dtls start,full start,end,full stack time,packet number,payload size
2120681,2120074,2121731,1657,1,25
2125471,2124864,2127423,2559,2,25
2131164,2130557,2133664,3107,3,25
2137405,2136798,2138672,1874,4,25
2142412,2141805,2144048,2243,5,25
2147788,2147181,2149055,1874,6,25
2152796,2152189,2155382,3193,7,25
2159123,2158516,2160357,1841,8,25
2164097,2163490,2165364,1874,9,25
2169321,2168497,2170371,1874,10,25
2174200,2173593,2175467,1874,11,25
2179296,2178689,2181480,2791,12,25
2185310,2184703,2187726,3023,13,25
2191556,2190949,2193339,2390,14,25
2197385,2196561,2198435,1874,15,25
2202264,2201657,2203531,1874,16,25
2207360,2206753,2208595,1842,17,25
2212425,2211817,2213692,1875,18,25
2217521,2216914,2218755,1841,19,25
2222584,2221977,2225000,3023,20,25
2228831,2228223,2230930,2707,21,25
2234761,2234154,2236544,2390,22,25
2240374,2239767,2241841,2074,23,25
2245671,2245064,2247455,2391,24,25
2251285,2250678,2253701,3023,25,25
2257749,2256925,2258799,1874,26,25
2262628,2262021,2264496,2475,27,25
2268326,2267719,2269593,1874,28,25
2273423,2272816,2274690,1874,29,25
2278520,2277913,2280387,2474,30,25
2284217,2283610,2285484,1874,31,25
2289313,2288706,2291814,3108,32,25
2295644,2295037,2297110,2073,33,25
2300940,2300333,2302207,1874,34,25
2306036,2305429,2307271,1842,35,25
2311100,2310493,2312566,2073,36,25
2316396,2315789,2318812,3023,37,25
2322643,2322036,2324426,2390,38,25
2328473,2327649,2329523,1874,39,25
2333353,2332746,2334586,1840,40,25
2338416,2337809,2339683,1874,41,25
2343513,2342906,2346014,3108,42,25
2350061,2349238,2351111,1873,43,25
2354941,2354334,2356175,1841,44,25
2360004,2359397,2362104,2707,45,25
2365934,2365327,2367063,1736,46,25
2370893,2370286,2372359,2073,47,25
2376189,2375582,2377456,1874,48,25
2381286,2380679,2382553,1874,49,25
2386600,2385776,2387650,1874,50,25
2391479,2390872,2392746,1874,51,25
2396576,2395969,2399076,3107,52,25
2402907,2402300,2404374,2074,53,25
2408204,2407597,2409987,2390,54,25
2413817,2413210,2415084,1874,55,25
2418914,2418307,2420149,1842,56,25
2424195,2423372,2425245,1873,57,25
2429292,2428468,2430342,1874,58,25
2434172,2433565,2435407,1842,59,25
2439236,2438629,2441336,2707,60,25
2445167,2444560,2446434,1874,61,25
2450264,2449657,2452448,2791,62,25
2456279,2455672,2457745,2073,63,25
2461575,2460968,2463358,2390,64,25
2467188,2466581,2468455,1874,65,25
2472284,2471677,2473551,1874,66,25
2477381,2476774,2479882,3108,67,25
2483713,2483106,2484842,1736,68,25
2488671,2488064,2490771,2707,69,25
2494602,2493995,2497018,3023,70,25
2501066,2500242,2502116,1874,71,25
2505945,2505338,2507812,2474,72,25
2511642,2511035,2512909,1874,73,25
2516739,2516132,2521308,5176,74,25
2525139,2524532,2526268,1736,75,25
2530098,2529490,2531365,1875,76,25
2535194,2534587,2537379,2792,77,25
2541210,2540603,2542993,2390,78,25
2546823,2546216,2547952,1736,79,25
2551782,2551175,2554198,3023,80,25
2558029,2557422,2559296,1874,81,25
2563342,2562519,2564393,1874,82,25
2568224,2567617,2570725,3108,83,25
2574557,2573950,2575824,1874,84,25
2579654,2579047,2580889,1842,85,25
2584720,2584113,2586819,2706,86,25
2590651,2590044,2591919,1875,87,25
2595750,2595143,2597302,2159,88,25
2601133,2600526,2602579,2053,89,25
2606410,2605803,2607678,1875,90,25
2611726,2610902,2612777,1875,91,25
2616608,2616001,2617876,1875,92,25
2621707,2621100,2623575,2475,93,25
2627406,2626799,2628674,1875,94,25
2632504,2631897,2633772,1875,95,25
2637602,2636995,2638870,1875,96,25
2642701,2642094,2644253,2159,97,25
2648084,2647477,2649352,1875,98,25
2653182,2652575,2655684,3109,99,25
2659732,2658909,2660783,1874,100,25
2664703,2664096,2665971,1875,101,25
2669890,2669283,2671674,2391,102,25
2675810,2674987,2676861,1874,103,25
2680780,2680173,2682048,1875,104,25
2685967,2685360,2687096,1736,105,25
2691016,2690409,2692378,1969,106,25
2696297,2695690,2698312,2622,107,25
2702232,2701625,2704565,2940,108,25
2708702,2707878,2709753,1875,109,25
2713889,2713065,2714940,1875,110,25
2718859,2718252,2719989,1737,111,25
2723908,2723301,2725923,2622,112,25
2730060,2729236,2731111,1875,113,25
2735030,2734423,2737446,3023,114,25
2741366,2740759,2742634,1875,115,25
2746553,2745946,2748969,3023,116,25
2753105,2752282,2754156,1874,117,25
2758076,2757469,2759860,2391,118,25
2763780,2763173,2765459,2286,119,25
2769379,2768772,2771712,2940,120,25
2775633,2775026,2776901,1875,121,25
2780821,2780214,2782089,1875,122,25
2786008,2785401,2787276,1875,123,25
2791412,2790588,2792463,1875,124,25
2796382,2795775,2797650,1875,125,25
2801569,2800962,2803353,2391,126,25
2807489,2806665,2808540,1875,127,25
2812459,2811852,2813727,1875,128,25
2817646,2817039,2818914,1875,129,25
2822833,2822226,2824101,1875,130,25
2828020,2827413,2829287,1874,131,25
2833423,2832599,2834474,1875,132,25
2838393,2837786,2839661,1875,133,25
2843580,2842973,2844848,1875,134,25
2848767,2848160,2850212,2052,135,25
2854132,2853525,2856148,2623,136,25
2860069,2859462,2861748,2286,137,25
2865668,2865061,2867346,2285,138,25
2871266,2870659,2872333,1674,139,25
2876252,2875645,2877930,2285,140,25
2881850,2881243,2882916,1673,141,25
2886835,2886228,2888197,1969,142,25
2892116,2891509,2893384,1875,143,25
2897303,2896696,2898433,1737,144,25
2902351,2901745,2903619,1874,145,25
2907538,2906931,2909321,2390,146,25
2913241,2912634,2914509,1875,147,25
2918428,2917821,2920844,3023,148,25
2924763,2924157,2927096,2939,149,25
2931017,2930410,2932379,1969,150,25
2936515,2935691,2937566,1875,151,25
2941703,2940879,2942754,1875,152,25
2946674,2946067,2947803,1736,153,25
2951723,2951115,2952991,1876,154,25
2956911,2956304,2958357,2053,155,25
2962277,2961670,2963638,1968,156,25
2967558,2966951,2969891,2940,157,25
2973812,2973205,2976144,2939,158,25
2980281,2979457,2981332,1875,159,25
2985469,2984645,2986520,1875,160,25
2990440,2989833,2992857,3024,161,25
2996994,2996171,2998045,1874,162,25
3002182,3001358,3003233,1875,163,25
3007153,3006546,3008421,1875,164,25
3012341,3011734,3013609,1875,165,25
3017529,3016922,3019313,2391,166,25
3023234,3022627,3024911,2284,167,25
3029048,3028224,3030099,1875,168,25
3034020,3033413,3036437,3024,169,25
3040358,3039751,3042374,2623,170,25
3046295,3045688,3047973,2285,171,25
3051894,3051286,3053573,2287,172,25
3057494,3056887,3058856,1969,173,25
3062776,3062169,3064138,1969,174,25
3068058,3067451,3069124,1673,175,25
3073044,3072437,3074722,2285,176,25
3078642,3078035,3080658,2623,177,25
3084579,3083972,3086257,2285,178,25
3090177,3089570,3091244,1674,179,25
3095381,3094557,3096432,1875,180,25
3100352,3099745,3101620,1875,181,25
3105540,3104933,3107324,2391,182,25
3111244,3110637,3112923,2286,183,25
3116844,3116237,3119177,2940,184,25
3123098,3122491,3124460,1969,185,25
3128380,3127773,3130058,2285,186,25
3133979,3133372,3135046,1674,187,25
3138966,3138359,3140982,2623,188,25
3145119,3144296,3146170,1874,189,25
3150090,3149483,3151873,2390,190,25
3155794,3155187,3158127,2940,191,25
3162048,3161441,3164381,2940,192,25
3168303,3167696,3170319,2623,193,25
3174457,3173633,3175508,1875,194,25
3179428,3178821,3180875,2054,195,25
3184796,3184189,3186475,2286,196,25
3190396,3189789,3192729,2940,197,25
3196867,3196043,3197918,1875,198,25
3201838,3201231,3203283,2052,199,25
3207203,3206596,3209535,2939,200,25
3213673,3212849,3214724,1875,201,25
3218644,3218037,3220090,2053,202,25
3224011,3223404,3225076,1672,203,25
3228997,3228390,3230676,2286,204,25
3234814,3233990,3235865,1875,205,25
3239786,3239179,3240915,1736,206,25
3244836,3244229,3246513,2284,207,25
3250434,3249827,3251702,1875,208,25
3255622,3255015,3256752,1737,209,25
3260672,3260065,3263005,2940,210,25
3266927,3266320,3268943,2623,211,25
3273082,3272258,3274133,1875,212,25
3278271,3277447,3279322,1875,213,25
3283242,3282635,3285659,3024,214,25
3289581,3288974,3290849,1875,215,25
3294769,3294162,3296036,1874,216,25
3299956,3299349,3301739,2390,217,25
3305660,3305053,3306726,1673,218,25
3310646,3310039,3312325,2286,219,25
3316246,3315639,3317312,1673,220,25
3321232,3320625,3323565,2940,221,25
3327703,3326879,3328754,1875,222,25
3332891,3332067,3333942,1875,223,25
3337862,3337255,3339645,2390,224,25
3343566,3342959,3345244,2285,225,25
3349165,3348558,3350527,1969,226,25
3354447,3353840,3355809,1969,227,25
3359946,3359122,3360997,1875,228,25
3364918,3364310,3367017,2707,229,25
3370938,3370331,3372004,1673,230,25
3375924,3375317,3377602,2285,231,25
3381523,3380916,3383855,2939,232,25
3387777,3387170,3389139,1969,233,25
3393059,3392452,3394125,1673,234,25
3398046,3397439,3399112,1673,235,25
3403033,3402426,3404099,1673,236,25
3408019,3407412,3409379,1967,237,25
3413299,3412692,3414976,2284,238,25
3418897,3418290,3420576,2286,239,25
3424497,3423890,3425765,1875,240,25
3429902,3429078,3430953,1875,241,25
3434873,3434266,3436141,1875,242,25
3440062,3439455,3441192,1737,243,25
3445113,3444506,3446791,2285,244,25
3450929,3450105,3451980,1875,245,25
3455900,3455293,3457029,1736,246,25
3461166,3460342,3462217,1875,247,25
3466136,3465530,3467404,1874,248,25
3471324,3470717,3473108,2391,249,25
3477029,3476422,3478094,1672,250,25
3482015,3481408,3483081,1673,251,25
3487003,3486395,3488069,1674,252,25
3492206,3491382,3493257,1875,253,25
3497178,3496571,3498961,2390,254,25
3502882,3502275,3505214,2939,255,25
3509135,3508528,3510814,2286,256,25
3514735,3514128,3515802,1674,257,25
3519723,3519116,3521085,1969,258,25
3525223,3524399,3526274,1875,259,25
3530194,3529587,3532295,2708,260,25
3536217,3535610,3537485,1875,261,25
3541405,3540798,3543189,2391,262,25
3547110,3546503,3548176,1673,263,25
3552097,3551490,3553163,1673,264,25
3557084,3556477,3558151,1674,265,25
3562071,3561464,3564087,2623,266,25
3568226,3567402,3569277,1875,267,25
3573198,3572591,3575299,2708,268,25
3579437,3578614,3580488,1874,269,25
3584409,3583802,3585677,1875,270,25
3589815,3588991,3590866,1875,271,25
3594786,3594179,3596054,1875,272,25
3599974,3599367,3601757,2390,273,25
3605678,3605071,3608010,2939,274,25
3612148,3611324,3613199,1875,275,25
3617119,3616512,3618565,2053,276,25
3622486,3621879,3623754,1875,277,25
3627674,3627067,3628942,1875,278,25
3632862,3632255,3635279,3024,279,25
3639200,3638593,3640468,1875,280,25
3644388,3643781,3645656,1875,281,25
3649577,3648970,3650845,1875,282,25
3654766,3654159,3655896,1737,283,25
3659817,3659209,3661179,1970,284,25
3665316,3664493,3666367,1874,285,25
3670288,3669681,3671556,1875,286,25
3675477,3674870,3677260,2390,287,25
3681398,3680574,3682449,1875,288,25
3686370,3685763,3687638,1875,289,25
3691559,3690952,3692827,1875,290,25
3696747,3696140,3698530,2390,291,25
3702451,3701844,3703719,1875,292,25
3707639,3707032,3708907,1875,293,25
3713044,3712220,3714095,1875,294,25
3718016,3717409,3720433,3024,295,25
3724572,3723748,3725623,1875,296,25
3729761,3728937,3730812,1875,297,25
3734950,3734126,3736001,1875,298,25
3739922,3739315,3741052,1737,299,25
3744972,3744365,3747305,2940,300,25
3751227,3750620,3752495,1875,301,25
3756416,3755809,3757545,1736,302,25
3761683,3760859,3762734,1875,303,25
3766655,3766048,3767923,1875,304,25
3771844,3771237,3774261,3024,305,25
3778183,3777576,3780516,2940,306,25
3784654,3783831,3785705,1874,307,25
3789626,3789019,3791409,2390,308,25
3795330,3794723,3796397,1674,309,25
3800317,3799710,3801585,1875,310,25
3805723,3804899,3806774,1875,311,25
3810695,3810088,3812794,2706,312,25
3816716,3816109,3817781,1672,313,25
3821701,3821094,3822969,1875,314,25
3826891,3826283,3828337,2054,315,25
3832259,3831652,3833621,1969,316,25
3837542,3836935,3838810,1875,317,25
3842731,3842124,3843998,1874,318,25
3848136,3847312,3849187,1875,319,25
3853325,3852501,3854376,1875,320,25
3858513,3857689,3859564,1875,321,25
3863701,3862877,3864752,1875,322,25
3868890,3868066,3869941,1875,323,25
3873862,3873255,3875308,2053,324,25
3879229,3878622,3880591,1969,325,25
3884512,3883905,3886528,2623,326,25
3890450,3889843,3892783,2940,327,25
3896921,3896097,3897972,1875,328,25
3901893,3901286,3903161,1875,329,25
3907082,3906475,3909183,2708,330,25
3913104,3912497,3914372,1875,331,25
3918293,3917686,3919561,1875,332,25
3923482,3922875,3924927,2052,333,25
3928848,3928241,3930116,1875,334,25
3934254,3933430,3935305,1875,335,25
3939226,3938619,3940356,1737,336,25
3944493,3943669,3945544,1875,337,25
3949464,3948857,3951564,2707,338,25
3955485,3954878,3956753,1875,339,25
3960891,3960067,3961942,1875,340,25
3965863,3965256,3968280,3024,341,25
3972200,3971594,3974532,2938,342,25
3978670,3977846,3979721,1875,343,25
3983641,3983034,3985741,2707,344,25
3989663,3989056,3991996,2940,345,25
3996135,3995311,3997186,1875,346,25
4001322,4000499,4002373,1874,347,25
4006293,4005686,4007740,2054,348,25
4011661,4011054,4013023,1969,349,25
4017161,4016337,4018212,1875,350,25
4022133,4021526,4023401,1875,351,25
4027322,4026715,4028768,2053,352,25
4032689,4032082,4033957,1875,353,25
4037877,4037270,4040293,3023,354,25
4044215,4043608,4046210,2602,355,25
4050131,4049524,4051493,1969,356,25
4055631,4054807,4056682,1875,357,25
4060602,4059995,4061870,1875,358,25
4065791,4065184,4068207,3023,359,25
4072129,4071522,4073491,1969,360,25
4077411,4076804,4078772,1968,361,25
4082693,4082086,4083760,1674,362,25
4087680,4087073,4089359,2286,363,25
4093497,4092673,4094548,1875,364,25
4098469,4097862,4099737,1875,365,25
4103659,4103052,4105106,2054,366,25
4109028,4108421,4110296,1875,367,25
4114218,4113611,4115665,2054,368,25
4119587,4118980,4120654,1674,369,25
4124575,4123968,4126908,2940,370,25
4130831,4130224,4132510,2286,371,25
4136432,4135825,4138110,2285,372,25
4142249,4141425,4143301,1876,373,25
4147439,4146616,4148490,1874,374,25
4152412,4151805,4153543,1738,375,25
4157465,4156858,4159144,2286,376,25
4163066,4162459,4164745,2286,377,25
4168884,4168060,4169935,1875,378,25
4173857,4173250,4175125,1875,379,25
4179047,4178440,4180810,2370,380,25
4184949,4184125,4186001,1876,381,25
4190140,4189316,4191192,1876,382,25
4195331,4194507,4196382,1875,383,25
4200304,4199697,4202722,3025,384,25
4206861,4206037,4207913,1876,385,25
4211835,4211228,4213103,1875,386,25
4217025,4216418,4219126,2708,387,25
4223049,4222442,4224116,1674,388,25
4228255,4227431,4229306,1875,389,25
4233228,4232621,4234496,1875,390,25
4238418,4237811,4239549,1738,391,25
4243471,4242864,4244833,1969,392,25
4248755,4248148,4250751,2603,393,25
4254674,4254067,4256352,2285,394,25
4260274,4259667,4261341,1674,395,25
4265263,4264656,4266626,1970,396,25
4270548,4269941,4271614,1673,397,25
4275753,4274929,4276804,1875,398,25
4280725,4280118,4282510,2392,399,25
4286432,4285825,4287700,1875,400,25
4291622,4291015,4292890,1875,401,25
4296812,4296205,4298080,1875,402,25
4302003,4301395,4303449,2054,403,25
4307588,4306764,4308639,1875,404,25
4312561,4311954,4313829,1875,405,25
4317751,4317144,4320168,3024,406,25
4324091,4323484,4325770,2286,407,25
4329692,4329085,4332025,2940,408,25
4335948,4335341,4337015,1674,409,25
4340937,4340330,4342004,1674,410,25
4345926,4345319,4348259,2940,411,25
4352182,4351575,4353544,1969,412,25
4357466,4356859,4358734,1875,413,25
4362656,4362049,4363786,1737,414,25
4367708,4367101,4370041,2940,415,25
4374181,4373357,4375233,1876,416,25
4379155,4378548,4381256,2708,417,25
4385179,4384572,4386541,1969,418,25
4390680,4389856,4391732,1876,419,25
4395654,4395047,4397101,2054,420,25
4401024,4400417,4402292,1875,421,25
4406214,4405607,4407482,1875,422,25
4411404,4410797,4412851,2054,423,25
4416773,4416166,4419106,2940,424,25
4423246,4422422,4424298,1876,425,25
4428437,4427613,4429489,1876,426,25
4433628,4432804,4434680,1876,427,25
4438602,4437995,4439870,1875,428,25
4443792,4443185,4445556,2371,429,25
4449478,4448871,4451157,2286,430,25
4455079,4454472,4457412,2940,431,25
4461335,4460728,4463014,2286,432,25
4466936,4466329,4468204,1875,433,25
4472126,4471519,4474543,3024,434,25
4478466,4477859,4480799,2940,435,25
4484722,4484115,4487055,2940,436,25
4490978,4490371,4492973,2602,437,25
4496897,4496289,4499230,2941,438,25
4503153,4502546,4504421,1875,439,25
4508343,4507736,4510127,2391,440,25
4514049,4513442,4515115,1673,441,25
4519037,4518430,4520716,2286,442,25
4524638,4524031,4526654,2623,443,25
4530577,4529970,4532911,2941,444,25
4536834,4536227,4537901,1674,445,25
4542040,4541216,4543092,1876,446,25
4547014,4546407,4548282,1875,447,25
4552204,4551597,4554622,3025,448,25
4558545,4557938,4559907,1969,449,25
4563829,4563222,4565508,2286,450,25
4569431,4568824,4570498,1674,451,25
4574420,4573813,4575782,1969,452,25
4579921,4579097,4580973,1876,453,25
4584895,4584288,4586024,1736,454,25
4589946,4589339,4591625,2286,455,25
4595548,4594941,4597543,2602,456,25
4601683,4600859,4602735,1876,457,25
4606657,4606050,4607787,1737,458,25
4611926,4611102,4612978,1876,459,25
4616900,4616293,4618168,1875,460,25
4622090,4621483,4623358,1875,461,25
4627280,4626673,4628548,1875,462,25
4632470,4631863,4633739,1876,463,25
4637661,4637054,4640079,3025,464,25
4644219,4643395,4645271,1876,465,25
4649193,4648586,4650640,2054,466,25
4654562,4653955,4655830,1875,467,25
4659752,4659145,4661853,2708,468,25
4665776,4665169,4668109,2940,469,25
4672032,4671425,4673395,1970,470,25
4677317,4676710,4679312,2602,471,25
4683235,4682628,4684598,1970,472,25
4688737,4687913,4689789,1876,473,25
4693711,4693104,4694841,1737,474,25
4698763,4698156,4701097,2941,475,25
4705020,4704413,4707352,2939,476,25
4711275,4710668,4713270,2602,477,25
4717193,4716586,4718461,1875,478,25
4722383,4721776,4724147,2371,479,25
4728070,4727463,4729749,2286,480,25
4733672,4733065,4735351,2286,481,25
4739490,4738666,4740542,1876,482,25
4744464,4743857,4746565,2708,483,25
4750705,4749881,4751757,1876,484,25
4755679,4755072,4758097,3025,485,25
4762237,4761413,4763289,1876,486,25
4767211,4766604,4769312,2708,487,25
4773235,4772628,4774302,1674,488,25
4778224,4777617,4779903,2286,489,25
4783825,4783218,4785504,2286,490,25
4789426,4788819,4790493,1674,491,25
4794415,4793808,4795482,1674,492,25
4799404,4798797,4801082,2285,493,25
4805005,4804398,4806273,1875,494,25
4810412,4809588,4811464,1876,495,25
4815386,4814779,4816654,1875,496,25
4820792,4819968,4821844,1876,497,25
4825765,4825159,4827866,2707,498,25
4831789,4831182,4833468,2286,499,25
4837390,4836783,4838457,1674,500,25
4842379,4841772,4844058,2286,501,25
4847980,4847373,4849659,2286,502,25
4853581,4852974,4854944,1970,503,25
4858866,4858259,4860545,2286,504,25
4864468,4863861,4866147,2286,505,25
4870287,4869463,4871339,1876,506,25
4875478,4874654,4876530,1876,507,25
4880452,4879845,4882236,2391,508,25
4886158,4885551,4888175,2624,509,25
4892098,4891491,4893165,1674,510,25
4897304,4896480,4898356,1876,511,25
4902278,4901671,4903546,1875,512,25
4907468,4906861,4908598,1737,513,25
4912737,4911913,4913789,1876,514,25
4917711,4917104,4920129,3025,515,25
4924052,4923445,4925731,2286,516,25
4929653,4929046,4931670,2624,517,25
4935593,4934986,4936660,1674,518,25
4940582,4939975,4942915,2940,519,25
4946838,4946231,4948517,2286,520,25
4952439,4951832,4954772,2940,521,25
4958912,4958088,4959964,1876,522,25
4963886,4963279,4965332,2053,523,25
4969254,4968647,4970522,1875,524,25
4974444,4973837,4976545,2708,525,25
4980468,4979861,4982800,2939,526,25
4986940,4986116,4987992,1876,527,25
4991914,4991307,4993678,2371,528,25
4997601,4996994,4998667,1673,529,25
5002590,5001982,5003952,1970,530,25
5007874,5007267,5009237,1970,531,25
5013159,5012552,5014838,2286,532,25
5018760,5018153,5020028,1875,533,25
5023950,5023343,5025219,1876,534,25
5029141,5028534,5031559,3025,535,25
5035482,5034875,5037161,2286,536,25
5041084,5040477,5043418,2941,537,25
5047341,5046734,5049337,2603,538,25
5053260,5052653,5054939,2286,539,25
5058862,5058255,5060131,1876,540,25
5064053,5063446,5065321,1875,541,25
5069243,5068636,5071344,2708,542,25
5075267,5074660,5076535,1875,543,25
5080457,5079850,5081725,1875,544,25
5085647,5085040,5086915,1875,545,25
5090837,5090230,5092622,2392,546,25
5096545,5095938,5098224,2286,547,25
5102147,5101540,5103214,1674,548,25
5107353,5106529,5108405,1876,549,25
5112544,5111720,5113596,1876,550,25
5117518,5116911,5118965,2054,551,25
5123105,5122281,5124156,1875,552,25
5128077,5127470,5129345,1875,553,25
5133267,5132660,5134535,1875,554,25
5138457,5137850,5140875,3025,555,25
5144798,5144191,5146477,2286,556,25
5150399,5149792,5151466,1674,557,25
5155604,5154781,5156656,1875,558,25
5160578,5159971,5161846,1875,559,25
5165768,5165161,5168185,3024,560,25
5172108,5171501,5174441,2940,561,25
5178364,5177757,5180360,2603,562,25
5184283,5183676,5185350,1674,563,25
5189272,5188665,5191605,2940,564,25
5195528,5194921,5196796,1875,565,25
5200718,5200111,5201849,1738,566,25
5205771,5205164,5206838,1674,567,25
5210760,5210153,5212028,1875,568,25
5215950,5215343,5217218,1875,569,25
5221140,5220533,5223557,3024,570,25
5227480,5226873,5228843,1970,571,25
5232982,5232158,5234033,1875,572,25
5237955,5237348,5239223,1875,573,25
5243145,5242538,5244592,2054,574,25
5248514,5247907,5250530,2623,575,25
5254453,5253846,5256131,2285,576,25
5260052,5259446,5261320,1874,577,25
5265241,5264634,5266509,1875,578,25
5270431,5269824,5272215,2391,579,25
5276137,5275530,5277405,1875,580,25
5281543,5280720,5282595,1875,581,25
5286517,5285910,5287963,2053,582,25
5291885,5291278,5293153,1875,583,25
5297075,5296468,5299492,3024,584,25
5303415,5302808,5305093,2285,585,25
5309232,5308408,5310284,1876,586,25
5314206,5313599,5315989,2390,587,25
5319911,5319304,5321274,1970,588,25
5325413,5324589,5326464,1875,589,25
5330386,5329779,5332170,2391,590,25
5336309,5335485,5337360,1875,591,25
5341282,5340675,5343699,3024,592,25
5347622,5347015,5349616,2601,593,25
5353539,5352932,5355218,2286,594,25
5359140,5358533,5360502,1969,595,25
5364424,5363817,5366758,2941,596,25
5370898,5370074,5371949,1875,597,25
5376088,5375264,5377139,1875,598,25
5381061,5380454,5382192,1738,599,25
5386114,5385507,5387180,1673,600,25
5391102,5390495,5393119,2624,601,25
5397042,5396435,5398310,1875,602,25
5402232,5401625,5404650,3025,603,25
5408573,5407966,5409640,1674,604,25
5413779,5412955,5414831,1876,605,25
5418970,5418146,5420022,1876,606,25
5423944,5423337,5425708,2371,607,25
5429630,5429023,5430993,1970,608,25
5434915,5434308,5435982,1674,609,25
5439904,5439297,5440971,1674,610,25
5444893,5444286,5446255,1969,611,25
5450177,5449570,5451445,1875,612,25
5455367,5454760,5456814,2054,613,25
5460953,5460129,5462005,1876,614,25
5465927,5465320,5467691,2371,615,25
5471613,5471006,5472680,1674,616,25
5476602,5475995,5478598,2603,617,25
5482521,5481914,5483883,1969,618,25
5488022,5487198,5489074,1876,619,25
5492996,5492389,5494760,2371,620,25
5498682,5498075,5500361,2286,621,25
5504500,5503676,5505551,1875,622,25
5509473,5508866,5511574,2708,623,25
5515497,5514890,5516765,1875,624,25
5520687,5520080,5521955,1875,625,25
5525877,5525270,5527661,2391,626,25
5531583,5530976,5533578,2602,627,25
5537718,5536894,5538770,1876,628,25
5542692,5542085,5545110,3025,629,25
5549033,5548426,5550395,1969,630,25
5554317,5553710,5555995,2285,631,25
5559917,5559310,5562251,2941,632,25
5566174,5565567,5567241,1674,633,25
5571163,5570556,5572431,1875,634,25
5576353,5575746,5578771,3025,635,25
5582911,5582087,5583963,1876,636,25
5588101,5587278,5589153,1875,637,25
5593292,5592468,5594344,1876,638,25
5598266,5597659,5600030,2371,639,25
5603952,5603345,5605948,2603,640,25
5609871,5609264,5610937,1673,641,25
5614859,5614252,5615925,1673,642,25
5620063,5619240,5621115,1875,643,25
5625037,5624430,5626305,1875,644,25
5630227,5629620,5632328,2708,645,25
5636251,5635644,5637930,2286,646,25
5641852,5641245,5643120,1875,647,25
5647042,5646435,5648310,1875,648,25
5652232,5651625,5653500,1875,649,25
5657422,5656815,5659207,2392,650,25
5663346,5662522,5664398,1876,651,25
5668320,5667713,5670420,2707,652,25
5674560,5673736,5675612,1876,653,25
5679534,5678927,5680663,1736,654,25
5684585,5683978,5685947,1969,655,25
5689869,5689262,5691548,2286,656,25
5695470,5694863,5697803,2940,657,25
5701726,5701119,5702793,1674,658,25
5706715,5706108,5707782,1674,659,25
5711704,5711097,5712972,1875,660,25
5716894,5716287,5718023,1736,661,25
5722162,5721338,5723214,1876,662,25
5727136,5726529,5728404,1875,663,25
5732326,5731719,5734744,3025,664,25
5738667,5738060,5739935,1875,665,25
5743856,5743249,5745125,1876,666,25
5749047,5748440,5750809,2369,667,25
5754731,5754124,5756748,2624,668,25
5760671,5760064,5762350,2286,669,25
5766272,5765665,5767634,1969,670,25
5771556,5770949,5772623,1674,671,25
5776761,5775938,5777813,1875,672,25
5781951,5781128,5783003,1875,673,25
5786925,5786318,5788193,1875,674,25
5792115,5791508,5794532,3024,675,25
5798672,5797848,5799723,1875,676,25
5803645,5803038,5805430,2392,677,25
5809570,5808746,5810622,1876,678,25
5814544,5813937,5815812,1875,679,25
5819734,5819127,5821835,2708,680,25
5825758,5825151,5826825,1674,681,25
5830748,5830140,5833081,2941,682,25
5837004,5836397,5838272,1875,683,25
5842194,5841587,5843462,1875,684,25
5847384,5846777,5848515,1738,685,25
5852437,5851830,5853705,1875,686,25
5857627,5857020,5860045,3025,687,25
5863968,5863361,5865236,1875,688,25
5869158,5868551,5870426,1875,689,25
5874348,5873741,5875616,1875,690,25
5879538,5878931,5881955,3024,691,25
5885878,5885271,5887241,1970,692,25
5891380,5890556,5892432,1876,693,25
5896570,5895747,5897622,1875,694,25
5901544,5900937,5902674,1737,695,25
5906596,5905989,5908274,2285,696,25
5912197,5911589,5913558,1969,697,25
5917480,5916873,5919813,2940,698,25
5923736,5923129,5924802,1673,699,25
5928724,5928117,5930720,2603,700,25
5934643,5934036,5936639,2603,701,25
5940778,5939955,5941830,1875,702,25
5945751,5945144,5946882,1738,703,25
5950803,5950196,5952071,1875,704,25
5955993,5955386,5957440,2054,705,25
5961362,5960755,5963041,2286,706,25
5966963,5966356,5968959,2603,707,25
5973099,5972275,5974151,1876,708,25
5978073,5977466,5980175,2709,709,25
5984098,5983491,5986094,2603,710,25
5990017,5989410,5991380,1970,711,25
5995301,5994695,5997635,2940,712,25
6001558,6000951,6002919,1968,713,25
6006841,6006234,6008858,2624,714,25
6012781,6012174,6014776,2602,715,25
6018699,6018092,6020378,2286,716,25
6024301,6023694,6025980,2286,717,25
6029903,6029296,6032237,2941,718,25
6036160,6035553,6038493,2940,719,25
6042416,6041809,6044748,2939,720,25
6048671,6048064,6049738,1674,721,25
6053660,6053053,6055339,2286,722,25
6059261,6058654,6060940,2286,723,25
6065079,6064255,6066131,1876,724,25
6070052,6069446,6071499,2053,725,25
6075422,6074815,6077101,2286,726,25
6081023,6080416,6082291,1875,727,25
6086214,6085606,6087661,2055,728,25
6091583,6090976,6092650,1674,729,25
6096789,6095965,6097841,1876,730,25
6101763,6101156,6103210,2054,731,25
6107349,6106525,6108401,1876,732,25
6112323,6111716,6114087,2371,733,25
6118225,6117402,6119277,1875,734,25
6123199,6122592,6124330,1738,735,25
6128469,6127645,6129521,1876,736,25
6133443,6132836,6135861,3025,737,25
6139785,6139178,6141781,2603,738,25
6145704,6145097,6147383,2286,739,25
6151305,6150698,6152573,1875,740,25
6156495,6155888,6157624,1736,741,25
6161546,6160939,6163880,2941,742,25
6167803,6167196,6169165,1969,743,25
6173304,6172480,6174356,1876,744,25
6178495,6177671,6179547,1876,745,25
6183469,6182862,6184737,1875,746,25
6188659,6188052,6191077,3025,747,25
6195000,6194393,6197333,2940,748,25
6201256,6200649,6202934,2285,749,25
6206856,6206249,6208851,2602,750,25
6212774,6212167,6214453,2286,751,25
6218376,6217769,6220055,2286,752,25
6223977,6223370,6225245,1875,753,25
6229167,6228560,6230435,1875,754,25
6234357,6233750,6236775,3025,755,25
6240698,6240091,6242061,1970,756,25
6246200,6245376,6247252,1876,757,25
6251175,6250567,6253592,3025,758,25
6257515,6256908,6259511,2603,759,25
6263434,6262827,6264796,1969,760,25
6268934,6268111,6269986,1875,761,25
6273908,6273301,6275670,2369,762,25
6279592,6278985,6281926,2941,763,25
6285849,6285242,6287845,2603,764,25
6291768,6291161,6293447,2286,765,25
6297369,6296762,6299048,2286,766,25
6302971,6302364,6304967,2603,767,25
6308890,6308283,6310568,2285,768,25
6314490,6313883,6316168,2285,769,25
6320092,6319484,6322426,2942,770,25
6326349,6325742,6328682,2940,771,25
6332605,6331998,6333874,1876,772,25
6337796,6337189,6339064,1875,773,25
6342986,6342379,6344433,2054,774,25
6348356,6347749,6350352,2603,775,25
6354275,6353668,6355341,1673,776,25
6359263,6358656,6360626,1970,777,25
6364548,6363941,6365817,1876,778,25
6369739,6369132,6371185,2053,779,25
6375108,6374501,6376787,2286,780,25
6380710,6380103,6381778,1675,781,25
6385700,6385093,6388034,2941,782,25
6391957,6391350,6393025,1675,783,25
6396947,6396340,6398216,1876,784,25
6402355,6401532,6403406,1874,785,25
6407328,6406721,6408775,2054,786,25
6412914,6412090,6413966,1876,787,25
6417888,6417281,6419156,1875,788,25
6423295,6422471,6424347,1876,789,25
6428269,6427662,6429715,2053,790,25
6433854,6433030,6434906,1876,791,25
6438828,6438221,6440929,2708,792,25
6445068,6444245,6446120,1875,793,25
6450259,6449435,6451311,1876,794,25
6455233,6454626,6457333,2707,795,25
6461256,6460649,6462619,1970,796,25
6466758,6465934,6467810,1876,797,25
6471732,6471125,6473832,2707,798,25
6477755,6477148,6478822,1674,799,25
6482744,6482137,6483811,1674,800,25
6487733,6487126,6489412,2286,801,25
6493334,6492727,6494697,1970,802,25
6498619,6498012,6500298,2286,803,25
6504221,6503614,6506555,2941,804,25
6510478,6509871,6512812,2941,805,25
6516735,6516128,6519069,2941,806,25
6522992,6522385,6524059,1674,807,25
6527981,6527374,6529343,1969,808,25
6533265,6532658,6534332,1674,809,25
6538254,6537647,6540588,2941,810,25
6544728,6543904,6545780,1876,811,25
6549702,6549095,6552120,3025,812,25
6556260,6555436,6557312,1876,813,25
6561235,6560628,6562999,2371,814,25
6566923,6566316,6569256,2940,815,25
6573398,6572574,6574450,1876,816,25
6578591,6577767,6579643,1876,817,25
6583566,6582959,6585013,2054,818,25
6588937,6588330,6590206,1876,819,25
6594130,6593523,6595399,1876,820,25
6599322,6598715,6601423,2708,821,25
6605348,6604741,6606416,1675,822,25
6610340,6609733,6612337,2604,823,25
6616262,6615655,6617942,2287,824,25
6621866,6621259,6623545,2286,825,25
6627469,6626862,6629803,2941,826,25
6633728,6633121,6636041,2920,827,25
6639965,6639358,6641645,2287,828,25
6645786,6644962,6646838,1876,829,25
6650761,6650154,6653179,3025,830,25
6657104,6656497,6658373,1876,831,25
6662296,6661689,6663565,1876,832,25
6667489,6666882,6668620,1738,833,25
6672544,6671937,6673813,1876,834,25
6677953,6677129,6679005,1876,835,25
6682928,6682321,6685030,2709,836,25
6688954,6688347,6691267,2920,837,25
6695409,6694585,6696462,1877,838,25
6700386,6699779,6701834,2055,839,25
6705758,6705151,6708091,2940,840,25
6712016,6711409,6713084,1675,841,25
6717008,6716401,6718076,1675,842,25
6722000,6721393,6723068,1675,843,25
6726991,6726384,6728058,1674,844,25
6732199,6731375,6733251,1876,845,25
6737175,6736568,6739593,3025,846,25
6743518,6742911,6744787,1876,847,25
6748710,6748103,6751128,3025,848,25
6755053,6754446,6757366,2920,849,25
6761291,6760684,6762560,1876,850,25
6766484,6765877,6768902,3025,851,25
6772827,6772220,6774823,2603,852,25
6778964,6778140,6780017,1877,853,25
6783939,6783333,6785071,1738,854,25
6788995,6788388,6790357,1969,855,25
6794281,6793674,6796278,2604,856,25
6800203,6799596,6801565,1969,857,25
6805489,6804882,6807486,2604,858,25
6811411,6810804,6812479,1675,859,25
6816403,6815796,6818400,2604,860,25
6822325,6821718,6824638,2920,861,25
6828779,6827955,6829832,1877,862,25
6833756,6833149,6836173,3024,863,25
6840315,6839491,6841368,1877,864,25
6845292,6844685,6846561,1876,865,25
6850702,6849878,6851755,1877,866,25
6855679,6855072,6857444,2372,867,25
6861368,6860761,6863702,2941,868,25
6867627,6867020,6868695,1675,869,25
6872619,6872012,6874616,2604,870,25
6878541,6877934,6880220,2286,871,25
6884144,6883537,6885212,1675,872,25
6889135,6888528,6891469,2941,873,25
6895394,6894787,6896757,1970,874,25
6900681,6900074,6903015,2941,875,25
6906940,6906333,6908620,2287,876,25
6912545,6911938,6914224,2286,877,25
6918148,6917541,6919511,1970,878,25
6923652,6922828,6924704,1876,879,25
6928628,6928021,6929897,1876,880,25
6933821,6933214,6935585,2371,881,25
6939509,6938902,6940576,1674,882,25
6944716,6943893,6945769,1876,883,25
6949693,6949086,6952112,3026,884,25
6956037,6955430,6957717,2287,885,25
6961641,6961034,6963638,2604,886,25
6967563,6966956,6969243,2287,887,25
6973384,6972560,6974437,1877,888,25
6978361,6977754,6979630,1876,889,25
6983554,6982947,6985973,3026,890,25
6989898,6989291,6990966,1675,891,25
6995107,6994283,6996160,1877,892,25
7000083,6999476,7001215,1739,893,25
7005139,7004532,7007135,2603,894,25
7011060,7010453,7012422,1969,895,25
7016563,7015739,7017616,1877,896,25
7021540,7020933,7023620,2687,897,25
7027545,7026938,7028612,1674,898,25
7032752,7031929,7033805,1876,899,25
7037729,7037122,7038999,1877,900,25
7043140,7042316,7044193,1877,901,25
7048334,7047510,7049386,1876,902,25
7053310,7052703,7054441,1738,903,25
7058365,7057758,7060362,2604,904,25
7064287,7063680,7065355,1675,905,25
7069496,7068672,7070548,1876,906,25
7074472,7073865,7076235,2370,907,25
7080159,7079552,7082155,2603,908,25
7086080,7085473,7088392,2919,909,25
7092318,7091710,7093587,1877,910,25
7097511,7096904,7098958,2054,911,25
7102882,7102275,7104879,2604,912,25
7108804,7108197,7110073,1876,913,25
7113997,7113390,7115128,1738,914,25
7119269,7118445,7120322,1877,915,25
7124246,7123639,7126348,2709,916,25
7130273,7129666,7131636,1970,917,25
7135777,7134953,7136830,1877,918,25
7140754,7140147,7143172,3025,919,25
7147314,7146490,7148367,1877,920,25
7152508,7151684,7153561,1877,921,25
7157485,7156878,7159249,2371,922,25
7163390,7162566,7164443,1877,923,25
7168367,7167760,7169636,1876,924,25
7173560,7172953,7174829,1876,925,25
7178753,7178146,7180517,2371,926,25
7184441,7183834,7185710,1876,927,25
7189634,7189027,7190903,1876,928,25
7195043,7194220,7196096,1876,929,25
7200020,7199413,7202437,3024,930,25
7206362,7205755,7208675,2920,931,25
7212600,7211993,7213869,1876,932,25
7217793,7217186,7219062,1876,933,25
7222986,7222379,7225088,2709,934,25
7229013,7228406,7231009,2603,935,25
7234934,7234327,7236002,1675,936,25
7240142,7239318,7241194,1876,937,25
7245118,7244511,7247537,3026,938,25
7251679,7250855,7252732,1877,939,25
7256656,7256049,7258419,2370,940,25
7262343,7261736,7264340,2604,941,25
7268265,7267658,7270578,2920,942,25
7274503,7273896,7276183,2287,943,25
7280107,7279500,7282441,2941,944,25
7286583,7285759,7287636,1877,945,25
7291560,7290953,7292691,1738,946,25
7296832,7296008,7297884,1876,947,25
7301807,7301200,7304224,3024,948,25
7308149,7307542,7309216,1674,949,25
7313140,7312533,7315137,2604,950,25
7319062,7318455,7320426,1971,951,25
7324567,7323743,7325620,1877,952,25
7329544,7328937,7331962,3025,953,25
7335887,7335280,7337156,1876,954,25
7341080,7340473,7343498,3025,955,25
7347423,7346816,7349103,2287,956,25
7353027,7352420,7355024,2604,957,25
7358950,7358342,7360017,1675,958,25
7363941,7363334,7365620,2286,959,25
7369544,7368937,7370813,1876,960,25
7374737,7374130,7377155,3025,961,25
7381080,7380473,7383077,2604,962,25
7387002,7386395,7388682,2287,963,25
7392606,7391999,7394603,2604,964,25
7398745,7397921,7399797,1876,965,25
7403720,7403113,7404989,1876,966,25
7408913,7408306,7410676,2370,967,25
7414817,7413993,7415870,1877,968,25
7419794,7419187,7421063,1876,969,25
7424987,7424380,7426256,1876,970,25
7430180,7429573,7431628,2055,971,25
7435769,7434945,7436822,1877,972,25
7440745,7440138,7442193,2055,973,25
7446117,7445510,7447797,2287,974,25
7451721,7451114,7453717,2603,975,25
7457859,7457035,7458912,1877,976,25
7462836,7462229,7464105,1876,977,25
7468029,7467422,7469161,1739,978,25
7473085,7472478,7474764,2286,979,25
7478689,7478082,7479958,1876,980,25
7483882,7483275,7485984,2709,981,25
7489909,7489302,7491178,1876,982,25
7495102,7494495,7497204,2709,983,25
7501129,7500522,7503126,2604,984,25
7507268,7506444,7508320,1876,985,25
7512243,7511637,7513512,1875,986,25
7517653,7516829,7518706,1877,987,25
7522630,7522023,7524711,2688,988,25
7528853,7528029,7529906,1877,989,25
7533830,7533223,7535278,2055,990,25
7539204,7538596,7541517,2921,991,25
7545442,7544835,7547776,2941,992,25
7551701,7551094,7553698,2604,993,25
7557623,7557016,7559957,2941,994,25
7563882,7563275,7565878,2603,995,25
7569803,7569196,7571167,1971,996,25
7575091,7574484,7577425,2941,997,25
7581350,7580743,7582417,1674,998,25
7586341,7585734,7587705,1971,999,25
7591629,7591022,7593626,2604,1000,25
7597640,7597033,7599235,2202,1001,25
7603248,7602641,7604527,1886,1002,25
7608540,7607933,7610452,2519,1003,25
7614465,7613858,7615734,1876,1004,25
7619747,7619140,7621744,2604,1005,25
7625758,7625151,7627027,1876,1006,25
7631040,7630433,7633353,2920,1007,25
7637367,7636760,7639279,2519,1008,25
7643292,7642685,7644561,1876,1009,25
7648574,7647967,7650254,2287,1010,25
7654267,7653660,7656180,2520,1011,25
7660193,7659586,7661462,1876,1012,25
7665692,7664868,7666745,1877,1013,25
7670975,7670151,7672028,1877,1014,25
7676041,7675434,7677109,1675,1015,25
7681122,7680515,7682391,1876,1016,25
7686403,7685796,7687471,1675,1017,25
7691484,7690877,7693396,2519,1018,25
7697409,7696802,7699638,2836,1019,25
7703652,7703045,7705881,2836,1020,25
7710111,7709287,7711164,1877,1021,25
7715393,7714569,7716445,1876,1022,25
7720457,7719850,7721726,1876,1023,25
7725955,7725131,7727008,1877,1024,25
7731238,7730414,7732290,1876,1025,25
7736520,7735696,7737572,1876,1026,25
7741585,7740978,7742854,1876,1027,25
7746867,7746260,7749180,2920,1028,25
7753192,7752586,7754471,1885,1029,25
7758484,7757877,7759753,1876,1030,25
7763766,7763159,7766079,2920,1031,25
7770093,7769486,7771161,1675,1032,25
7775174,7774567,7777087,2520,1033,25
7781100,7780493,7783329,2836,1034,25
7787343,7786736,7788612,1876,1035,25
7792625,7792018,7794938,2920,1036,25
7799168,7798345,7800221,1876,1037,25
7804234,7803627,7805503,1876,1038,25
7809516,7808909,7810785,1876,1039,25
7814798,7814191,7816161,1970,1040,25
7820174,7819567,7821768,2201,1041,25
7825781,7825174,7827060,1886,1042,25
7831073,7830466,7833302,2836,1043,25
7837316,7836709,7839544,2835,1044,25
7843558,7842951,7845470,2519,1045,25
7849483,7848876,7850752,1876,1046,25
7854765,7854158,7857078,2920,1047,25
7861309,7860485,7862362,1877,1048,25
7866592,7865768,7867645,1877,1049,25
7871658,7871051,7872726,1675,1050,25
7876738,7876131,7878017,1886,1051,25
7882029,7881422,7883308,1886,1052,25
7887320,7886713,7888916,2203,1053,25
7892929,7892322,7894198,1876,1054,25
7898211,7897604,7899575,1971,1055,25
7903587,7902980,7904866,1886,1056,25
7908879,7908272,7910158,1886,1057,25
7914171,7913564,7916083,2519,1058,25
7920096,7919489,7921375,1886,1059,25
7925604,7924781,7926657,1876,1060,25
7930885,7930062,7931938,1876,1061,25
7935951,7935344,7938264,2920,1062,25
7942494,7941671,7943547,1876,1063,25
7947560,7946953,7949557,2604,1064,25
7953787,7952964,7954840,1876,1065,25
7958852,7958245,7961186,2941,1066,25
7965200,7964593,7967111,2518,1067,25
7971124,7970517,7972403,1886,1068,25
7976416,7975809,7977686,1877,1069,25
7981699,7981092,7982767,1675,1070,25
7986997,7986173,7988050,1877,1071,25
7992062,7991455,7994396,2941,1072,25
7998627,7997803,7999680,1877,1073,25
8003693,8003086,8004761,1675,1074,25
8008774,8008166,8010043,1877,1075,25
8014272,8013448,8015325,1877,1076,25
8019338,8018731,8021018,2287,1077,25
8025031,8024424,8026300,1876,1078,25
8030312,8029706,8031581,1875,1079,25
8035810,8034986,8036863,1877,1080,25
8040875,8040268,8042872,2604,1081,25
8047103,8046279,8048156,1877,1082,25
8052168,8051561,8053848,2287,1083,25
8057861,8057254,8059457,2203,1084,25
8063469,8062863,8064747,1884,1085,25
8068760,8068153,8070039,1886,1086,25
8074051,8073444,8075320,1876,1087,25
8079333,8078726,8081012,2286,1088,25
8085025,8084418,8091558,7140,1089,25
8095789,8094965,8096842,1877,1090,25
8101071,8100248,8102124,1876,1091,25
8106137,8105530,8108133,2603,1092,25
8112364,8111540,8113417,1877,1093,25
8117430,8116823,8119110,2287,1094,25
8123340,8122516,8124393,1877,1095,25
8128623,8127799,8129676,1877,1096,25
8133906,8133082,8134959,1877,1097,25
8138972,8138365,8140241,1876,1098,25
8144254,8143647,8146567,2920,1099,25
8150581,8149974,8151859,1885,1100,25
8156089,8155265,8157142,1877,1101,25
8161154,8160547,8163150,2603,1102,25
8167164,8166557,8168759,2202,1103,25
8172772,8172165,8174042,1877,1104,25
8178054,8177447,8179121,1674,1105,25
8183351,8182527,8184404,1877,1106,25
8188417,8187810,8189485,1675,1107,25
8193498,8192891,8194767,1876,1108,25
8198779,8198172,8201112,2940,1109,25
8205126,8204518,8207355,2837,1110,25
8211585,8210761,8212637,1876,1111,25
8216866,8216042,8217918,1876,1112,25
8222146,8221323,8223199,1876,1113,25
8227427,8226604,8228479,1875,1114,25
8232491,8231884,8233760,1876,1115,25
8237772,8237165,8239769,2604,1116,25
8243783,8243176,8245052,1876,1117,25
8249064,8248457,8250132,1675,1118,25
8254361,8253537,8255414,1877,1119,25
8259643,8258819,8260695,1876,1120,25
8264707,8264100,8266070,1970,1121,25
8270082,8269475,8271678,2203,1122,25
8275691,8275084,8277603,2519,1123,25
8281616,8281009,8283527,2518,1124,25
8287757,8286933,8288810,1877,1125,25
8292822,8292215,8294819,2604,1126,25
8299049,8298225,8300102,1877,1127,25
8304114,8303507,8305383,1876,1128,25
8309396,8308789,8311393,2604,1129,25
8315407,8314800,8317319,2519,1130,25
8321332,8320725,8322611,1886,1131,25
8326839,8326016,8327891,1875,1132,25
8331903,8331296,8334236,2940,1133,25
8338250,8337643,8339846,2203,1134,25
8343860,8343252,8345129,1877,1135,25
8349359,8348535,8350412,1877,1136,25
8354424,8353817,8356103,2286,1137,25
8360116,8359509,8361385,1876,1138,25
8365397,8364790,8367731,2941,1139,25
8371745,8371138,8373024,1886,1140,25
8377036,8376429,8379264,2835,1141,25
8383277,8382670,8384546,1876,1142,25
8388559,8387952,8389627,1675,1143,25
8393856,8393032,8394909,1877,1144,25
8399139,8398315,8400192,1877,1145,25
8404204,8403597,8405473,1876,1146,25
8409702,8408878,8410754,1876,1147,25
8414766,8414159,8416035,1876,1148,25
8420264,8419440,8421317,1877,1149,25
8425329,8424722,8426692,1970,1150,25
8430705,8430098,8432301,2203,1151,25
8436314,8435707,8437910,2203,1152,25
8441923,8441316,8443518,2202,1153,25
8447531,8446924,8449127,2203,1154,25
8453140,8452533,8455369,2836,1155,25
8459382,8458775,8460651,1876,1156,25
8464880,8464056,8465932,1876,1157,25
8469945,8469338,8471012,1674,1158,25
8475024,8474417,8476293,1876,1159,25
8480523,8479699,8481575,1876,1160,25
8485587,8484980,8486856,1876,1161,25
8490869,8490262,8492138,1876,1162,25
8496150,8495543,8497829,2286,1163,25
8501842,8501235,8503753,2518,1164,25
8507766,8507159,8509035,1876,1165,25
8513265,8512441,8514318,1877,1166,25
8518331,8517724,8519695,1971,1167,25
8523923,8523100,8524976,1876,1168,25
8529205,8528381,8530257,1876,1169,25
8534269,8533662,8535337,1675,1170,25
8539566,8538742,8540618,1876,1171,25
8544631,8544024,8546628,2604,1172,25
8550642,8550035,8552237,2202,1173,25
8556467,8555643,8557520,1877,1174,25
8561532,8560925,8562600,1675,1175,25
8566613,8566006,8567882,1876,1176,25
8571894,8571287,8572962,1675,1177,25
8576974,8576367,8579203,2836,1178,25
8583216,8582609,8585444,2835,1179,25
8589457,8588850,8591686,2836,1180,25
8595700,8595093,8597611,2518,1181,25
8601624,8601017,8602903,1886,1182,25
8606915,8606308,8609144,2836,1183,25
8613157,8612550,8615068,2518,1184,25
8619081,8618474,8621310,2836,1185,25
8625541,8624717,8626594,1877,1186,25
8630824,8630000,8631877,1877,1187,25
8635890,8635283,8636958,1675,1188,25
8640970,8640363,8642249,1886,1189,25
8646261,8645654,8648490,2836,1190,25
8652720,8651897,8653773,1876,1191,25
8657785,8657178,8659782,2604,1192,25
8663796,8663189,8666025,2836,1193,25
8670038,8669431,8671317,1886,1194,25
8675547,8674723,8676600,1877,1195,25
8680830,8680006,8681883,1877,1196,25
8685895,8685289,8687164,1875,1197,25
8691177,8690569,8692244,1675,1198,25
8696474,8695650,8697527,1877,1199,25
8701540,8700933,8702809,1876,1200,25
8706822,8706215,8709156,2941,1201,25
8713386,8712562,8714438,1876,1202,25
8718450,8717843,8719518,1675,1203,25
8723531,8722924,8725443,2519,1204,25
8729456,8728849,8731685,2836,1205,25
8735699,8735092,8737295,2203,1206,25
8741308,8740701,8742903,2202,1207,25
8746915,8746309,8749143,2834,1208,25
8753157,8752550,8754426,1876,1209,25
8758655,8757831,8759708,1877,1210,25
8763938,8763114,8764991,1877,1211,25
8769221,8768397,8770273,1876,1212,25
8774286,8773679,8775555,1876,1213,25
8779568,8778961,8781881,2920,1214,25
8786111,8785287,8787163,1876,1215,25
8791176,8790569,8793172,2603,1216,25
8797185,8796578,8798464,1886,1217,25
8802694,8801870,8803747,1877,1218,25
8807760,8807153,8809440,2287,1219,25
8813453,8812846,8814732,1886,1220,25
8818744,8818137,8820340,2203,1221,25
8824569,8823746,8825622,1876,1222,25
8829635,8829028,8831315,2287,1223,25
8835328,8834721,8836597,1876,1224,25
8840826,8840003,8841879,1876,1225,25
8845892,8845285,8847254,1969,1226,25
8851484,8850660,8852537,1877,1227,25
8856766,8855942,8857819,1877,1228,25
8862048,8861224,8863101,1877,1229,25
8867331,8866507,8868384,1877,1230,25
8872395,8871789,8873758,1969,1231,25
8877770,8877163,8879999,2836,1232,25
8884013,8883406,8885608,2202,1233,25
8889621,8889014,8891533,2519,1234,25
8895546,8894939,8896825,1886,1235,25
8900838,8900231,8902750,2519,1236,25
8906762,8906156,8908031,1875,1237,25
8912044,8911437,8914041,2604,1238,25
8918055,8917448,8920284,2836,1239,25
8924298,8923691,8926209,2518,1240,25
8930222,8929615,8931491,1876,1241,25
8935503,8934896,8936867,1971,1242,25
8940878,8940272,8943106,2834,1243,25
8947120,8946513,8949349,2836,1244,25
8953363,8952756,8954642,1886,1245,25
8958655,8958048,8959934,1886,1246,25
8963947,8963340,8966176,2836,1247,25
8970189,8969582,8972100,2518,1248,25
8976329,8975506,8977382,1876,1249,25
8981394,8980787,8983073,2286,1250,25
8987086,8986479,8988355,1876,1251,25
8992367,8991760,8994046,2286,1252,25
8998059,8997452,8999338,1886,1253,25
9003351,9002744,9005262,2518,1254,25
9009275,9008668,9010544,1876,1255,25
9014557,9013950,9016554,2604,1256,25
9020784,9019960,9021837,1877,1257,25
9025849,9025242,9026917,1675,1258,25
9030929,9030322,9032198,1876,1259,25
9036428,9035604,9037481,1877,1260,25
9041493,9040886,9043173,2287,1261,25
9047186,9046579,9048455,1876,1262,25
9052468,9051861,9053832,1971,1263,25
9057845,9057238,9060074,2836,1264,25
9064088,9063480,9065357,1877,1265,25
9069370,9068763,9070437,1674,1266,25
9074450,9073843,9076679,2836,1267,25
9080693,9080086,9081971,1885,1268,25
9086201,9085377,9087254,1877,1269,25
9091268,9090660,9092632,1972,1270,25
9096645,9096038,9098557,2519,1271,25
9102787,9101963,9103840,1877,1272,25
9108069,9107245,9109122,1877,1273,25
9113135,9112528,9114497,1969,1274,25
9118510,9117903,9119788,1885,1275,25
9123801,9123194,9125070,1876,1276,25
9129082,9128475,9131394,2919,1277,25
9135408,9134801,9136677,1876,1278,25
9140689,9140082,9142369,2287,1279,25
9146382,9145775,9147977,2202,1280,25
9151990,9151383,9153270,1887,1281,25
9157283,9156676,9158552,1876,1282,25
9162565,9161958,9164877,2919,1283,25
9169108,9168284,9170161,1877,1284,25
9174174,9173567,9176170,2603,1285,25
9180400,9179576,9181452,1876,1286,25
9185465,9184858,9186734,1876,1287,25
9190963,9190139,9192016,1877,1288,25
9196029,9195422,9198342,2920,1289,25
9202356,9201749,9203625,1876,1290,25
9207638,9207031,9208907,1876,1291,25
9212919,9212312,9214916,2604,1292,25
9218930,9218323,9220526,2203,1293,25
9224756,9223932,9225808,1876,1294,25
9229820,9229213,9230888,1675,1295,25
9234900,9234293,9236812,2519,1296,25
9240825,9240218,9242094,1876,1297,25
9246106,9245499,9247786,2287,1298,25
9251799,9251192,9253711,2519,1299,25
9257941,9257117,9258993,1876,1300,25
9263005,9262398,9264685,2287,1301,25
9268915,9268091,9269967,1876,1302,25
9273979,9273372,9275046,1674,1303,25
9279059,9278452,9280654,2202,1304,25
9284666,9284059,9285935,1876,1305,25
9289947,9289340,9292260,2920,1306,25
9296273,9295666,9297542,1876,1307,25
9301772,9300948,9302825,1877,1308,25
9306838,9306231,9309150,2919,1309,25
9313381,9312557,9314433,1876,1310,25
9318445,9317838,9320124,2286,1311,25
9324137,9323530,9325416,1886,1312,25
9329644,9328821,9330697,1876,1313,25
9334710,9334103,9336074,1971,1314,25
9340087,9339480,9342316,2836,1315,25
9346330,9345723,9348559,2836,1316,25
9352573,9351966,9353842,1876,1317,25
9357854,9357247,9359218,1971,1318,25
9363446,9362623,9364499,1876,1319,25
9368512,9367905,9370509,2604,1320,25
9374523,9373916,9376751,2835,1321,25
9380765,9380158,9382361,2203,1322,25
9386374,9385767,9387643,1876,1323,25
9391655,9391048,9392723,1675,1324,25
9396953,9396129,9398006,1877,1325,25
9402235,9401412,9403288,1876,1326,25
9407301,9406694,9408665,1971,1327,25
9412678,9412071,9414274,2203,1328,25
9418287,9417680,9420515,2835,1329,25
9424746,9423922,9425799,1877,1330,25
9429811,9429204,9432123,2919,1331,25
9436136,9435530,9437405,1875,1332,25
9441418,9440811,9442687,1876,1333,25
9446917,9446093,9447970,1877,1334,25
9451982,9451376,9454295,2919,1335,25
9458309,9457702,9459578,1876,1336,25
9463590,9462983,9464954,1971,1337,25
9468968,9468360,9470247,1887,1338,25
9474260,9473653,9475529,1876,1339,25
9479540,9478934,9480809,1875,1340,25
9484822,9484215,9486091,1876,1341,25
9490103,9489496,9491467,1971,1342,25
9495479,9494872,9497707,2835,1343,25
9501721,9501114,9502990,1876,1344,25
9507003,9506396,9508367,1971,1345,25
9512379,9511772,9513658,1886,1346,25
9517670,9517063,9518939,1876,1347,25
9522952,9522345,9525265,2920,1348,25
9529496,9528672,9530549,1877,1349,25
9534562,9533955,9536242,2287,1350,25
9540255,9539648,9542168,2520,1351,25
9546398,9545574,9547451,1877,1352,25
9551681,9550857,9552734,1877,1353,25
9556747,9556140,9558744,2604,1354,25
9562758,9562151,9564037,1886,1355,25
9568267,9567443,9569320,1877,1356,25
9573333,9572726,9575013,2287,1357,25
9579026,9578419,9581254,2835,1358,25
9585485,9584661,9586538,1877,1359,25
9590551,9589944,9591619,1675,1360,25
9595849,9595025,9596902,1877,1361,25
9600915,9600308,9602912,2604,1362,25
9606925,9606318,9608837,2519,1363,25
9613067,9612243,9614120,1877,1364,25
9618133,9617526,9620130,2604,1365,25
9624144,9623537,9626373,2836,1366,25
9630603,9629779,9631656,1877,1367,25
9635886,9635062,9636939,1877,1368,25
9640952,9640345,9643265,2920,1369,25
9647279,9646672,9649191,2519,1370,25
9653204,9652597,9655432,2835,1371,25
9659446,9658839,9660715,1876,1372,25
9664728,9664121,9667040,2919,1373,25
9671054,9670447,9672966,2519,1374,25
9676979,9676372,9679208,2836,1375,25
9683223,9682615,9684492,1877,1376,25
9688722,9687898,9689775,1877,1377,25
9693787,9693180,9695467,2287,1378,25
9699697,9698873,9700750,1877,1379,25
9704763,9704156,9705831,1675,1380,25
9710060,9709236,9711113,1877,1381,25
9715127,9714519,9716194,1675,1382,25
9720424,9719600,9721477,1877,1383,25
9725490,9724883,9726852,1969,1384,25
9730865,9730258,9732143,1885,1385,25
9736155,9735548,9737424,1876,1386,25
9741437,9740830,9742504,1674,1387,25
9746516,9745909,9747786,1877,1388,25
9751799,9751192,9754112,2920,1389,25
9758125,9757518,9760036,2518,1390,25
9764048,9763442,9765317,1875,1391,25
9769330,9768723,9770693,1970,1392,25
9774706,9774099,9776618,2519,1393,25
9780631,9780024,9781910,1886,1394,25
9785923,9785316,9787192,1876,1395,25
9791422,9790598,9792475,1877,1396,25
9796705,9795881,9797758,1877,1397,25
9801771,9801164,9802839,1675,1398,25
9806852,9806245,9808448,2203,1399,25
9812461,9811854,9813740,1886,1400,25
9817969,9817146,9819022,1876,1401,25
9823035,9822428,9824103,1675,1402,25
9828116,9827509,9829712,2203,1403,25
9833725,9833118,9834994,1876,1404,25
9839224,9838400,9840277,1877,1405,25
9844289,9843682,9845653,1971,1406,25
9849665,9849058,9850934,1876,1407,25
9855164,9854340,9856217,1877,1408,25
9860230,9859623,9862226,2603,1409,25
9866239,9865632,9867508,1876,1410,25
9871521,9870914,9873833,2919,1411,25
9878064,9877240,9879117,1877,1412,25
9883129,9882523,9884197,1674,1413,25
9888209,9887602,9890438,2836,1414,25
9894669,9893845,9895722,1877,1415,25
9899734,9899127,9902047,2920,1416,25
9906061,9905454,9908289,2835,1417,25
9912303,9911696,9914532,2836,1418,25
9918545,9917938,9920456,2518,1419,25
9924469,9923862,9926697,2835,1420,25
9930711,9930104,9932622,2518,1421,25
9936851,9936028,9937904,1876,1422,25
9941916,9941309,9943596,2287,1423,25
9947609,9947002,9948878,1876,1424,25
9952890,9952283,9955203,2920,1425,25
9959217,9958610,9960812,2202,1426,25
9964825,9964218,9966420,2202,1427,25
9970433,9969826,9971702,1876,1428,25
9975932,9975108,9976985,1877,1429,25
9980997,9980390,9982065,1675,1430,25
9986078,9985471,9987990,2519,1431,25
9992003,9991396,9993599,2203,1432,25
9997829,9997005,9998882,1877,1433,25
10002894,10002287,10004260,1973,1434,25
10008537,10007930,10010513,2583,1435,25
10015008,10014184,10016063,1879,1436,25
10020340,10019733,10021748,2015,1437,25
10026242,10025418,10027297,1879,1438,25
10031574,10030967,10033320,2353,1439,25
10037814,10036990,10038869,1879,1440,25
10043145,10042539,10044891,2352,1441,25
10049169,10048561,10050809,2248,1442,25
10055303,10054479,10056358,1879,1443,25
10060852,10060028,10061907,1879,1444,25
10066184,10065577,10067592,2015,1445,25
10071869,10071262,10073141,1879,1446,25
10077635,10077028,10078690,1662,1447,25
10082967,10082360,10084375,2015,1448,25
10088652,10088045,10090292,2247,1449,25
10094569,10093962,10095639,1677,1450,25
10100055,10099448,10101110,1662,1451,25
10105387,10104780,10106658,1878,1452,25
10110935,10110328,10112207,1879,1453,25
10116484,10115877,10117892,2015,1454,25
10122386,10121562,10123441,1879,1455,25
10127718,10127111,10128810,1699,1456,25
10133087,10132480,10134359,1879,1457,25
10138636,10138029,10139908,1879,1458,25
10144185,10143578,10145593,2015,1459,25
10149870,10149263,10151847,2584,1460,25
10156125,10155518,10157195,1677,1461,25
10161472,10160865,10162542,1677,1462,25
10167036,10166212,10168091,1879,1463,25
10172368,10171761,10173640,1879,1464,25
10177917,10177310,10179188,1878,1465,25
10183465,10182858,10184737,1879,1466,25
10189221,10188614,10190276,1662,1467,25
10194553,10193946,10195961,2015,1468,25
10200237,10199631,10201509,1878,1469,25
10205786,10205179,10207058,1879,1470,25
10211335,10210728,10212743,2015,1471,25
10217021,10216414,10218660,2246,1472,25
10222938,10222331,10224578,2247,1473,25
10228855,10228248,10230495,2247,1474,25
10234773,10234166,10236097,1931,1475,25
10240506,10239899,10241560,1661,1476,25
10245837,10245230,10247264,2034,1477,25
10251757,10250934,10252812,1878,1478,25
10257305,10256698,10258359,1661,1479,25
10262635,10262028,10264380,2352,1480,25
10268874,10268050,10269928,1878,1481,25
10274205,10273597,10275476,1879,1482,25
10279753,10279146,10280844,1698,1483,25
10285121,10284514,10286392,1878,1484,25
10290669,10290062,10292731,2669,1485,25
10297009,10296402,10298332,1930,1486,25
10302609,10302002,10304587,2585,1487,25
10308864,10308257,10310135,1878,1488,25
10314412,10313805,10315502,1697,1489,25
10319779,10319172,10321050,1878,1490,25
10325327,10324720,10326598,1878,1491,25
10331091,10330484,10332146,1662,1492,25
10336423,10335816,10337831,2015,1493,25
10342325,10341501,10343380,1879,1494,25
10347656,10347049,10348928,1879,1495,25
10353205,10352598,10354296,1698,1496,25
10358572,10357966,10359894,1928,1497,25
10364171,10363564,10365241,1677,1498,25
10369518,10368911,10371496,2585,1499,25
10375774,10375167,10377752,2585,1500,25
10382030,10381423,10384008,2585,1501,25
10388286,10387679,10389356,1677,1502,25
10393755,10393148,10394810,1662,1503,25
10399087,10398480,10400495,2015,1504,25
10404772,10404165,10406044,1879,1505,25
10410537,10409713,10411592,1879,1506,25
10415869,10415262,10417277,2015,1507,25
10421668,10421061,10422723,1662,1508,25
10427000,10426393,10428408,2015,1509,25
10432685,10432078,10434663,2585,1510,25
10439078,10438471,10440133,1662,1511,25
10444410,10443803,10445682,1879,1512,25
10449959,10449352,10451367,2015,1513,25
10455644,10455037,10456916,1879,1514,25
10461193,10460586,10462939,2353,1515,25
10467333,10466726,10468388,1662,1516,25
10472665,10472058,10473936,1878,1517,25
10478213,10477606,10480274,2668,1518,25
10484552,10483945,10485876,1931,1519,25
10490370,10489546,10491425,1879,1520,25
10495703,10495096,10496975,1879,1521,25
10501253,10500646,10502525,1879,1522,25
10507019,10506195,10508074,1879,1523,25
10512352,10511745,10514098,2353,1524,25
10518376,10517769,10519648,1879,1525,25
10523926,10523319,10525988,2669,1526,25
10530267,10529660,10531338,1678,1527,25
10535832,10535008,10536887,1879,1528,25
10541381,10540774,10542436,1662,1529,25
10546931,10546107,10547986,1879,1530,25
10552263,10551656,10554009,2353,1531,25
10558287,10557680,10560265,2585,1532,25
10564544,10563937,10565816,1879,1533,25
10570094,10569487,10571839,2352,1534,25
10576117,10575510,10577440,1930,1535,25
10581718,10581111,10582990,1879,1536,25
10587267,10586661,10588539,1878,1537,25
10592817,10592210,10594563,2353,1538,25
10598841,10598234,10600481,2247,1539,25
10604759,10604152,10606398,2246,1540,25
10610676,10610069,10612317,2248,1541,25
10616594,10615988,10617665,1677,1542,25
10621943,10621336,10623583,2247,1543,25
10627861,10627254,10629838,2584,1544,25
10634117,10633510,10635188,1678,1545,25
10639466,10638859,10640738,1879,1546,25
10645016,10644409,10647079,2670,1547,25
10651482,10650875,10652537,1662,1548,25
10656814,10656207,10658876,2669,1549,25
10663155,10662548,10664427,1879,1550,25
10668921,10668097,10669976,1879,1551,25
10674254,10673647,10675526,1879,1552,25
10679803,10679196,10681075,1879,1553,25
10685569,10684962,10686624,1662,1554,25
10691119,10690295,10692174,1879,1555,25
10696452,10695845,10697544,1699,1556,25
10701822,10701215,10703799,2584,1557,25
10708078,10707471,10709149,1678,1558,25
10713427,10712820,10714699,1879,1559,25
10718977,10718370,10720249,1879,1560,25
10724527,10723920,10725799,1879,1561,25
10730077,10729470,10731349,1879,1562,25
10735627,10735020,10736718,1698,1563,25
10740996,10740389,10742637,2248,1564,25
10746915,10746308,10747986,1678,1565,25
10752381,10751774,10753436,1662,1566,25
10757931,10757107,10758986,1879,1567,25
10763264,10762657,10765010,2353,1568,25
10769505,10768681,10770560,1879,1569,25
10774839,10774231,10775931,1700,1570,25
10780209,10779602,10781481,1879,1571,25
10785759,10785152,10787030,1878,1572,25
10791308,10790701,10793371,2670,1573,25
10797867,10797043,10798922,1879,1574,25
10803200,10802593,10804292,1699,1575,25
10808709,10808102,10809764,1662,1576,25
10814259,10813435,10815314,1879,1577,25
10819592,10818985,10820864,1879,1578,25
10825350,10824743,10826405,1662,1579,25
10830683,10830076,10832428,2352,1580,25
10836706,10836099,10837978,1879,1581,25
10842256,10841649,10843347,1698,1582,25
10847625,10847018,10849265,2247,1583,25
10853543,10852936,10854614,1678,1584,25
10858892,10858285,10859963,1678,1585,25
10864241,10863634,10865881,2247,1586,25
10870160,10869553,10871231,1678,1587,25
10875509,10874902,10876781,1879,1588,25
10881059,10880452,10882805,2353,1589,25
10887300,10886476,10888355,1879,1590,25
10892850,10892026,10893905,1879,1591,25
10898183,10897576,10899455,1879,1592,25
10903733,10903126,10905479,2353,1593,25
10909975,10909151,10911030,1879,1594,25
10915308,10914701,10916580,1879,1595,25
10920858,10920251,10921950,1699,1596,25
10926227,10925620,10927868,2248,1597,25
10932146,10931539,10933787,2248,1598,25
10938065,10937458,10939337,1879,1599,25
10946961,10946137,10948016,1879,1600,25
10952497,10951890,10953552,1662,1601,25
10957830,10957223,10959238,2015,1602,25
10963734,10962910,10964789,1879,1603,25
10969067,10968460,10970339,1879,1604,25
10974617,10974010,10975709,1699,1605,25
10980204,10979380,10981259,1879,1606,25
10985537,10984930,10986628,1698,1607,25
10990907,10990299,10991977,1678,1608,25
10996256,10995649,10997528,1879,1609,25
11001807,11001200,11003552,2352,1610,25
11007831,11007224,11009103,1879,1611,25
11013598,11012991,11014653,1662,1612,25
11019149,11018325,11020204,1879,1613,25
11024691,11024084,11025746,1662,1614,25
11030024,11029417,11031433,2016,1615,25
11035929,11035105,11036984,1879,1616,25
11041264,11040656,11043326,2670,1617,25
11047727,11047120,11048782,1662,1618,25
11053060,11052453,11054151,1698,1619,25
11058429,11057822,11060407,2585,1620,25
11064805,11064198,11065860,1662,1621,25
11070138,11069531,11071230,1699,1622,25
11075726,11074902,11076781,1879,1623,25
11081060,11080453,11082468,2015,1624,25
11086964,11086140,11088019,1879,1625,25
11092298,11091691,11093570,1879,1626,25
11098066,11097242,11099121,1879,1627,25
11103400,11102793,11105462,2669,1628,25
11109741,11109134,11111013,1879,1629,25
11115504,11114685,11116559,1874,1630,25
11120837,11120230,11122109,1879,1631,25
11126387,11125780,11127479,1699,1632,25
11131974,11131150,11133029,1879,1633,25
11137308,11136701,11139054,2353,1634,25
11143333,11142726,11144974,2248,1635,25
11149253,11148646,11150894,2248,1636,25
11155173,11154566,11156244,1678,1637,25
11160740,11159916,11161795,1879,1638,25
11166291,11165467,11167346,1879,1639,25
11171842,11171018,11172897,1879,1640,25
11177176,11176569,11178448,1879,1641,25
11182727,11182120,11184473,2353,1642,25
11188752,11188145,11189823,1678,1643,25
11194319,11193495,11195374,1879,1644,25
11199653,11199046,11201399,2353,1645,25
11205895,11205071,11206950,1879,1646,25
11211229,11210622,11212638,2016,1647,25
11216917,11216310,11218241,1931,1648,25
11222520,11221913,11223591,1678,1649,25
11227870,11227263,11228941,1678,1650,25
11233219,11232612,11234491,1879,1651,25
11238770,11238163,11240516,2353,1652,25
11245012,11244188,11246067,1879,1653,25
11250562,11249955,11251617,1662,1654,25
11256099,11255492,11257154,1662,1655,25
11261649,11260825,11262704,1879,1656,25
11266983,11266376,11269045,2669,1657,25
11273324,11272717,11274596,1879,1658,25
11278874,11278267,11280146,1879,1659,25
11284425,11283818,11285833,2015,1660,25
11290112,11289505,11291183,1678,1661,25
11295604,11294997,11296659,1662,1662,25
11300937,11300330,11302028,1698,1663,25
11306423,11305816,11307478,1662,1664,25
11311756,11311149,11313028,1879,1665,25
11317306,11316699,11318397,1698,1666,25
11322676,11322069,11324317,2248,1667,25
11328596,11327989,11330235,2246,1668,25
11334651,11334044,11335706,1662,1669,25
11339984,11339377,11341393,2016,1670,25
11345672,11345065,11347650,2585,1671,25
11352147,11351323,11353202,1879,1672,25
11357482,11356874,11359228,2354,1673,25
11363724,11362900,11364779,1879,1674,25
11369058,11368451,11370466,2015,1675,25
11374962,11374138,11376017,1879,1676,25
11380295,11379688,11381703,2015,1677,25
11386095,11385488,11387150,1662,1678,25
11391429,11390822,11392838,2016,1679,25
11397117,11396510,11398188,1678,1680,25
11402467,11401860,11403739,1879,1681,25
11408018,11407411,11409764,2353,1682,25
11414043,11413436,11415367,1931,1683,25
11419645,11419039,11421623,2584,1684,25
11426120,11425296,11427175,1879,1685,25
11431671,11430847,11432726,1879,1686,25
11437004,11436397,11438413,2016,1687,25
11442909,11442085,11443964,1879,1688,25
11448242,11447635,11449987,2352,1689,25
11454266,11453659,11455538,1879,1690,25
11459817,11459210,11461085,1875,1691,25
11465363,11464756,11466635,1879,1692,25
11470914,11470307,11472977,2670,1693,25
11477256,11476649,11478327,1678,1694,25
11482605,11481998,11483929,1931,1695,25
11488207,11487600,11489531,1931,1696,25
11493810,11493203,11495082,1879,1697,25
11499361,11498754,11501424,2670,1698,25
11505827,11505220,11506882,1662,1699,25
11511161,11510554,11512252,1698,1700,25
11516530,11515923,11518170,2247,1701,25
11522449,11521842,11523721,1879,1702,25
11528215,11527608,11529270,1662,1703,25
11533765,11532941,11534820,1879,1704,25
11539099,11538491,11540371,1880,1705,25
11544649,11544042,11546712,2670,1706,25
11551209,11550385,11552264,1879,1707,25
11556750,11556143,11557805,1662,1708,25
11562299,11561476,11563354,1878,1709,25
11567632,11567025,11568904,1879,1710,25
11573183,11572576,11574275,1699,1711,25
11578553,11577946,11580531,2585,1712,25
11584811,11584204,11586452,2248,1713,25
11590948,11590124,11592003,1879,1714,25
11596497,11595890,11597552,1662,1715,25
11601830,11601223,11603576,2353,1716,25
11607855,11607248,11608926,1678,1717,25
11613204,11612597,11617377,4780,1718,25
11621657,11621050,11622929,1879,1719,25
11627207,11626600,11637247,10647,1720,25
11641615,11641008,11643487,2479,1721,25
11647766,11647159,11648837,1678,1722,25
11653115,11652508,11655093,2585,1723,25
11659489,11658882,11660544,1662,1724,25
11664822,11664215,11665913,1698,1725,25
11670191,11669584,11672170,2586,1726,25
11676666,11675843,11677721,1878,1727,25
11681999,11681392,11683406,2014,1728,25
11687685,11687078,11689009,1931,1729,25
11693505,11692681,11694560,1879,1730,25
11698840,11698232,11699932,1700,1731,25
11704427,11703603,11705482,1879,1732,25
11709761,11709154,11711824,2670,1733,25
11716104,11715497,11717376,1879,1734,25
11721655,11721048,11723718,2670,1735,25
11727998,11727391,11729955,2564,1736,25
11734451,11733627,11735506,1879,1737,25
11739785,11739178,11740876,1698,1738,25
11745154,11744547,11747133,2586,1739,25
11751413,11750806,11753053,2247,1740,25
11757332,11756725,11759310,2585,1741,25
11763730,11763123,11764785,1662,1742,25
11769064,11768457,11770156,1699,1743,25
11774574,11773967,11775629,1662,1744,25
11779908,11779301,11781316,2015,1745,25
11785595,11784988,11787234,2246,1746,25
11791513,11790906,11792785,1879,1747,25
11797064,11796457,11798336,1879,1748,25
11802615,11802008,11804023,2015,1749,25
11808518,11807695,11809573,1878,1750,25
11813852,11813245,11815914,2669,1751,25
11820194,11819587,11821265,1678,1752,25
11825681,11825074,11826736,1662,1753,25
11831014,11830407,11832423,2016,1754,25
11836702,11836095,11837974,1879,1755,25
11842252,11841645,11843524,1879,1756,25
11847802,11847195,11849865,2670,1757,25
11854362,11853538,11855417,1879,1758,25
11859696,11859089,11860968,1879,1759,25
11865247,11864640,11866656,2016,1760,25
11870935,11870328,11872913,2585,1761,25
11877193,11876586,11878264,1678,1762,25
11882543,11881936,11884521,2585,1763,25
11889017,11888193,11890072,1879,1764,25
11894350,11893743,11895622,1879,1765,25
11900117,11899293,11901172,1879,1766,25
11905450,11904843,11906722,1879,1767,25
11911215,11910608,11912270,1662,1768,25
11916549,11915942,11917821,1879,1769,25
11922316,11921492,11923371,1879,1770,25
11927649,11927042,11928921,1879,1771,25
11933416,11932809,11934471,1662,1772,25
11938749,11938142,11940811,2669,1773,25
11945090,11944483,11947068,2585,1774,25
11951348,11950741,11952419,1678,1775,25
11956914,11956090,11957969,1879,1776,25
11962465,11961858,11963520,1662,1777,25
11967799,11967191,11969862,2671,1778,25
11974142,11973535,11975414,1879,1779,25
11979693,11979086,11981756,2670,1780,25
11986036,11985429,11987677,2248,1781,25
11991956,11991349,11993597,2248,1782,25
11998008,11997401,11999063,1662,1783,25
12003342,12002735,12005405,2670,1784,25
12009685,12009078,12010756,1678,1785,25
12015034,12014427,12016306,1879,1786,25
12020585,12019978,12021677,1699,1787,25
12025955,12025348,12027278,1930,1788,25
12031558,12030950,12032830,1880,1789,25
12037110,12036502,12039172,2670,1790,25
12043452,12042845,12045093,2248,1791,25
12049589,12048765,12050644,1879,1792,25
12054923,12054316,12056986,2670,1793,25
12061405,12060798,12062460,1662,1794,25
12066739,12066132,12068802,2670,1795,25
12073196,12072589,12074251,1662,1796,25
12078530,12077923,12079937,2014,1797,25
12084218,12083610,12085490,1880,1798,25
12089769,12089162,12091177,2015,1799,25
12095456,12094849,12097097,2248,1800,25
12101376,12100769,12102648,1879,1801,25
12106927,12106320,12108199,1879,1802,25
12112478,12111871,12113750,1879,1803,25
12118245,12117639,12119300,1661,1804,25
12123795,12122972,12124850,1878,1805,25
12129129,12128522,12131192,2670,1806,25
12135689,12134865,12136744,1879,1807,25
12141023,12140416,12143086,2670,1808,25
12147366,12146759,12149322,2563,1809,25
12153602,12152995,12154673,1678,1810,25
12158952,12158345,12160276,1931,1811,25
12164555,12163948,12166533,2585,1812,25
12170813,12170205,12172137,1932,1813,25
12176633,12175809,12177688,1879,1814,25
12181967,12181360,12183376,2016,1815,25
12187655,12187048,12188726,1678,1816,25
12193004,12192397,12194276,1879,1817,25
12198555,12197948,12200301,2353,1818,25
12204797,12203973,12205852,1879,1819,25
12210131,12209524,12212193,2669,1820,25
12216605,12215998,12217660,1662,1821,25
12222151,12221332,12223206,1874,1822,25
12227485,12226878,12228757,1879,1823,25
12233036,12232429,12234308,1879,1824,25
12238587,12237980,12239859,1879,1825,25
12244138,12243531,12246200,2669,1826,25
12250696,12249873,12251751,1878,1827,25
12256030,12255423,12257776,2353,1828,25
12262273,12261449,12263328,1879,1829,25
12267607,12267000,12269353,2353,1830,25
12273633,12273026,12275274,2248,1831,25
12279554,12278947,12281195,2248,1832,25
12285474,12284867,12286797,1930,1833,25
12291076,12290469,12292348,1879,1834,25
12296626,12296019,12297894,1875,1835,25
12302172,12301565,12303444,1879,1836,25
12307722,12307115,12309468,2353,1837,25
12313747,12313140,12315071,1931,1838,25
12319350,12318743,12321327,2584,1839,25
12325742,12325135,12326797,1662,1840,25
12331076,12330469,12332167,1698,1841,25
12336445,12335838,12338423,2585,1842,25
12342703,12342096,12344026,1930,1843,25
12348434,12347827,12349489,1662,1844,25
12353768,12353161,12355176,2015,1845,25
12359672,12358848,12360727,1879,1846,25
12365223,12364399,12366278,1879,1847,25
12370774,12369950,12371829,1879,1848,25
12376108,12375501,12377380,1879,1849,25
12381875,12381268,12382930,1662,1850,25
12387209,12386602,12388481,1879,1851,25
12392760,12392153,12394032,1879,1852,25
12398311,12397704,12399402,1698,1853,25
12403805,12403198,12404860,1662,1854,25
12409138,12408531,12410410,1879,1855,25
12414688,12414081,12416751,2670,1856,25
12421031,12420424,12422102,1678,1857,25
12426499,12425892,12427554,1662,1858,25
12431833,12431226,12433242,2016,1859,25
12437521,12436914,12438592,1678,1860,25
12443088,12442264,12444143,1879,1861,25
12448422,12447815,12449694,1879,1862,25
12454190,12453366,12455245,1879,1863,25
12459524,12458917,12461586,2669,1864,25
12465998,12465391,12467053,1662,1865,25
12471332,12470725,12472740,2015,1866,25
12477235,12476412,12478290,1878,1867,25
12482770,12482163,12483825,1662,1868,25
12488104,12487497,12489512,2015,1869,25
12494008,12493184,12495063,1879,1870,25
12499341,12498734,12500613,1879,1871,25
12505108,12504285,12506163,1878,1872,25
12510442,12509835,12511714,1879,1873,25
12516210,12515386,12517265,1879,1874,25
12521747,12521140,12522802,1662,1875,25
12527081,12526474,12528352,1878,1876,25
12532630,12532023,12533902,1879,1877,25
12538181,12537574,12539272,1698,1878,25
12543673,12543066,12544728,1662,1879,25
12549224,12548400,12550279,1879,1880,25
12554558,12553951,12556303,2352,1881,25
12560582,12559975,12566866,6891,1882,25
12571146,12570539,12572418,1879,1883,25
12576697,12576090,12578760,2670,1884,25
12583040,12582433,12584996,2563,1885,25
12589276,12588669,12590347,1678,1886,25
12594745,12594138,12595800,1662,1887,25
12600079,12599472,12601824,2352,1888,25
12606103,12605496,12607174,1678,1889,25
12611571,12610964,12612626,1662,1890,25
12616905,12616298,12618177,1879,1891,25
12622456,12621849,12623728,1879,1892,25
12628217,12627610,12629272,1662,1893,25
12633550,12632943,12634642,1699,1894,25
12639063,12638455,12640118,1663,1895,25
12644397,12643790,12646460,2670,1896,25
12650740,12650133,12652697,2564,1897,25
12656977,12656370,12658616,2246,1898,25
12662895,12662288,12663966,1678,1899,25
12668462,12667638,12669517,1879,1900,25
12673796,12673189,12675542,2353,1901,25
12679821,12679214,12681145,1931,1902,25
12685424,12684817,12686747,1930,1903,25
12691243,12690419,12692298,1879,1904,25
12696577,12695970,12697986,2016,1905,25
12702388,12701781,12703443,1662,1906,25
12707722,12707115,12709467,2352,1907,25
12713963,12713139,12715018,1879,1908,25
12719297,12718690,12720706,2016,1909,25
12724985,12724378,12726056,1678,1910,25
12730335,12729728,12732314,2586,1911,25
12736594,12735987,12737917,1930,1912,25
12742413,12741589,12743468,1879,1913,25
12747964,12747140,12749019,1879,1914,25
12753298,12752691,12754390,1699,1915,25
12758792,12758185,12759847,1662,1916,25
12764343,12763519,12765398,1879,1917,25
12769882,12769275,12770937,1662,1918,25
12775430,12774609,12776485,1876,1919,25
12780764,12780157,12782510,2353,1920,25
12786789,12786182,12788429,2247,1921,25
12792925,12792101,12793980,1879,1922,25
12798259,12797652,12799531,1879,1923,25
12803810,12803203,12804902,1699,1924,25
12809397,12808573,12810452,1879,1925,25
12814730,12814123,12816476,2353,1926,25
12820972,12820148,12822027,1879,1927,25
12826305,12825698,12828050,2352,1928,25
12832329,12831722,12834307,2585,1929,25
12838586,12837979,12840227,2248,1930,25
12844635,12844028,12845690,1662,1931,25
12849969,12849362,12851715,2353,1932,25
12855994,12855387,12857317,1930,1933,25
12861737,12861130,12862792,1662,1934,25
12867071,12866464,12868817,2353,1935,25
12873096,12872489,12874368,1879,1936,25
12878858,12878040,12879913,1873,1937,25
12884192,12883585,12885283,1698,1938,25
12889778,12888954,12890833,1879,1939,25
12895329,12894505,12896384,1879,1940,25
12900663,12900056,12901935,1879,1941,25
12906214,12905607,12907623,2016,1942,25
12911902,12911295,12913174,1879,1943,25
12917654,12917047,12918709,1662,1944,25
12923204,12922380,12924259,1879,1945,25
12928538,12927931,12930283,2352,1946,25
12934779,12933955,12935834,1879,1947,25
12940113,12939506,12941522,2016,1948,25
12946018,12945194,12947073,1879,1949,25
12951352,12950745,12953098,2353,1950,25
12957502,12956895,12958557,1662,1951,25
12962836,12962229,12964898,2669,1952,25
12969394,12968570,12970449,1879,1953,25
12974727,12974120,12975819,1699,1954,25
12980097,12979490,12981168,1678,1955,25
12985446,12984839,12986718,1879,1956,25
12990996,12990389,12992741,2352,1957,25
12997020,12996413,12998998,2585,1958,25
13003494,13002671,13004549,1878,1959,25
13008828,13008221,13010236,2015,1960,25
13014514,13013908,13016155,2247,1961,25
13020434,13019827,13022391,2564,1962,25
13026671,13026064,13027943,1879,1963,25
13032439,13031615,13033494,1879,1964,25
13037773,13037166,13039180,2014,1965,25
13043459,13042852,13044731,1879,1966,25
13049010,13048403,13050282,1879,1967,25
13054560,13053953,13055830,1877,1968,25
13060109,13059502,13061381,1879,1969,25
13065661,13065053,13067386,2333,1970,25
13071665,13071058,13073622,2564,1971,25
13078119,13077295,13079174,1879,1972,25
13083453,13082846,13084545,1699,1973,25
13089041,13088217,13090096,1879,1974,25
13094375,13093768,13095647,1879,1975,25
13099926,13099319,13101198,1879,1976,25
13105478,13104870,13106750,1880,1977,25
13111246,13110422,13112301,1879,1978,25
13116579,13115972,13118642,2670,1979,25
13122922,13122314,13124194,1880,1980,25
13128689,13127865,13129744,1879,1981,25
13134239,13133415,13135294,1879,1982,25
13139572,13138965,13141318,2353,1983,25
13145597,13144990,13146920,1930,1984,25
13151198,13150591,13152269,1678,1985,25
13156765,13155941,13157820,1879,1986,25
13162099,13161492,13164162,2670,1987,25
13168441,13167834,13169512,1678,1988,25
13174007,13173183,13175062,1879,1989,25
13179557,13178950,13180612,1662,1990,25
13185107,13184283,13186162,1879,1991,25
13190440,13189833,13191712,1879,1992,25
13195990,13195383,13197262,1879,1993,25
13201541,13200934,13202949,2015,1994,25
13207445,13206621,13208500,1879,1995,25
13212778,13212171,13213869,1698,1996,25
13218364,13217540,13219419,1879,1997,25
13223697,13223090,13224789,1699,1998,25
13229068,13228461,13230139,1678,1999,25
13234418,13233811,13236396,2585,2000,25
13240893,13240069,13241948,1879,2001,25
13246227,13245620,13247319,1699,2002,25
13251598,13250991,13252669,1678,2003,25
13256948,13256341,13258272,1931,2004,25
13262551,13261944,13264528,2584,2005,25
13269024,13268201,13270079,1878,2006,25
13274574,13273751,13275629,1878,2007,25
13279908,13279301,13281971,2670,2008,25
13286251,13285644,13288229,2585,2009,25
13292643,13292036,13293698,1662,2010,25
13297977,13297370,13299249,1879,2011,25
13303528,13302921,13305590,2669,2012,25
13309870,13309263,13311194,1931,2013,25
13315689,13314866,13316744,1878,2014,25
13321233,13320626,13322288,1662,2015,25
13326566,13325959,13327974,2015,2016,25
13332386,13331779,13333441,1662,2017,25
13337719,13337112,13339465,2353,2018,25
13343744,13343137,13345068,1931,2019,25
13349347,13348740,13351325,2585,2020,25
13355822,13354998,13356877,1879,2021,25
13361156,13360549,13362564,2015,2022,25
13366843,13366236,13368167,1931,2023,25
13372587,13371980,13373642,1662,2024,25
13377921,13377314,13379984,2670,2025,25
13384264,13383657,13385588,1931,2026,25
13389867,13389260,13391844,2584,2027,25
13396124,13395517,13397448,1931,2028,25
13401944,13401120,13402999,1879,2029,25
13407278,13406671,13408550,1879,2030,25
13413046,13412222,13414101,1879,2031,25
13418380,13417773,13419652,1879,2032,25
13423931,13423324,13425203,1879,2033,25
13429482,13428875,13430754,1879,2034,25
13435033,13434426,13436305,1879,2035,25
13440786,13440179,13441841,1662,2036,25
13446119,13445512,13447391,1879,2037,25
13451671,13451063,13453417,2354,2038,25
13457696,13457089,13459673,2584,2039,25
13463953,13463346,13465277,1931,2040,25
13469556,13468949,13471197,2248,2041,25
13475476,13474869,13476748,1879,2042,25
13481027,13480420,13483090,2670,2043,25
13487370,13486763,13488642,1879,2044,25
13493137,13492314,13494192,1878,2045,25
13498471,13497864,13499563,1699,2046,25
13503842,13503235,13504913,1678,2047,25
13509409,13508585,13510464,1879,2048,25
13514743,13514136,13516015,1879,2049,25
13520294,13519687,13522040,2353,2050,25
13526535,13525712,13527590,1878,2051,25
13531869,13531262,13533615,2353,2052,25
13537894,13537287,13539166,1879,2053,25
13543445,13542838,13545508,2670,2054,25
13549788,13549181,13550859,1678,2055,25
13555355,13554531,13556410,1879,2056,25
13560689,13560082,13561781,1699,2057,25
13566060,13565453,13567130,1677,2058,25
13571409,13570802,13572733,1931,2059,25
13577012,13576405,13578990,2585,2060,25
13583270,13582663,13584911,2248,2061,25
13589331,13588723,13590386,1663,2062,25
13594665,13594058,13595937,1879,2063,25
13600433,13599609,13601488,1879,2064,25
13605767,13605160,13607039,1879,2065,25
13611318,13610711,13612590,1879,2066,25
13617086,13616262,13618141,1879,2067,25
13622631,13622024,13623686,1662,2068,25
13627965,13627358,13629374,2016,2069,25
13633654,13633047,13634978,1931,2070,25
13639257,13638650,13641234,2584,2071,25
13645514,13644907,13647155,2248,2072,25
13651651,13650827,13652706,1879,2073,25
13656985,13656378,13659047,2669,2074,25
13663327,13662720,13664398,1678,2075,25
13668678,13668070,13670635,2565,2076,25
13674915,13674308,13676555,2247,2077,25
13681051,13680227,13682106,1879,2078,25
13686602,13685778,13687657,1879,2079,25
13691936,13691329,13693027,1698,2080,25
13697306,13696699,13698946,2247,2081,25
13703225,13702618,13704296,1678,2082,25
13708575,13707968,13710553,2585,2083,25
13714833,13714226,13716157,1931,2084,25
13720436,13719829,13721507,1678,2085,25
13726003,13725179,13727058,1879,2086,25
13731337,13730730,13732609,1879,2087,25
13736888,13736281,13738634,2353,2088,25
13742914,13742307,13744186,1879,2089,25
13748465,13747858,13749873,2015,2090,25
13754152,13753545,13756130,2585,2091,25
13760410,13759803,13762387,2584,2092,25
13766884,13766060,13767939,1879,2093,25
13772218,13771611,13773309,1698,2094,25
13777805,13776981,13778860,1879,2095,25
13783139,13782532,13785202,2670,2096,25
13789482,13788875,13790754,1879,2097,25
13795033,13794426,13796305,1879,2098,25
13800584,13799977,13801856,1879,2099,25
13806135,13805528,13807226,1698,2100,25
13811505,13810898,13812777,1879,2101,25
13817056,13816449,13818802,2353,2102,25
13823081,13822474,13824152,1678,2103,25
13828648,13827824,13829703,1879,2104,25
13833982,13833375,13835254,1879,2105,25
13839533,13838926,13840941,2015,2106,25
13845221,13844613,13846291,1678,2107,25
13850570,13849963,13852547,2584,2108,25
13856827,13856220,13858468,2248,2109,25
13862869,13862262,13863924,1662,2110,25
13868203,13867596,13869474,1878,2111,25
13873753,13873146,13875025,1879,2112,25
13879518,13878911,13880573,1662,2113,25
13884852,13884245,13886915,2670,2114,25
13891195,13890588,13892467,1879,2115,25
13896746,13896139,13898808,2669,2116,25
13903088,13902481,13904159,1678,2117,25
13908438,13907831,13909761,1930,2118,25
13914040,13913433,13915111,1678,2119,25
13919390,13918783,13921368,2585,2120,25
13925865,13925041,13926920,1879,2121,25
13931199,13930592,13932945,2353,2122,25
13937441,13936617,13938496,1879,2123,25
13942775,13942168,13944520,2352,2124,25
13948800,13948193,13950123,1930,2125,25
13954402,13953795,13955674,1879,2126,25
13959952,13959346,13961224,1878,2127,25
13965503,13964896,13966911,2015,2128,25
13971191,13970583,13973168,2585,2129,25
13977448,13976841,13979426,2585,2130,25
13983923,13983099,13984978,1879,2131,25
13989257,13988650,13990529,1879,2132,25
13994808,13994201,13996554,2353,2133,25
14000834,14000227,14002474,2247,2134,25
14006753,14006146,14007824,1678,2135,25
14012103,14011496,14013174,1678,2136,25
14017670,14016846,14018725,1879,2137,25
14023004,14022397,14024412,2015,2138,25
14028691,14028084,14029963,1879,2139,25
14034242,14033635,14035334,1699,2140,25
14039613,14039006,14040937,1931,2141,25
14045216,14044609,14047194,2585,2142,25
14051474,14050867,14052545,1678,2143,25
14057041,14056217,14058096,1879,2144,25
14062375,14061768,14063647,1879,2145,25
14067926,14067319,14069333,2014,2146,25
14073613,14073006,14075570,2564,2147,25
14079850,14079243,14080921,1678,2148,25
14085317,14084710,14086372,1662,2149,25
14090868,14090044,14091923,1879,2150,25
14096407,14095800,14097462,1662,2151,25
14101741,14101134,14103013,1879,2152,25
14107292,14106685,14108700,2015,2153,25
14112980,14112373,14114252,1879,2154,25
14118748,14117924,14119803,1879,2155,25
14124082,14123475,14126144,2669,2156,25
14130556,14129949,14131611,1662,2157,25
14136102,14135283,14137157,1874,2158,25
14141642,14141035,14142697,1662,2159,25
14146976,14146369,14148068,1699,2160,25
14152347,14151740,14153671,1931,2161,25
14157950,14157343,14159590,2247,2162,25
14163869,14163262,14165510,2248,2163,25
14170005,14169182,14171060,1878,2164,25
14175549,14174942,14176604,1662,2165,25
14180883,14180276,14182944,2668,2166,25
14187224,14186617,14188863,2246,2167,25
14193143,14192536,14194214,1678,2168,25
14198493,14197886,14199564,1678,2169,25
14203842,14203236,14205166,1930,2170,25
14209445,14208838,14210516,1678,2171,25
14214795,14214188,14216772,2584,2172,25
14221269,14220445,14222324,1879,2173,25
14226604,14225997,14228667,2670,2174,25
14232947,14232340,14234587,2247,2175,25
14238866,14238259,14239937,1678,2176,25
14244216,14243609,14245857,2248,2177,25
14250137,14249530,14251461,1931,2178,25
14255740,14255133,14257063,1930,2179,25
14261342,14260735,14262413,1678,2180,25
14266692,14266085,14267964,1879,2181,25
14272243,14271636,14273989,2353,2182,25
14278269,14277662,14279340,1678,2183,25
14283619,14283012,14284891,1879,2184,25
14289170,14288563,14291233,2670,2185,25
14295513,14294906,14297470,2564,2186,25
14301869,14301262,14302924,1662,2187,25
14307421,14306597,14308476,1879,2188,25
14312957,14312350,14314012,1662,2189,25
14318506,14317684,14319561,1877,2190,25
14324045,14323438,14325100,1662,2191,25
14329379,14328772,14330788,2016,2192,25
14335068,14334461,14337024,2563,2193,25
14341521,14340697,14342576,1879,2194,25
14346855,14346248,14347946,1698,2195,25
14352225,14351618,14354203,2585,2196,25
14358483,14357876,14360461,2585,2197,25
14364741,14364134,14366064,1930,2198,25
14370343,14369736,14371615,1879,2199,25
14375894,14375287,14377639,2352,2200,25
14381918,14381311,14383242,1931,2201,25
14387521,14386914,14389162,2248,2202,25
14393442,14392835,14394766,1931,2203,25
14399261,14398438,14400316,1878,2204,25
14404810,14404203,14405865,1662,2205,25
14410359,14409537,14411414,1877,2206,25
14415693,14415086,14416965,1879,2207,25
14421244,14420637,14422516,1879,2208,25
14426795,14426188,14428203,2015,2209,25
14432482,14431875,14434121,2246,2210,25
14438402,14437794,14440359,2565,2211,25
14444639,14444032,14445710,1678,2212,25
14450206,14449382,14451261,1879,2213,25
14455540,14454933,14457601,2668,2214,25
14462001,14461394,14463056,1662,2215,25
14467552,14466728,14468607,1879,2216,25
14472886,14472279,14474631,2352,2217,25
14478910,14478303,14479981,1678,2218,25
14484260,14483653,14485331,1678,2219,25
14489611,14489003,14490934,1931,2220,25
14495429,14494606,14496484,1878,2221,25
14500763,14500156,14502035,1879,2222,25
14506531,14505924,14507586,1662,2223,25
14511865,14511258,14513927,2669,2224,25
14518424,14517600,14519479,1879,2225,25
14523758,14523151,14525167,2016,2226,25
14529447,14528840,14531087,2247,2227,25
14535366,14534759,14536638,1879,2228,25
14541131,14540310,14542186,1876,2229,25
14546465,14545858,14548527,2669,2230,25
14553024,14552200,14554079,1879,2231,25
14558358,14557751,14560104,2353,2232,25
14564601,14563777,14565656,1879,2233,25
14569935,14569328,14571207,1879,2234,25
14575701,14574879,14576756,1877,2235,25
14581035,14580428,14582307,1879,2236,25
14586802,14586195,14587857,1662,2237,25
14592136,14591529,14594197,2668,2238,25
14598477,14597870,14599749,1879,2239,25
14604028,14603421,14605774,2353,2240,25
14610054,14609447,14611695,2248,2241,25
14615975,14615368,14617615,2247,2242,25
14621894,14621287,14623535,2248,2243,25
14628031,14627207,14629086,1879,2244,25
14633582,14632758,14634637,1879,2245,25
14638916,14638309,14640324,2015,2246,25
14644603,14643996,14645875,1879,2247,25
14650154,14649547,14651246,1699,2248,25
14655663,14655056,14656718,1662,2249,25
14660997,14660390,14662269,1879,2250,25
14666548,14665941,14668294,2353,2251,25
14672573,14671966,14673644,1678,2252,25
14678140,14677316,14679195,1879,2253,25
14683474,14682867,14684883,2016,2254,25
14689163,14688556,14690802,2246,2255,25
14695081,14694474,14696353,1879,2256,25
14700632,14700025,14702378,2353,2257,25
14706658,14706051,14707729,1678,2258,25
14712008,14711401,14713986,2585,2259,25
14718266,14717659,14720245,2586,2260,25
14724742,14723918,14725797,1879,2261,25
14730076,14729469,14731485,2016,2262,25
14735982,14735158,14737037,1879,2263,25
14741316,14740709,14742408,1699,2264,25
14746687,14746080,14748010,1930,2265,25
14752289,14751682,14753928,2246,2266,25
14758335,14757728,14759390,1662,2267,25
14763883,14763062,14764938,1876,2268,25
14769217,14768610,14770625,2015,2269,25
14775122,14774298,14776177,1879,2270,25
14780456,14779849,14782202,2353,2271,25
14786482,14785875,14787553,1678,2272,25
14791959,14791352,14793014,1662,2273,25
14797294,14796686,14799355,2669,2274,25
14803852,14803028,14804907,1879,2275,25
14809403,14808796,14810458,1662,2276,25
14814737,14814130,14816483,2353,2277,25
14820763,14820156,14821834,1678,2278,25
14826330,14825506,14827385,1879,2279,25
14831881,14831274,14832936,1662,2280,25
14837432,14836608,14838487,1879,2281,25
14842766,14842159,14844175,2016,2282,25
14848455,14847848,14850096,2248,2283,25
14854376,14853769,14855700,1931,2284,25
14859979,14859372,14861956,2584,2285,25
14866236,14865629,14867508,1879,2286,25
14871988,14871381,14873043,1662,2287,25
14877322,14876715,14878730,2015,2288,25
14883009,14882402,14884648,2246,2289,25
14888927,14888320,14890199,1879,2290,25
14894478,14893871,14895569,1698,2291,25
14899848,14899241,14901172,1931,2292,25
14905593,14904986,14906648,1662,2293,25
14910927,14910320,14912199,1879,2294,25
14916478,14915871,14918541,2670,2295,25
14922821,14922214,14924461,2247,2296,25
14928958,14928134,14930013,1879,2297,25
14934293,14933685,14935565,1880,2298,25
14940052,14939445,14941107,1662,2299,25
14945386,14944779,14946477,1698,2300,25
14950973,14950149,14952028,1879,2301,25
14956524,14955700,14957579,1879,2302,25
14962075,14961251,14963130,1879,2303,25
14967409,14966802,14968818,2016,2304,25
14973098,14972491,14975076,2585,2305,25
14979497,14978890,14980552,1662,2306,25
14985048,14984224,14986103,1879,2307,25
14990599,14989775,14991654,1879,2308,25
14995933,14995326,14997679,2353,2309,25
15001959,15001352,15003231,1879,2310,25
15007510,15006903,15008917,2014,2311,25
15013197,15012590,15014469,1879,2312,25
15018748,15018141,15020810,2669,2313,25
15025091,15024483,15026162,1679,2314,25
15030657,15029834,15031712,1878,2315,25
15036209,15035385,15037264,1879,2316,25
15041543,15040936,15042815,1879,2317,25
15047094,15046487,15048840,2353,2318,25
15053120,15052513,15054444,1931,2319,25
15058723,15058116,15060362,2246,2320,25
15064641,15064034,15065913,1879,2321,25
15070193,15069586,15071285,1699,2322,25
15075698,15075091,15076753,1662,2323,25
15081032,15080425,15082440,2015,2324,25
15086936,15086112,15087991,1879,2325,25
15092271,15091663,15094333,2670,2326,25
15098830,15098006,15099885,1879,2327,25
15104369,15103762,15105424,1662,2328,25
15109703,15109096,15110975,1879,2329,25
15115254,15114647,15117000,2353,2330,25
15121497,15120673,15122552,1879,2331,25
15126831,15126224,15128103,1879,2332,25
15132382,15131775,15133654,1879,2333,25
15138150,15137326,15139205,1879,2334,25
15143690,15143083,15144745,1662,2335,25
15149024,15148417,15151087,2670,2336,25
15155367,15154760,15157345,2585,2337,25
15161625,15161018,15162949,1931,2338,25
15167445,15166621,15168500,1879,2339,25
15172988,15172381,15174043,1662,2340,25
15178538,15177715,15179593,1878,2341,25
15183872,15183265,15185144,1879,2342,25
15189423,15188816,15190832,2016,2343,25
15195112,15194505,15196183,1678,2344,25
15200462,15199855,15201786,1931,2345,25
15206282,15205458,15207337,1879,2346,25
15211616,15211009,15212708,1699,2347,25
15217204,15216380,15218259,1879,2348,25
15222538,15221931,15223810,1879,2349,25
15228089,15227482,15229181,1699,2350,25
15233461,15232854,15234785,1931,2351,25
15239064,15238457,15240705,2248,2352,25
15244985,15244378,15246963,2585,2353,25
15251461,15250637,15252516,1879,2354,25
15257012,15256188,15258067,1879,2355,25
15262346,15261739,15264092,2353,2356,25
15268589,15267765,15269644,1879,2357,25
15274139,15273316,15275194,1878,2358,25
15279474,15278867,15280565,1698,2359,25
15284844,15284237,15285915,1678,2360,25
15290194,15289587,15291265,1678,2361,25
15295686,15295079,15296741,1662,2362,25
15301020,15300414,15302111,1697,2363,25
15306606,15305783,15307661,1878,2364,25
15311941,15311334,15313213,1879,2365,25
15317493,15316886,15318765,1879,2366,25
15323045,15322438,15324317,1879,2367,25
15328797,15328190,15329852,1662,2368,25
15334131,15333524,15335403,1879,2369,25
15339683,15339076,15341091,2015,2370,25
15345588,15344764,15346643,1879,2371,25
15350923,15350316,15352986,2670,2372,25
15357267,15356660,15358338,1678,2373,25
15362618,15362011,15363890,1879,2374,25
15368169,15367562,15369261,1699,2375,25
15373540,15372933,15374864,1931,2376,25
15379360,15378536,15380415,1879,2377,25
15384911,15384087,15385966,1879,2378,25
15390462,15389638,15391517,1879,2379,25
15395796,15395189,15397203,2014,2380,25
15401483,15400876,15402807,1931,2381,25
15407303,15406479,15408358,1879,2382,25
15412637,15412030,15414383,2353,2383,25
15418662,15418055,15419733,1678,2384,25
15424012,15423405,15425336,1931,2385,25
15429615,15429008,15431592,2584,2386,25
15436089,15435265,15437144,1879,2387,25
15441640,15440816,15442695,1879,2388,25
15446974,15446367,15448243,1876,2389,25
15452522,15451915,15454268,2353,2390,25
15458765,15457941,15459820,1879,2391,25
15464316,15463492,15465371,1879,2392,25
15469650,15469043,15470922,1879,2393,25
15475201,15474594,15477263,2669,2394,25
15481543,15480936,15482614,1678,2395,25
15486893,15486286,15488165,1879,2396,25
15492444,15491837,15493852,2015,2397,25
15498348,15497524,15499403,1879,2398,25
15503682,15503075,15504954,1879,2399,25
15509233,15508626,15510641,2015,2400,25
15514921,15514314,15516245,1931,2401,25
15520525,15519917,15522166,2249,2402,25
15526565,15525958,15527620,1662,2403,25
15532116,15531292,15533171,1879,2404,25
15537450,15536843,15538722,1879,2405,25
15543001,15542394,15544092,1698,2406,25
15548372,15547765,15549443,1678,2407,25
15553939,15553115,15554994,1879,2408,25
15559273,15558666,15561019,2353,2409,25
15565299,15564692,15566369,1677,2410,25
15570648,15570041,15571719,1678,2411,25
15576215,15575391,15577270,1879,2412,25
15581549,15580942,15583294,2352,2413,25
15587689,15587082,15588744,1662,2414,25
15593023,15592416,15594295,1879,2415,25
15598574,15597967,15599983,2016,2416,25
15604262,15603656,15605534,1878,2417,25
15609813,15609206,15611559,2353,2418,25
15616056,15615232,15617111,1879,2419,25
15621390,15620783,15622482,1699,2420,25
15626761,15626154,15628423,2269,2421,25
15632703,15632096,15634026,1930,2422,25
15638305,15637698,15639376,1678,2423,25
15643872,15643048,15644927,1879,2424,25
15649206,15648599,15651268,2669,2425,25
15655548,15654941,15657189,2248,2426,25
15661469,15660862,15662741,1879,2427,25
15667020,15666413,15668292,1879,2428,25
15672571,15671964,15674317,2353,2429,25
15678597,15677990,15680238,2248,2430,25
15684518,15683911,15686159,2248,2431,25
15690439,15689832,15691711,1879,2432,25
15695990,15695383,15697736,2353,2433,25
15702016,15701409,15703994,2585,2434,25
15708274,15707667,15709345,1678,2435,25
15713624,15713017,15715602,2585,2436,25
15719882,15719275,15721154,1879,2437,25
15725646,15725039,15726701,1662,2438,25
15730980,15730373,15732726,2353,2439,25
15737005,15736398,15738646,2248,2440,25
15742926,15742319,15744198,1879,2441,25
15748477,15747870,15750539,2669,2442,25
15754819,15754212,15756142,1930,2443,25
15760538,15759931,15761593,1662,2444,25
15765872,15765265,15767281,2016,2445,25
15771560,15770953,15772884,1931,2446,25
15777163,15776556,15779141,2585,2447,25
15783421,15782814,15784492,1678,2448,25
15788771,15788164,15790043,1879,2449,25
15794539,15793715,15795594,1879,2450,25
15799873,15799266,15801618,2352,2451,25
15805898,15805291,15807539,2248,2452,25
15812036,15811212,15813091,1879,2453,25
15817369,15816763,15818641,1878,2454,25
15822920,15822313,15824012,1699,2455,25
15828405,15827798,15829460,1662,2456,25
15833952,15833132,15835007,1875,2457,25
15839286,15838679,15840693,2014,2458,25
15845189,15844365,15846244,1879,2459,25
15850523,15849916,15851932,2016,2460,25
15856212,15855604,15857283,1679,2461,25
15861779,15860955,15862834,1879,2462,25
15867113,15866506,15868385,1879,2463,25
15872665,15872058,15874073,2015,2464,25
15878352,15877745,15879423,1678,2465,25
15883919,15883095,15884974,1879,2466,25
15889253,15888646,15890345,1699,2467,25
15894841,15894017,15895896,1879,2468,25
15900392,15899568,15901447,1879,2469,25
15905943,15905336,15906998,1662,2470,25
15911494,15910670,15912549,1879,2471,25
15917037,15916430,15918092,1662,2472,25
15922371,15921764,15923780,2016,2473,25
15928060,15927453,15929700,2247,2474,25
15933980,15933373,15935051,1678,2475,25
15939330,15938723,15940602,1879,2476,25
15944881,15944274,15946153,1879,2477,25
15950432,15949825,15951840,2015,2478,25
15956120,15955513,15958098,2585,2479,25
15962595,15961771,15963650,1879,2480,25
15967929,15967322,15969201,1879,2481,25
15973480,15972873,15974889,2016,2482,25
15979386,15978562,15980441,1879,2483,25
15984937,15984113,15985992,1879,2484,25
15990271,15989664,15992017,2353,2485,25
15996513,15995690,15997568,1878,2486,25
16001847,16001240,16003256,2016,2487,25
16007651,16007044,16008707,1663,2488,25
16012987,16012380,16014260,1880,2489,25
16018540,16017933,16020287,2354,2490,25
16024568,16023961,16026209,2248,2491,25
16030707,16029883,16031763,1880,2492,25
16036249,16035642,16037305,1663,2493,25
16041802,16041195,16042858,1663,2494,25
16047139,16046532,16048412,1880,2495,25
16052692,16052085,16054754,2669,2496,25
16059035,16058428,16060308,1880,2497,25
16064588,16063981,16066334,2353,2498,25
16070742,16070135,16071798,1663,2499,25
16076295,16075471,16077351,1880,2500,25
16081838,16081231,16082894,1663,2501,25
16087391,16086567,16088447,1880,2502,25
16092933,16092325,16093989,1664,2503,25
16098269,16097662,16099678,2016,2504,25
16104176,16103352,16105232,1880,2505,25
16109513,16108906,16111576,2670,2506,25
16116073,16115250,16117129,1879,2507,25
16121626,16120802,16122682,1880,2508,25
16127179,16126355,16128235,1880,2509,25
16132516,16131909,16133608,1699,2510,25
16138006,16137399,16139062,1663,2511,25
16143342,16142735,16144615,1880,2512,25
16148896,16148289,16150305,2016,2513,25
16154586,16153979,16155859,1880,2514,25
16160140,16159533,16161413,1880,2515,25
16165693,16165086,16166786,1700,2516,25
16171284,16170460,16172340,1880,2517,25
16176620,16176013,16177893,1880,2518,25
16182391,16181567,16183447,1880,2519,25
16187727,16187120,16189136,2016,2520,25
16193417,16192810,16195396,2586,2521,25
16199677,16199070,16201655,2585,2522,25
16205936,16205329,16207260,1931,2523,25
16211758,16210934,16212814,1880,2524,25
16217312,16216705,16218368,1663,2525,25
16222648,16222041,16223921,1880,2526,25
16228202,16227595,16229294,1699,2527,25
16233689,16233082,16234745,1663,2528,25
16239026,16238419,16241089,2670,2529,25
16245371,16244764,16246644,1880,2530,25
16250925,16250318,16252672,2354,2531,25
16256953,16256346,16258226,1880,2532,25
16262506,16261899,16263779,1880,2533,25
16268277,16267453,16269333,1880,2534,25
16273613,16273006,16275021,2015,2535,25
16279519,16278695,16280575,1880,2536,25
16284856,16284249,16286601,2352,2537,25
16291099,16290275,16292155,1880,2538,25
16296436,16295829,16297709,1880,2539,25
16302206,16301383,16303262,1879,2540,25
16307759,16307152,16308815,1663,2541,25
16313296,16312689,16314352,1663,2542,25
16318848,16318026,16319904,1878,2543,25
16324185,16323578,16325458,1880,2544,25
16329739,16329132,16330832,1700,2545,25
16335112,16334505,16336184,1679,2546,25
16340465,16339858,16341789,1931,2547,25
16346069,16345462,16348047,2585,2548,25
16352546,16351722,16353602,1880,2549,25
16357883,16357276,16358975,1699,2550,25
16363256,16362649,16364328,1679,2551,25
16368609,16368002,16369882,1880,2552,25
16374163,16373556,16375255,1699,2553,25
16379536,16378929,16380861,1932,2554,25
16385142,16384535,16386415,1880,2555,25
16390695,16390088,16391962,1874,2556,25
16396242,16395635,16397335,1700,2557,25
16401730,16401123,16402786,1663,2558,25
16407066,16406459,16408157,1698,2559,25
16412437,16411830,16413710,1880,2560,25
16417991,16417384,16420054,2670,2561,25
16424336,16423729,16426294,2565,2562,25
16430575,16429968,16431848,1880,2563,25
16436129,16435522,16437399,1877,2564,25
16441679,16441072,16443088,2016,2565,25
16447503,16446896,16448559,1663,2566,25
16452839,16452232,16453932,1700,2567,25
16458430,16457606,16459486,1880,2568,25
16463767,16463160,16465493,2333,2569,25
16469775,16469168,16470846,1678,2570,25
16475344,16474520,16476400,1880,2571,25
16480681,16480074,16481774,1700,2572,25
16486054,16485447,16487695,2248,2573,25
16491976,16491369,16493299,1930,2574,25
16497796,16496972,16498852,1880,2575,25
16503349,16502742,16504405,1663,2576,25
16508686,16508079,16510748,2669,2577,25
16515148,16514541,16516204,1663,2578,25
16520485,16519878,16522548,2670,2579,25
16526830,16526223,16528471,2248,2580,25
16532753,16532146,16534078,1932,2581,25
16538495,16537888,16539551,1663,2582,25
16543833,16543225,16545897,2672,2583,25
16550396,16549572,16551452,1880,2584,25
16555950,16555126,16557006,1880,2585,25
16561287,16560680,16562695,2015,2586,25
16567092,16566485,16568148,1663,2587,25
16572429,16571822,16573699,1877,2588,25
16577980,16577373,16579726,2353,2589,25
16584007,16583400,16585078,1678,2590,25
16589359,16588752,16591000,2248,2591,25
16595282,16594675,16597240,2565,2592,25
16601738,16600915,16602794,1879,2593,25
16607075,16606468,16608801,2333,2594,25
16613082,16612475,16615039,2564,2595,25
16619321,16618714,16620645,1931,2596,25
16624926,16624319,16626883,2564,2597,25
16631165,16630558,16632806,2248,2598,25
16637087,16636480,16638411,1931,2599,25
16642692,16642085,16643763,1678,2600,25
16648044,16647437,16650022,2585,2601,25
16654521,16653697,16655577,1880,2602,25
16659858,16659251,16661131,1880,2603,25
16665628,16664805,16666684,1879,2604,25
16670965,16670358,16672057,1699,2605,25
16676338,16675731,16677409,1678,2606,25
16681690,16681083,16683014,1931,2607,25
16687410,16686803,16688466,1663,2608,25
16692964,16692140,16694020,1880,2609,25
16698301,16697694,16699574,1880,2610,25
16703855,16703248,16704947,1699,2611,25
16709228,16708621,16710300,1679,2612,25
16714581,16713974,16715651,1677,2613,25
16719932,16719325,16721004,1679,2614,25
16725285,16724678,16726609,1931,2615,25
16730889,16730283,16732867,2584,2616,25
16737366,16736542,16738422,1880,2617,25
16742703,16742096,16744450,2354,2618,25
16748731,16748124,16750710,2586,2619,25
16754992,16754385,16756064,1679,2620,25
16760345,16759738,16761416,1678,2621,25
16765697,16765090,16766970,1880,2622,25
16771468,16770861,16772524,1663,2623,25
16776805,16776198,16778214,2016,2624,25
16782496,16781889,16784137,2248,2625,25
16788419,16787812,16789692,1880,2626,25
16794190,16793366,16795246,1880,2627,25
16799527,16798920,16801590,2670,2628,25
16806089,16805265,16807145,1880,2629,25
16811638,16810819,16812694,1875,2630,25
16816975,16816368,16818068,1700,2631,25
16822349,16821742,16823989,2247,2632,25
16828271,16827664,16829912,2248,2633,25
16834193,16833586,16835265,1679,2634,25
16839763,16838939,16840819,1880,2635,25
16845100,16844493,16846193,1700,2636,25
16850474,16849867,16852453,2586,2637,25
16856735,16856128,16858376,2248,2638,25
16862657,16862050,16863930,1880,2639,25
16868418,16867811,16869474,1663,2640,25
16873755,16873148,16875028,1880,2641,25
16879309,16878702,16880582,1880,2642,25
16884864,16884256,16886137,1881,2643,25
16890418,16889811,16892165,2354,2644,25
16896447,16895840,16897518,1678,2645,25
16901799,16901192,16903440,2248,2646,25
16907937,16907114,16908993,1879,2647,25
16913491,16912667,16914547,1880,2648,25
16919045,16918221,16920101,1880,2649,25
16924382,16923775,16926107,2332,2650,25
16930389,16929782,16931713,1931,2651,25
16936211,16935387,16937267,1880,2652,25
16941548,16940941,16943610,2669,2653,25
16948109,16947285,16949165,1880,2654,25
16953663,16952839,16954719,1880,2655,25
16959000,16958393,16960746,2353,2656,25
16965244,16964420,16966300,1880,2657,25
16970581,16969974,16971673,1699,2658,25
16976171,16975347,16977227,1880,2659,25
16981723,16981117,16982779,1662,2660,25
16987060,16986453,16988152,1699,2661,25
16992433,16991826,16993706,1880,2662,25
16998204,16997380,16999260,1880,2663,25
17003541,17002934,17004814,1880,2664,25
17009095,17008488,17010366,1878,2665,25
17014848,17014241,17015904,1663,2666,25
17020185,17019578,17021456,1878,2667,25
17025737,17025130,17027010,1880,2668,25
17031291,17030684,17032564,1880,2669,25
17037062,17036238,17038118,1880,2670,25
17042399,17041792,17044461,2669,2671,25
17048960,17048136,17050016,1880,2672,25
17054297,17053690,17056044,2354,2673,25
17060542,17059718,17061598,1880,2674,25
17065879,17065272,17067287,2015,2675,25
17071568,17070961,17072841,1880,2676,25
17077123,17076515,17078216,1701,2677,25
17082714,17081890,17083770,1880,2678,25
17088051,17087444,17089322,1878,2679,25
17093820,17092996,17094876,1880,2680,25
17099157,17098550,17100882,2332,2681,25
17105286,17104679,17106342,1663,2682,25
17110623,17110016,17111894,1878,2683,25
17116175,17115568,17117267,1699,2684,25
17121548,17120941,17123526,2585,2685,25
17128025,17127201,17129081,1880,2686,25
17133362,17132755,17134635,1880,2687,25
17138916,17138309,17140663,2354,2688,25
17145162,17144338,17146218,1880,2689,25
17150716,17149892,17151772,1880,2690,25
17156053,17155446,17157461,2015,2691,25
17161959,17161135,17163015,1880,2692,25
17167296,17166689,17168704,2015,2693,25
17172985,17172378,17174625,2247,2694,25
17179124,17178300,17180180,1880,2695,25
17184461,17183854,17186525,2671,2696,25
17190807,17190200,17192080,1880,2697,25
17196361,17195754,17197634,1880,2698,25
17202132,17201308,17203188,1880,2699,25
17207470,17206862,17208740,1878,2700,25
17213021,17212414,17214429,2015,2701,25
17218711,17218104,17220690,2586,2702,25
17225189,17224365,17226245,1880,2703,25
17230526,17229919,17232589,2670,2704,25
17236871,17236264,17238850,2586,2705,25
17243348,17242525,17244404,1879,2706,25
17248685,17248078,17249778,1700,2707,25
17254276,17253452,17255332,1880,2708,25
17259613,17259006,17260886,1880,2709,25
17265167,17264560,17266440,1880,2710,25
17270721,17270114,17272130,2016,2711,25
17276412,17275805,17278053,2248,2712,25
17282335,17281728,17283608,1880,2713,25
17288106,17287282,17289162,1880,2714,25
17293443,17292836,17294716,1880,2715,25
17299213,17298390,17300269,1879,2716,25
17304550,17303943,17305823,1880,2717,25
17310104,17309497,17311513,2016,2718,25
17315911,17315304,17316967,1663,2719,25
17321248,17320641,17322657,2016,2720,25
17327065,17326458,17328121,1663,2721,25
17332402,17331795,17333810,2015,2722,25
17338091,17337484,17340070,2586,2723,25
17344569,17343745,17345625,1880,2724,25
17350123,17349299,17351179,1880,2725,25
17355677,17354853,17356733,1880,2726,25
17361015,17360408,17362288,1880,2727,25
17366784,17366177,17367840,1663,2728,25
17372121,17371514,17373530,2016,2729,25
17377812,17377205,17379453,2248,2730,25
17383734,17383127,17384806,1679,2731,25
17389087,17388480,17390360,1880,2732,25
17394641,17394034,17396386,2352,2733,25
17400668,17400061,17402647,2586,2734,25
17406930,17406322,17408571,2249,2735,25
17413070,17412246,17414126,1880,2736,25
17418624,17417800,17419680,1880,2737,25
17423961,17423354,17425370,2016,2738,25
17429651,17429044,17430976,1932,2739,25
17435257,17434650,17437236,2586,2740,25
17441518,17440911,17443496,2585,2741,25
17447995,17447171,17449051,1880,2742,25
17453332,17452725,17454605,1880,2743,25
17458886,17458279,17460950,2671,2744,25
17465448,17464625,17466504,1879,2745,25
17470785,17470178,17472058,1880,2746,25
17476339,17475732,17477608,1876,2747,25
17482106,17481282,17483162,1880,2748,25
17487443,17486836,17488716,1880,2749,25
17492997,17492390,17495059,2669,2750,25
17499473,17498866,17500529,1663,2751,25
17504810,17504203,17506083,1880,2752,25
17510364,17509757,17512427,2670,2753,25
17516709,17516102,17517781,1679,2754,25
17522062,17521455,17524019,2564,2755,25
17528301,17527694,17529574,1880,2756,25
17533856,17533249,17534948,1699,2757,25
17539446,17538622,17540502,1880,2758,25
17544783,17544176,17545876,1700,2759,25
17550374,17549550,17551430,1880,2760,25
17555711,17555104,17557120,2016,2761,25
17561401,17560794,17563380,2586,2762,25
17567662,17567055,17568935,1880,2763,25
17573433,17572609,17574489,1880,2764,25
17578770,17578163,17580043,1880,2765,25
17584541,17583717,17585597,1880,2766,25
17589878,17589271,17591603,2332,2767,25
17595885,17595278,17597527,2249,2768,25
17601809,17601202,17603134,1932,2769,25
17607547,17606940,17608603,1663,2770,25
17612884,17612277,17614157,1880,2771,25
17618438,17617831,17619711,1880,2772,25
17623992,17623385,17625265,1880,2773,25
17629763,17628939,17630819,1880,2774,25
17635317,17634493,17636373,1880,2775,25
17640654,17640047,17642063,2016,2776,25
17646474,17645867,17647530,1663,2777,25
17651811,17651204,17653084,1880,2778,25
17657365,17656758,17658458,1700,2779,25
17662739,17662132,17664380,2248,2780,25
17668663,17668055,17669735,1680,2781,25
17674128,17673521,17675184,1663,2782,25
17679682,17679075,17680738,1663,2783,25
17685236,17684412,17686292,1880,2784,25
17690777,17690170,17691833,1663,2785,25
17696114,17695507,17698177,2670,2786,25
17702460,17701852,17703785,1933,2787,25
17708283,17707459,17709339,1880,2788,25
17713620,17713013,17714712,1699,2789,25
17718993,17718386,17720064,1678,2790,25
17724482,17723875,17725538,1663,2791,25
17729819,17729212,17730910,1698,2792,25
17735408,17734584,17736464,1880,2793,25
17740962,17740138,17742018,1880,2794,25
17746299,17745692,17748024,2332,2795,25
17752522,17751698,17753578,1880,2796,25
17757859,17757252,17758952,1700,2797,25
17763233,17762626,17765190,2564,2798,25
17769472,17768865,17770544,1679,2799,25
17774825,17774218,17776783,2565,2800,25
17781282,17780458,17782338,1880,2801,25
17786619,17786012,17788681,2669,2802,25
17793180,17792356,17794236,1880,2803,25
17798517,17797910,17799610,1700,2804,25
17803891,17803284,17804963,1679,2805,25
17809244,17808637,17810316,1679,2806,25
17814597,17813990,17815870,1880,2807,25
17820151,17819544,17822214,2670,2808,25
17826496,17825889,17828475,2586,2809,25
17832974,17832150,17834030,1880,2810,25
17838311,17837704,17840374,2670,2811,25
17844656,17844049,17846297,2248,2812,25
17850796,17849972,17851852,1880,2813,25
17856133,17855526,17857542,2016,2814,25
17861824,17861217,17863097,1880,2815,25
17867378,17866771,17868651,1880,2816,25
17872932,17872325,17874678,2353,2817,25
17878960,17878353,17880032,1679,2818,25
17884530,17883706,17885586,1880,2819,25
17889867,17889260,17891140,1880,2820,25
17895421,17894814,17897483,2669,2821,25
17901765,17901158,17902837,1679,2822,25
17907119,17906512,17908392,1880,2823,25
17912673,17912066,17914419,2353,2824,25
17918822,17918215,17919878,1663,2825,25
17924160,17923553,17925569,2016,2826,25
17929851,17929243,17931808,2565,2827,25
17936090,17935483,17937731,2248,2828,25
17942140,17941533,17943196,1663,2829,25
17947477,17946870,17949223,2353,2830,25
17953631,17953024,17954687,1663,2831,25
17958968,17958361,17961031,2670,2832,25
17965313,17964706,17966637,1931,2833,25
17971134,17970311,17972190,1879,2834,25
17976688,17975864,17977744,1880,2835,25
17982025,17981418,17984088,2670,2836,25
17988370,17987763,17989695,1932,2837,25
17994088,17993482,17995144,1662,2838,25
17999425,17998818,18000517,1699,2839,25
18004798,18004191,18005870,1679,2840,25
18010151,18009544,18011476,1932,2841,25
18015974,18015150,18017030,1880,2842,25
18021312,18020705,18022403,1698,2843,25
18026901,18026077,18027957,1880,2844,25
18032238,18031631,18033511,1880,2845,25
18037792,18037185,18039065,1880,2846,25
18043346,18042739,18044619,1880,2847,25
18048900,18048293,18050168,1875,2848,25
18054449,18053842,18055858,2016,2849,25
18060250,18059643,18061306,1663,2850,25
18065799,18064980,18066855,1875,2851,25
18071136,18070529,18072409,1880,2852,25
18076907,18076083,18077963,1880,2853,25
18082244,18081637,18083991,2354,2854,25
18088397,18087790,18089453,1663,2855,25
18093734,18093127,18095007,1880,2856,25
18099288,18098681,18100696,2015,2857,25
18104977,18104370,18106301,1931,2858,25
18110582,18109975,18112222,2247,2859,25
18116504,18115897,18117777,1880,2860,25
18122274,18121451,18123330,1879,2861,25
18127611,18127004,18128884,1880,2862,25
18133165,18132558,18135229,2671,2863,25
18139511,18138904,18140583,1679,2864,25
18145081,18144257,18146137,1880,2865,25
18150635,18149811,18151691,1880,2866,25
18155972,18155365,18157718,2353,2867,25
18162000,18161393,18163325,1932,2868,25
18167606,18166999,18168678,1679,2869,25
18172959,18172352,18174938,2586,2870,25
18179437,18178613,18180493,1880,2871,25
18184990,18184167,18186046,1879,2872,25
18190327,18189720,18191600,1880,2873,25
18195881,18195274,18197154,1880,2874,25
18201435,18200828,18202528,1700,2875,25
18206809,18206202,18208082,1880,2876,25
18212364,18211757,18213637,1880,2877,25
18217918,18217311,18219665,2354,2878,25
18224164,18223340,18225220,1880,2879,25
18229502,18228895,18231564,2669,2880,25
18236062,18235239,18237118,1879,2881,25
18241616,18241009,18242672,1663,2882,25
18246953,18246346,18248226,1880,2883,25
18252507,18251900,18253780,1880,2884,25
18258269,18257662,18259325,1663,2885,25
18263606,18262999,18265353,2354,2886,25
18269635,18269028,18270960,1932,2887,25
18275241,18274634,18276514,1880,2888,25
18281013,18280189,18282069,1880,2889,25
18286567,18285743,18287623,1880,2890,25
18291905,18291298,18293174,1876,2891,25
18297455,18296848,18298728,1880,2892,25
18303009,18302402,18304102,1700,2893,25
18308600,18307776,18309656,1880,2894,25
18313937,18313330,18315684,2354,2895,25
18319966,18319359,18321923,2564,2896,25
18326205,18325598,18328163,2565,2897,25
18332446,18331839,18334404,2565,2898,25
18338686,18338079,18339959,1880,2899,25
18344240,18343633,18345513,1880,2900,25
18350000,18349393,18351056,1663,2901,25
18355554,18354730,18356610,1880,2902,25
18361108,18360284,18362164,1880,2903,25
18366445,18365838,18368509,2671,2904,25
18372791,18372184,18374431,2247,2905,25
18378713,18378106,18379785,1679,2906,25
18384194,18383587,18385250,1663,2907,25
18389531,18388924,18390623,1699,2908,25
18395121,18394297,18396177,1880,2909,25
18400458,18399851,18402521,2670,2910,25
18406803,18406196,18407875,1679,2911,25
18412373,18411549,18413429,1880,2912,25
18417710,18417103,18418983,1880,2913,25
18423264,18422657,18424537,1880,2914,25
18429031,18428424,18430087,1663,2915,25
18434368,18433761,18435461,1700,2916,25
18439742,18439135,18441700,2565,2917,25
18445982,18445375,18447623,2248,2918,25
18451904,18451297,18453177,1880,2919,25
18457458,18456851,18458731,1880,2920,25
18463012,18462405,18464759,2354,2921,25
18469151,18468544,18470207,1663,2922,25
18474488,18473881,18476234,2353,2923,25
18480733,18479909,18481789,1880,2924,25
18486070,18485463,18487343,1880,2925,25
18491625,18491017,18492898,1881,2926,25
18497179,18496572,18498926,2354,2927,25
18503208,18502601,18505165,2564,2928,25
18509587,18508980,18510643,1663,2929,25
18514924,18514317,18516987,2670,2930,25
18521269,18520662,18522910,2248,2931,25
18527311,18526704,18528367,1663,2932,25
18532648,18532041,18534057,2016,2933,25
18538338,18537731,18539978,2247,2934,25
18544476,18543652,18545532,1880,2935,25
18549813,18549206,18551559,2353,2936,25
18555841,18555234,18556913,1679,2937,25
18561323,18560716,18562379,1663,2938,25
18566660,18566053,18567753,1700,2939,25
18572034,18571427,18573307,1880,2940,25
18577588,18576981,18579652,2671,2941,25
18583934,18583327,18585006,1679,2942,25
18589287,18588680,18591265,2585,2943,25
18595547,18594940,18597505,2565,2944,25
18601787,18601180,18603428,2248,2945,25
18607837,18607230,18608893,1663,2946,25
18613391,18612567,18614447,1880,2947,25
18618728,18618121,18620791,2670,2948,25
18625189,18624582,18626245,1663,2949,25
18630526,18629919,18632273,2354,2950,25
18636772,18635948,18637828,1880,2951,25
18642326,18641502,18643382,1880,2952,25
18647880,18647056,18648936,1880,2953,25
18653216,18652610,18654489,1879,2954,25
18658987,18658163,18660043,1880,2955,25
18664542,18663717,18665598,1881,2956,25
18669879,18669272,18671626,2354,2957,25
18676124,18675301,18677180,1879,2958,25
18681678,18680854,18682734,1880,2959,25
18687015,18686408,18688288,1880,2960,25
18692569,18691962,18694315,2353,2961,25
18698596,18697989,18700553,2564,2962,25
18704835,18704228,18706476,2248,2963,25
18710875,18710268,18711931,1663,2964,25
18716428,18715605,18717484,1879,2965,25
18721765,18721158,18723038,1880,2966,25
18727319,18726712,18728411,1699,2967,25
18732692,18732085,18734334,2249,2968,25
18738747,18738140,18739803,1663,2969,25
18744084,18743477,18745493,2016,2970,25
18749775,18749168,18751098,1930,2971,25
18755596,18754772,18756652,1880,2972,25
18761150,18760326,18762206,1880,2973,25
18766487,18765880,18767760,1880,2974,25
18772041,18771434,18773787,2353,2975,25
18778069,18777462,18779342,1880,2976,25
18783624,18783017,18784715,1698,2977,25
18788996,18788389,18790975,2586,2978,25
18795258,18794651,18796531,1880,2979,25
18801019,18800412,18802075,1663,2980,25
18806356,18805749,18808419,2670,2981,25
18812701,18812094,18813974,1880,2982,25
18818468,18817860,18819524,1664,2983,25
18823805,18823198,18825551,2353,2984,25
18829833,18829226,18830905,1679,2985,25
18835403,18834579,18836459,1880,2986,25
18840958,18840134,18842014,1880,2987,25
18846295,18845688,18848359,2671,2988,25
18852857,18852034,18853913,1879,2989,25
18858194,18857587,18859467,1880,2990,25
18863748,18863141,18865812,2671,2991,25
18870094,18869487,18871367,1880,2992,25
18875860,18875041,18876916,1875,2993,25
18881197,18880590,18882606,2016,2994,25
18887021,18886414,18888077,1663,2995,25
18892358,18891751,18893631,1880,2996,25
18897912,18897305,18899637,2332,2997,25
18904136,18903312,18905192,1880,2998,25
18909473,18908866,18910746,1880,2999,25
18915028,18914421,18916437,2016,3000,25
18920719,18920112,18921992,1880,3001,25
18926273,18925666,18928336,2670,3002,25
18932835,18932011,18933891,1880,3003,25
18938389,18937565,18939445,1880,3004,25
18943727,18943120,18945000,1880,3005,25
18949281,18948674,18951344,2670,3006,25
18955626,18955019,18956951,1932,3007,25
18961233,18960625,18962506,1881,3008,25
18966788,18966180,18968061,1881,3009,25
18972342,18971735,18973615,1880,3010,25
18977896,18977289,18979959,2670,3011,25
18984241,18983634,18985514,1880,3012,25
18989795,18989188,18991521,2333,3013,25
18996020,18995196,18997076,1880,3014,25
19001357,19000750,19002630,1880,3015,25
19006912,19006305,19008185,1880,3016,25
19012466,19011859,19013739,1880,3017,25
19018020,19017413,19019428,2015,3018,25
19023710,19023103,19025350,2247,3019,25
19029849,19029025,19030905,1880,3020,25
19035187,19034580,19036596,2016,3021,25
19040878,19040271,19042151,1880,3022,25
19046432,19045825,19047524,1699,3023,25
19051933,19051326,19052989,1663,3024,25
19057486,19056663,19058542,1879,3025,25
19063040,19062216,19064096,1880,3026,25
19068378,19067771,19069471,1700,3027,25
19073752,19073145,19075710,2565,3028,25
19079992,19079385,19081064,1679,3029,25
19085562,19084738,19086618,1880,3030,25
19090900,19090293,19091992,1699,3031,25
19096273,19095666,19097546,1880,3032,25
19102032,19101425,19103088,1663,3033,25
19107370,19106763,19108639,1876,3034,25
19112921,19112314,19114647,2333,3035,25
19118929,19118322,19120887,2565,3036,25
19125169,19124562,19126493,1931,3037,25
19130774,19130167,19132099,1932,3038,25
19136597,19135773,19137653,1880,3039,25
19142151,19141327,19143207,1880,3040,25
19147489,19146882,19149552,2670,3041,25
19153834,19153227,19155158,1931,3042,25
19159439,19158832,19161080,2248,3043,25
19165479,19164872,19166535,1663,3044,25
19170817,19170210,19172087,1877,3045,25
19176368,19175761,19178093,2332,3046,25
19182375,19181768,19183648,1880,3047,25
19187930,19187323,19189023,1700,3048,25
19193306,19192698,19194579,1881,3049,25
19198860,19198253,19200586,2333,3050,25
19205084,19204261,19206140,1879,3051,25
19210637,19209814,19211693,1879,3052,25
19216191,19215367,19217247,1880,3053,25
19221528,19220921,19222620,1699,3054,25
19227036,19226429,19228092,1663,3055,25
19232373,19231766,19233782,2016,3056,25
19238063,19237456,19239705,2249,3057,25
19244204,19243380,19245260,1880,3058,25
19249758,19248934,19250814,1880,3059,25
19255313,19254489,19256369,1880,3060,25
19260650,19260043,19261923,1880,3061,25
19266420,19265597,19267476,1879,3062,25
19271974,19271150,19273030,1880,3063,25
19277311,19276704,19278720,2016,3064,25
19283001,19282395,19284643,2248,3065,25
19288924,19288317,19290249,1932,3066,25
19294530,19293923,19296487,2564,3067,25
19300986,19300162,19302042,1880,3068,25
19306323,19305716,19308049,2333,3069,25
19312548,19311724,19313604,1880,3070,25
19317885,19317278,19319158,1880,3071,25
19323656,19322832,19324712,1880,3072,25
19328994,19328387,19330720,2333,3073,25
19335002,19334395,19336074,1679,3074,25
19340355,19339748,19341427,1679,3075,25
19345708,19345101,19346981,1880,3076,25
19351262,19350655,19352535,1880,3077,25
19356816,19356209,19358089,1880,3078,25
19362370,19361763,19364116,2353,3079,25
19368398,19367791,19369671,1880,3080,25
19373952,19373345,19375360,2015,3081,25
19379642,19379035,19381282,2247,3082,25
19385686,19385079,19386742,1663,3083,25
19391023,19390416,19392293,1877,3084,25
19396791,19395967,19397847,1880,3085,25
19402334,19401727,19403390,1663,3086,25
19407671,19407064,19408944,1880,3087,25
19413225,19412618,19414498,1880,3088,25
19418780,19418173,19419873,1700,3089,25
19424154,19423547,19425794,2247,3090,25
19430076,19429469,19431148,1679,3091,25
19435429,19434822,19436702,1880,3092,25
19441201,19440377,19442257,1880,3093,25
19446538,19445931,19448284,2353,3094,25
19452783,19451959,19453839,1880,3095,25
19458120,19457513,19459212,1699,3096,25
19463493,19462886,19464766,1880,3097,25
19469047,19468440,19470140,1700,3098,25
19474421,19473814,19475746,1932,3099,25
19480144,19479537,19481200,1663,3100,25
19485699,19484875,19486755,1880,3101,25
19491253,19490429,19492309,1880,3102,25
19496792,19496185,19497848,1663,3103,25
19502341,19501522,19503397,1875,3104,25
19507678,19507071,19509741,2670,3105,25
19514023,19513417,19515664,2247,3106,25
19520163,19519339,19521219,1880,3107,25
19525500,19524893,19526909,2016,3108,25
19531408,19530584,19532464,1880,3109,25
19536745,19536138,19537837,1699,3110,25
19542258,19541651,19543314,1663,3111,25
19547596,19546988,19549005,2017,3112,25
19553287,19552680,19555265,2585,3113,25
19559547,19558940,19560619,1679,3114,25
19565117,19564293,19566173,1880,3115,25
19570666,19569848,19571722,1874,3116,25
19576003,19575396,19577276,1880,3117,25
19581558,19580951,19582831,1880,3118,25
19587113,19586505,19588522,2017,3119,25
19592804,19592197,19594783,2586,3120,25
19599186,19598579,19600242,1663,3121,25
19604523,19603916,19605796,1880,3122,25
19610077,19609470,19611350,1880,3123,25
19615843,19615236,19616899,1663,3124,25
19621394,19620574,19622450,1876,3125,25
19626948,19626124,19628004,1880,3126,25
19632285,19631678,19633558,1880,3127,25
19638056,19637232,19639112,1880,3128,25
19643393,19642786,19644484,1698,3129,25
19648765,19648158,19650090,1932,3130,25
19654371,19653764,19656329,2565,3131,25
19660611,19660004,19661884,1880,3132,25
19666165,19665558,19667438,1880,3133,25
19671936,19671329,19672992,1663,3134,25
19677490,19676666,19678546,1880,3135,25
19682827,19682220,19684100,1880,3136,25
19688382,19687774,19689474,1700,3137,25
19693755,19693148,19694826,1678,3138,25
19699324,19698500,19700380,1880,3139,25
19704661,19704054,19705934,1880,3140,25
19710214,19709608,19712277,2669,3141,25
19716559,19715952,19717832,1880,3142,25
19722113,19721506,19723522,2016,3143,25
19728020,19727196,19729076,1880,3144,25
19733574,19732750,19734630,1880,3145,25
19738910,19738304,19740974,2670,3146,25
19745473,19744649,19746529,1880,3147,25
19750810,19750203,19752536,2333,3148,25
19756818,19756211,19758458,2247,3149,25
19762861,19762254,19763917,1663,3150,25
19768198,19767591,19770262,2671,3151,25
19774544,19773937,19775817,1880,3152,25
19780315,19779491,19781371,1880,3153,25
19785652,19785045,19787060,2015,3154,25
19791342,19790735,19792615,1880,3155,25
19796896,19796289,19798305,2016,3156,25
19802804,19801980,19803860,1880,3157,25
19808359,19807535,19809415,1880,3158,25
19813696,19813089,19814969,1880,3159,25
19819251,19818644,19820976,2332,3160,25
19825258,19824651,19826899,2248,3161,25
19831181,19830574,19832253,1679,3162,25
19836534,19835927,19838175,2248,3163,25
19842594,19841987,19843650,1663,3164,25
19847931,19847324,19849994,2670,3165,25
19854276,19853669,19855347,1678,3166,25
19859628,19859021,19861269,2248,3167,25
19865768,19864944,19866824,1880,3168,25
19871303,19870696,19872359,1663,3169,25
19876640,19876033,19878365,2332,3170,25
19882647,19882040,19883920,1880,3171,25
19888201,19887594,19890264,2670,3172,25
19894547,19893940,19895619,1679,3173,25
19899900,19899293,19901858,2565,3174,25
19906140,19905533,19907413,1880,3175,25
19911694,19911087,19913420,2333,3176,25
19917919,19917095,19918975,1880,3177,25
19923470,19922863,19924526,1663,3178,25
19929024,19928200,19930080,1880,3179,25
19934361,19933754,19935634,1880,3180,25
19939916,19939309,19941189,1880,3181,25
19945470,19944863,19947196,2333,3182,25
19951695,19950871,19952751,1880,3183,25
19957032,19956425,19958124,1699,3184,25
19962406,19961799,19963731,1932,3185,25
19968012,19967405,19969285,1880,3186,25
19973783,19972959,19974839,1880,3187,25
19979120,19978513,19980529,2016,3188,25
19984810,19984203,19986768,2565,3189,25
19991051,19990444,19992376,1932,3190,25
19996785,19996178,19997841,1663,3191,25
20002339,20001515,20003395,1880,3192,25
20007677,20007070,20009741,2671,3193,25
20014135,20013528,20015191,1663,3194,25
20019473,20018866,20021537,2671,3195,25
20026037,20025213,20027093,1880,3196,25
20031375,20030768,20032468,1700,3197,25
20036750,20036143,20037822,1679,3198,25
20042321,20041497,20043377,1880,3199,25
20047871,20047052,20048927,1875,3200,25
20053415,20052807,20054471,1664,3201,25
20058753,20058146,20060163,2017,3202,25
20064445,20063838,20066403,2565,3203,25
20070686,20070079,20071757,1678,3204,25
20076039,20075432,20077680,2248,3205,25
20081962,20081355,20083920,2565,3206,25
20088420,20087596,20089476,1880,3207,25
20093975,20093151,20095031,1880,3208,25
20099313,20098706,20101376,2670,3209,25
20105659,20105052,20106984,1932,3210,25
20111266,20110659,20112539,1880,3211,25
20116821,20116214,20118863,2649,3212,25
20123146,20122539,20124218,1679,3213,25
20128500,20127893,20130142,2249,3214,25
20134642,20133818,20135698,1880,3215,25
20139980,20139373,20141073,1700,3216,25
20145355,20144748,20147314,2566,3217,25
20151597,20150990,20153556,2566,3218,25
20158056,20157232,20159112,1880,3219,25
20163394,20162787,20165120,2333,3220,25
20169402,20168795,20171044,2249,3221,25
20175327,20174720,20176652,1932,3222,25
20180934,20180327,20182207,1880,3223,25
20186489,20185882,20187899,2017,3224,25
20192182,20191575,20193507,1932,3225,25
20197789,20197182,20199062,1880,3226,25
20203344,20202737,20204753,2016,3227,25
20209036,20208429,20210677,2248,3228,25
20214960,20214353,20216032,1679,3229,25
20220531,20219707,20221588,1881,3230,25
20226088,20225264,20227144,1880,3231,25
20231426,20230819,20233152,2333,3232,25
20237435,20236828,20239394,2566,3233,25
20243894,20243070,20244950,1880,3234,25
20249232,20248625,20250958,2333,3235,25
20255240,20254633,20256312,1679,3236,25
20260594,20259987,20262236,2249,3237,25
20266736,20265912,20267793,1881,3238,25
20272075,20271468,20273801,2333,3239,25
20278301,20277477,20279357,1880,3240,25
20283846,20283239,20284903,1664,3241,25
20289185,20288578,20290910,2332,3242,25
20295193,20294586,20296264,1678,3243,25
20300546,20299939,20301618,1679,3244,25
20306117,20305293,20307173,1880,3245,25
20311455,20310848,20312864,2016,3246,25
20317147,20316540,20318219,1679,3247,25
20322501,20321894,20323572,1678,3248,25
20327854,20327247,20329494,2247,3249,25
20333777,20333170,20335050,1880,3250,25
20339332,20338725,20340741,2016,3251,25
20345024,20344417,20346666,2249,3252,25
20350949,20350342,20352222,1880,3253,25
20356721,20355897,20357778,1881,3254,25
20362060,20361453,20363153,1700,3255,25
20367553,20366946,20368610,1664,3256,25
20372892,20372285,20374956,2671,3257,25
20379239,20378632,20380880,2248,3258,25
20385162,20384555,20386487,1932,3259,25
20390890,20390283,20391947,1664,3260,25
20396229,20395622,20397498,1876,3261,25
20401980,20401373,20403036,1663,3262,25
20407530,20406711,20408587,1876,3263,25
20412869,20412262,20414595,2333,3264,25
20418878,20418271,20420151,1880,3265,25
20424650,20423826,20425707,1881,3266,25
20430207,20429383,20431264,1881,3267,25
20435764,20434940,20436821,1881,3268,25
20441104,20440497,20443147,2650,3269,25
20447430,20446823,20449389,2566,3270,25
20453672,20453065,20454744,1679,3271,25
20459242,20458419,20460299,1880,3272,25
20464581,20463974,20465990,2016,3273,25
20470405,20469798,20471462,1664,3274,25
20475745,20475138,20477019,1881,3275,25
20481302,20480695,20482711,2016,3276,25
20486993,20486386,20488635,2249,3277,25
20492917,20492310,20494190,1880,3278,25
20498471,20497864,20499880,2016,3279,25
20504162,20503555,20506120,2565,3280,25
20510403,20509796,20512045,2249,3281,25
20516327,20515720,20517600,1880,3282,25
20521882,20521275,20523155,1880,3283,25
20527438,20526830,20529164,2334,3284,25
20533663,20532839,20534719,1880,3285,25
20539217,20538610,20540273,1663,3286,25
20544554,20543948,20545964,2016,3287,25
20550246,20549639,20552204,2565,3288,25
20556605,20555998,20557662,1664,3289,25
20561944,20561337,20563037,1700,3290,25
20567319,20566712,20568961,2249,3291,25
20573243,20572636,20574315,1679,3292,25
20578597,20577990,20580555,2565,3293,25
20585055,20584231,20586111,1880,3294,25
20590393,20589786,20591485,1699,3295,25
20595983,20595160,20597039,1879,3296,25
20601321,20600714,20603385,2671,3297,25
20607668,20607061,20609627,2566,3298,25
20613910,20613303,20614982,1679,3299,25
20619264,20618657,20620589,1932,3300,25
20624871,20624264,20626144,1880,3301,25
20630426,20629819,20631519,1700,3302,25
20635801,20635194,20637442,2248,3303,25
20641724,20641117,20642997,1880,3304,25
20647279,20646672,20649004,2332,3305,25
20653503,20652679,20654559,1880,3306,25
20659045,20658438,20660101,1663,3307,25
20664383,20663776,20665475,1699,3308,25
20669895,20669287,20670951,1664,3309,25
20675233,20674626,20676642,2016,3310,25
20681141,20680317,20682197,1880,3311,25
20686479,20685872,20687889,2017,3312,25
20692171,20691564,20693813,2249,3313,25
20698215,20697608,20699271,1663,3314,25
20703553,20702946,20704645,1699,3315,25
20708927,20708320,20710884,2564,3316,25
20715168,20714560,20716492,1932,3317,25
20720774,20720167,20722099,1932,3318,25
20726381,20725774,20728023,2249,3319,25
20732305,20731698,20733630,1932,3320,25
20737912,20737305,20739236,1931,3321,25
20743518,20742911,20745160,2249,3322,25
20749659,20748835,20750715,1880,3323,25
20754997,20754390,20756407,2017,3324,25
20760689,20760082,20762014,1932,3325,25
20766296,20765689,20767938,2249,3326,25
20772221,20771614,20773293,1679,3327,25
20777792,20776968,20778848,1880,3328,25
20783340,20782733,20784397,1664,3329,25
20788679,20788072,20789951,1879,3330,25
20794433,20793826,20795489,1663,3331,25
20799988,20799164,20801045,1881,3332,25
20805327,20804720,20806420,1700,3333,25
20810702,20810095,20812342,2247,3334,25
20816624,20816017,20818266,2249,3335,25
20822661,20822054,20823717,1663,3336,25
20828216,20827392,20829272,1880,3337,25
20833554,20832947,20835618,2671,3338,25
20840040,20839433,20841096,1663,3339,25
20845378,20844771,20847442,2671,3340,25
20851725,20851118,20852797,1679,3341,25
20857079,20856472,20858720,2248,3342,25
20863002,20862395,20864327,1932,3343,25
20868825,20868002,20869881,1879,3344,25
20874163,20873556,20875436,1880,3345,25
20879935,20879328,20880991,1663,3346,25
20885273,20884666,20886546,1880,3347,25
20891045,20890221,20892101,1880,3348,25
20896383,20895776,20897792,2016,3349,25
20902074,20901467,20903715,2248,3350,25
20908213,20907390,20909269,1879,3351,25
20913551,20912944,20915277,2333,3352,25
20919560,20918952,20920833,1881,3353,25
20925115,20924508,20926387,1879,3354,25
20930885,20930062,20931941,1879,3355,25
20936425,20935818,20937481,1663,3356,25
20944072,20943465,20945883,2418,3357,25
20950166,20949559,20951238,1679,3358,25
20955520,20954913,20957478,2565,3359,25
20961873,20961266,20962929,1663,3360,25
20967211,20966604,20968620,2016,3361,25
20973022,20972415,20974078,1663,3362,25
20978360,20977753,20979633,1880,3363,25
20983915,20983308,20985188,1880,3364,25
20989470,20988863,20991196,2333,3365,25
20995695,20994871,20996751,1880,3366,25
21001032,21000425,21003095,2670,3367,25
21007594,21006770,21008650,1880,3368,25
21012932,21012325,21014342,2017,3369,25
21018841,21018017,21019897,1880,3370,25
21024178,21023571,21025588,2017,3371,25
21029870,21029263,21030942,1679,3372,25
21035441,21034617,21036497,1880,3373,25
21040779,21040172,21042843,2671,3374,25
21047126,21046519,21048768,2249,3375,25
21053050,21052443,21054690,2247,3376,25
21058972,21058365,21060044,1679,3377,25
21064543,21063719,21065599,1880,3378,25
21070092,21069485,21071148,1663,3379,25
21075430,21074823,21077494,2671,3380,25
21081777,21081170,21083734,2564,3381,25
21088233,21087410,21089289,1879,3382,25
21093571,21092964,21095296,2332,3383,25
21099578,21098971,21101220,2249,3384,25
21105502,21104895,21106827,1932,3385,25
21111109,21110502,21113067,2565,3386,25
21117463,21116856,21118519,1663,3387,25
21123019,21122411,21124075,1664,3388,25
21128574,21127750,21129630,1880,3389,25
21134128,21133304,21135184,1880,3390,25
21139466,21138859,21140876,2017,3391,25
21145158,21144551,21146431,1880,3392,25
21150713,21150106,21151986,1880,3393,25
21156466,21155859,21157522,1663,3394,25
21161803,21161196,21162896,1700,3395,25
21167309,21166702,21168365,1663,3396,25
21172647,21172040,21174373,2333,3397,25
21178655,21178048,21179727,1679,3398,25
21184226,21183402,21185282,1880,3399,25
21189565,21188957,21191629,2672,3400,25
21195912,21195305,21197870,2565,3401,25
21202153,21201546,21203426,1880,3402,25
21207708,21207101,21209434,2333,3403,25
21213716,21213109,21214788,1679,3404,25
21219070,21218463,21220395,1932,3405,25
21224677,21224070,21225749,1679,3406,25
21230031,21229424,21231103,1679,3407,25
21235385,21234778,21236658,1880,3408,25
21241150,21240543,21242206,1663,3409,25
21246488,21245881,21247898,2017,3410,25
21252397,21251573,21253453,1880,3411,25
21257735,21257128,21259798,2670,3412,25
21264081,21263474,21266039,2565,3413,25
21270447,21269840,21271503,1663,3414,25
21275998,21275178,21277054,1876,3415,25
21281336,21280729,21282609,1880,3416,25
21286891,21286284,21288164,1880,3417,25
21292446,21291839,21293539,1700,3418,25
21297821,21297214,21299779,2565,3419,25
21304173,21303566,21305229,1663,3420,25
21309509,21308903,21310782,1879,3421,25
21315064,21314457,21316157,1700,3422,25
21320439,21319832,21321511,1679,3423,25
21325793,21325186,21327434,2248,3424,25
21331716,21331109,21333041,1932,3425,25
21337540,21336716,21338596,1880,3426,25
21342879,21342271,21344152,1881,3427,25
21348434,21347827,21349526,1699,3428,25
21353808,21353201,21355132,1931,3429,25
21359414,21358807,21361372,2565,3430,25
21365872,21365048,21366928,1880,3431,25
21371427,21370603,21372483,1880,3432,25
21376982,21376158,21378038,1880,3433,25
21382537,21381713,21383593,1880,3434,25
21387875,21387268,21388967,1699,3435,25
21393466,21392642,21394522,1880,3436,25
21398804,21398197,21399897,1700,3437,25
21404309,21403702,21405365,1663,3438,25
21409647,21409040,21410920,1880,3439,25
21415401,21414794,21416457,1663,3440,25
21420739,21420132,21422465,2333,3441,25
21426860,21426253,21427917,1664,3442,25
21432199,21431592,21433608,2016,3443,25
21437890,21437283,21439215,1932,3444,25
21443497,21442890,21444770,1880,3445,25
21449052,21448445,21451116,2671,3446,25
21455522,21454915,21456578,1663,3447,25
21460860,21460253,21462923,2670,3448,25
21467422,21466599,21468478,1879,3449,25
21472760,21472153,21474486,2333,3450,25
21478768,21478161,21480041,1880,3451,25
21484540,21483716,21485596,1880,3452,25
21489878,21489271,21491603,2332,3453,25
21496103,21495279,21497160,1881,3454,25
21501442,21500835,21503506,2671,3455,25
21508006,21507182,21509062,1880,3456,25
21513556,21512737,21514612,1875,3457,25
21518894,21518287,21520957,2670,3458,25
21525240,21524633,21526513,1880,3459,25
21531012,21530188,21532068,1880,3460,25
21536350,21535743,21537760,2017,3461,25
21542177,21541570,21543233,1663,3462,25
21547732,21546908,21548788,1880,3463,25
21553070,21552463,21555134,2671,3464,25
21559633,21558810,21560689,1879,3465,25
21564971,21564364,21566244,1880,3466,25
21570526,21569919,21571799,1880,3467,25
21576298,21575691,21577354,1663,3468,25
21581636,21581029,21582909,1880,3469,25
21587191,21586584,21588284,1700,3470,25
21592676,21592069,21593732,1663,3471,25
21598014,21597407,21599282,1875,3472,25
21603564,21602957,21604837,1880,3473,25
21609119,21608512,21616290,7778,3474,25
21620573,21619966,21622531,2565,3475,25
21626814,21626207,21634196,7989,3476,25
21638479,21637872,21639551,1679,3477,25
21643833,21643226,21644905,1679,3478,25
21649187,21648580,21651145,2565,3479,25
21655566,21654959,21656622,1663,3480,25
21661120,21660297,21662176,1879,3481,25
21666458,21665851,21668521,2670,3482,25
21672804,21672197,21674762,2565,3483,25
21679045,21678438,21680687,2249,3484,25
21685106,21684499,21686162,1663,3485,25
21690444,21689837,21691717,1880,3486,25
21695999,21695392,21698063,2671,3487,25
21702457,21701850,21703513,1663,3488,25
21707795,21707188,21709069,1881,3489,25
21713351,21712744,21715414,2670,3490,25
21719697,21719090,21720769,1679,3491,25
21725268,21724444,21726324,1880,3492,25
21730606,21729999,21732332,2333,3493,25
21736830,21736007,21737886,1879,3494,25
21742168,21741561,21744232,2671,3495,25
21748515,21747908,21749788,1880,3496,25
21754285,21753463,21755342,1879,3497,25
21759624,21759017,21761351,2334,3498,25
21765633,21765026,21766906,1880,3499,25
21771187,21770581,21772460,1879,3500,25
21776742,21776135,21777835,1700,3501,25
21782117,21781510,21783189,1679,3502,25
21787471,21786864,21788543,1679,3503,25
21792825,21792218,21794783,2565,3504,25
21799066,21798459,21800391,1932,3505,25
21804673,21804066,21806315,2249,3506,25
21810597,21809990,21812555,2565,3507,25
21817055,21816231,21818111,1880,3508,25
21822393,21821786,21823666,1880,3509,25
21828154,21827547,21829210,1663,3510,25
21833492,21832885,21834585,1700,3511,25
21838867,21838260,21840140,1880,3512,25
21844639,21843815,21845695,1880,3513,25
21849977,21849370,21851070,1700,3514,25
21855352,21854745,21856625,1880,3515,25
21860907,21860300,21862317,2017,3516,25
21866817,21865993,21867873,1880,3517,25
21872155,21871548,21873881,2333,3518,25
21878164,21877557,21879806,2249,3519,25
21884088,21883481,21885361,1880,3520,25
21889643,21889036,21890912,1876,3521,25
21895194,21894587,21896604,2017,3522,25
21901104,21900280,21902160,1880,3523,25
21906442,21905835,21907715,1880,3524,25
21911997,21911390,21913723,2333,3525,25
21918222,21917398,21919279,1881,3526,25
21923561,21922954,21925287,2333,3527,25
21929706,21929099,21930762,1663,3528,25
21935044,21934437,21936317,1880,3529,25
21940817,21940209,21941873,1664,3530,25
21946155,21945548,21947248,1700,3531,25
21951530,21950923,21952803,1880,3532,25
21957085,21956478,21958493,2015,3533,25
21962992,21962168,21964048,1880,3534,25
21968330,21967723,21969603,1880,3535,25
21973885,21973278,21975293,2015,3536,25
21979575,21978968,21980647,1679,3537,25
21984929,21984322,21986571,2249,3538,25
21991070,21990246,21992126,1880,3539,25
21996625,21996018,21997682,1664,3540,25
22001964,22001357,22004007,2650,3541,25
22008507,22007683,22009563,1880,3542,25
22013844,22013238,22014937,1699,3543,25
22019219,22018612,22020861,2249,3544,25
22025360,22024536,22026416,1880,3545,25
22030900,22030293,22031956,1663,3546,25
22036238,22035631,22037648,2017,3547,25
22042047,22041440,22043103,1663,3548,25
22047384,22046778,22048652,1874,3549,25
22052934,22052327,22054026,1699,3550,25
22058308,22057701,22059581,1880,3551,25
22063863,22063256,22065927,2671,3552,25
22070210,22069603,22072167,2564,3553,25
22076451,22075843,22077523,1680,3554,25
22081805,22081198,22083447,2249,3555,25
22087947,22087123,22089004,1881,3556,25
22093286,22092679,22094559,1880,3557,25
22098841,22098234,22100114,1880,3558,25
22104396,22103789,22106460,2671,3559,25
22110743,22110136,22111815,1679,3560,25
22116097,22115490,22117739,2249,3561,25
22122022,22121415,22123295,1880,3562,25
22127794,22126970,22128850,1880,3563,25
22133132,22132525,22134542,2017,3564,25
22138941,22138334,22139997,1663,3565,25
22144279,22143672,22146342,2670,3566,25
22150734,22150127,22151790,1663,3567,25
22156289,22155682,22157346,1664,3568,25
22161628,22161021,22163037,2016,3569,25
22167319,22166712,22168391,1679,3570,25
22172673,22172066,22174630,2564,3571,25
22179130,22178306,22180187,1881,3572,25
22184469,22183862,22185878,2016,3573,25
22190160,22189553,22192118,2565,3574,25
22196617,22195794,22197673,1879,3575,25
22201955,22201348,22203048,1700,3576,25
22207330,22206723,22208402,1679,3577,25
22212900,22212077,22213956,1879,3578,25
22218238,22217631,22219965,2334,3579,25
22224247,22223640,22226205,2565,3580,25
22230705,22229881,22231762,1881,3581,25
22236261,22235437,22237318,1881,3582,25
22241600,22240993,22242869,1876,3583,25
22247151,22246544,22248424,1880,3584,25
22252706,22252099,22254770,2671,3585,25
22259171,22258564,22260228,1664,3586,25
22264727,22263903,22265783,1880,3587,25
22270282,22269458,22271339,1881,3588,25
22275621,22275014,22276894,1880,3589,25
22281176,22280569,22283240,2671,3590,25
22287740,22286916,22288796,1880,3591,25
22293078,22292471,22294170,1699,3592,25
22298452,22297845,22299524,1679,3593,25
22303806,22303199,22305763,2564,3594,25
22310046,22309439,22311319,1880,3595,25
22315601,22314994,22317327,2333,3596,25
22321827,22321003,22322884,1881,3597,25
22327166,22326559,22328575,2016,3598,25
22332857,22332250,22334130,1880,3599,25
22338412,22337805,22339685,1880,3600,25
22344184,22343360,22345240,1880,3601,25
22349522,22348915,22350930,2015,3602,25
22355430,22354606,22356486,1880,3603,25
22360768,22360161,22362041,1880,3604,25
22366323,22365716,22367596,1880,3605,25
22371878,22371271,22373151,1880,3606,25
22377433,22376826,22378706,1880,3607,25
22382988,22382381,22384261,1880,3608,25
22388754,22388147,22389811,1664,3609,25
22394093,22393486,22396156,2670,3610,25
22400440,22399833,22401765,1932,3611,25
22406047,22405440,22407371,1931,3612,25
22411653,22411046,22412725,1679,3613,25
22417007,22416400,22418280,1880,3614,25
22422760,22422153,22423816,1663,3615,25
22428098,22427491,22429371,1880,3616,25
22433870,22433046,22434926,1880,3617,25
22439412,22438805,22440468,1663,3618,25
22444967,22444360,22446023,1663,3619,25
22450305,22449698,22452369,2671,3620,25
22456869,22456045,22457925,1880,3621,25
22462423,22461600,22463479,1879,3622,25
22467761,22467154,22469825,2671,3623,25
22474242,22473635,22475298,1663,3624,25
22479580,22478973,22480849,1876,3625,25
22485131,22484524,22486404,1880,3626,25
22490903,22490079,22491959,1880,3627,25
22496241,22495634,22497514,1880,3628,25
22501796,22501189,22503859,2670,3629,25
22508142,22507535,22510100,2565,3630,25
22514383,22513776,22516025,2249,3631,25
22520524,22519700,22521580,1880,3632,25
22526076,22525256,22527133,1877,3633,25
22531415,22530808,22533140,2332,3634,25
22537639,22536815,22538695,1880,3635,25
22542977,22542370,22544069,1699,3636,25
22548568,22547744,22549624,1880,3637,25
22553906,22553299,22554999,1700,3638,25
22559411,22558804,22560467,1663,3639,25
22564750,22564142,22566476,2334,3640,25
22570758,22570151,22572399,2248,3641,25
22576898,22576074,22577954,1880,3642,25
22582236,22581629,22583962,2333,3643,25
22588245,22587638,22589317,1679,3644,25
22593816,22592992,22594872,1880,3645,25
22599153,22598547,22601217,2670,3646,25
22605501,22604893,22607142,2249,3647,25
22611641,22610817,22612697,1880,3648,25
22616979,22616372,22618388,2016,3649,25
22622670,22622063,22624310,2247,3650,25
22628592,22627985,22630233,2248,3651,25
22634516,22633909,22635840,1931,3652,25
22640122,22639515,22641764,2249,3653,25
22646047,22645440,22647119,1679,3654,25
22651401,22650794,22652674,1880,3655,25
22657173,22656349,22658229,1880,3656,25
22662715,22662108,22663771,1663,3657,25
22668053,22667446,22669463,2017,3658,25
22673746,22673139,22675388,2249,3659,25
22679670,22679063,22680742,1679,3660,25
22685024,22684417,22686297,1880,3661,25
22690796,22689972,22691852,1880,3662,25
22696134,22695527,22697407,1880,3663,25
22701905,22701082,22702962,1880,3664,25
22707244,22706637,22708970,2333,3665,25
22713373,22712765,22714429,1664,3666,25
22718711,22718104,22720775,2671,3667,25
22725058,22724451,22726331,1880,3668,25
22730613,22730006,22732023,2017,3669,25
22736306,22735699,22737948,2249,3670,25
22742230,22741623,22743555,1932,3671,25
22748054,22747230,22749110,1880,3672,25
22753392,22752785,22755456,2671,3673,25
22759956,22759132,22761012,1880,3674,25
22765294,22764687,22766567,1880,3675,25
22770849,22770242,22771941,1699,3676,25
22776223,22775616,22777496,1880,3677,25
22781778,22781171,22783051,1880,3678,25
22787548,22786941,22788604,1663,3679,25
22792886,22792279,22794950,2671,3680,25
22799233,22798626,22800506,1880,3681,25
22805004,22804181,22806060,1879,3682,25
22810342,22809735,22811615,1880,3683,25
22815897,22815290,22817961,2671,3684,25
22822244,22821637,22823517,1880,3685,25
22828007,22827400,22829064,1664,3686,25
22833346,22832739,22834756,2017,3687,25
22839039,22838432,22840364,1932,3688,25
22844782,22844175,22845839,1664,3689,25
22850338,22849514,22851394,1880,3690,25
22855676,22855069,22857085,2016,3691,25
22861368,22860761,22862440,1679,3692,25
22866722,22866115,22868680,2565,3693,25
22872963,22872356,22874605,2249,3694,25
22879002,22878395,22880059,1664,3695,25
22884341,22883734,22886404,2670,3696,25
22890904,22890080,22891961,1881,3697,25
22896460,22895636,22897517,1881,3698,25
22901799,22901192,22902892,1700,3699,25
22907292,22906685,22908349,1664,3700,25
22912632,22912025,22914675,2650,3701,25
22918958,22918351,22920231,1880,3702,25
22924513,22923906,22925786,1880,3703,25
22930068,22929461,22931478,2017,3704,25
22935761,22935154,22937720,2566,3705,25
22942003,22941396,22943075,1679,3706,25
22947574,22946750,22948630,1880,3707,25
22952912,22952305,22954185,1880,3708,25
22958467,22957860,22959740,1880,3709,25
22964238,22963415,22965294,1879,3710,25
22969775,22969168,22970831,1663,3711,25
22975329,22974722,22976386,1664,3712,25
22980668,22980061,22981941,1880,3713,25
22986223,22985616,22987633,2017,3714,25
22992131,22991308,22993187,1879,3715,25
22997469,22996862,22998879,2017,3716,25
23003288,23002681,23004344,1663,3717,25
23008843,23008019,23009899,1880,3718,25
23014181,23013574,23015274,1700,3719,25
23019669,23019062,23020725,1663,3720,25
23025007,23024400,23026100,1700,3721,25
23030382,23029775,23032024,2249,3722,25
23036524,23035700,23037581,1881,3723,25
23041863,23041256,23043927,2671,3724,25
23048210,23047603,23049282,1679,3725,25
23053564,23052957,23055522,2565,3726,25
23059805,23059198,23061763,2565,3727,25
23066046,23065439,23067688,2249,3728,25
23071970,23071363,23073042,1679,3729,25
23077324,23076717,23078649,1932,3730,25
23083148,23082324,23084204,1880,3731,25
23088486,23087879,23090550,2671,3732,25
23094833,23094226,23096791,2565,3733,25
23101212,23100605,23102268,1663,3734,25
23106550,23105943,23108613,2670,3735,25
23112896,23112289,23114169,1880,3736,25
23118451,23117844,23119724,1880,3737,25
23124006,23123399,23125416,2017,3738,25
23129698,23129091,23130971,1880,3739,25
23135253,23134646,23136979,2333,3740,25
23141478,23140654,23142535,1881,3741,25
23147034,23146210,23148090,1880,3742,25
23152372,23151765,23153464,1699,3743,25
23157746,23157139,23158818,1679,3744,25
23163100,23162493,23165058,2565,3745,25
23169557,23168734,23170613,1879,3746,25
23174895,23174288,23176959,2671,3747,25
23181459,23180635,23182515,1880,3748,25
23186797,23186190,23188207,2017,3749,25
23192490,23191883,23193763,1880,3750,25
23198045,23197438,23199771,2333,3751,25
23204184,23203577,23205240,1663,3752,25
23209739,23208915,23210795,1880,3753,25
23215294,23214470,23216350,1880,3754,25
23220632,23220025,23221905,1880,3755,25
23226187,23225580,23227460,1880,3756,25
23231742,23231135,23233806,2671,3757,25
23238089,23237482,23239161,1679,3758,25
23243443,23242836,23244515,1679,3759,25
23249014,23248190,23250070,1880,3760,25
23254352,23253745,23255625,1880,3761,25
23259907,23259300,23261180,1880,3762,25
23265679,23264855,23266735,1880,3763,25
23271222,23270615,23272278,1663,3764,25
23276560,23275953,23278624,2671,3765,25
23282907,23282300,23283978,1678,3766,25
23288260,23287653,23289584,1931,3767,25
23294083,23293259,23295139,1880,3768,25
23299421,23298814,23300694,1880,3769,25
23305193,23304586,23306249,1663,3770,25
23310531,23309924,23311804,1880,3771,25
23316086,23315479,23317359,1880,3772,25
23321641,23321034,23323367,2333,3773,25
23327649,23327042,23328721,1679,3774,25
23333003,23332396,23334075,1679,3775,25
23338357,23337750,23339682,1932,3776,25
23344081,23343474,23345137,1663,3777,25
23349636,23349029,23350692,1663,3778,25
23354974,23354367,23356247,1880,3779,25
23360529,23359922,23361938,2016,3780,25
23366220,23365613,23367292,1679,3781,25
23371574,23370967,23373215,2248,3782,25
23377498,23376890,23378822,1932,3783,25
23383321,23382497,23384378,1881,3784,25
23388877,23388053,23389933,1880,3785,25
23394215,23393608,23395483,1875,3786,25
23399982,23399158,23401038,1880,3787,25
23405320,23404713,23406593,1880,3788,25
23411079,23410471,23412136,1665,3789,25
23416418,23415811,23417827,2016,3790,25
23422327,23421503,23423384,1881,3791,25
23427667,23427060,23428760,1700,3792,25
23433259,23432435,23434315,1880,3793,25
23438597,23437990,23440660,2670,3794,25
23445160,23444336,23446216,1880,3795,25
23450498,23449891,23451908,2017,3796,25
23456191,23455584,23457516,1932,3797,25
23461798,23461191,23463122,1931,3798,25
23467404,23466797,23469046,2249,3799,25
23473449,23472842,23474505,1663,3800,25
23479004,23478180,23480061,1881,3801,25
23484343,23483736,23485752,2016,3802,25
23490252,23489428,23491309,1881,3803,25
23495808,23495201,23496865,1664,3804,25
23501364,23500540,23502421,1881,3805,25
23506703,23506096,23508112,2016,3806,25
23512612,23511788,23513668,1880,3807,25
23517950,23517343,23519360,2017,3808,25
23523860,23523036,23524917,1881,3809,25
23529199,23528592,23530607,2015,3810,25
23535004,23534397,23536061,1664,3811,25
23540560,23539736,23541617,1881,3812,25
23545899,23545292,23547308,2016,3813,25
23551591,23550984,23553550,2566,3814,25
23557949,23557342,23559005,1663,3815,25
23563287,23562680,23565351,2671,3816,25
23569634,23569027,23571276,2249,3817,25
23575558,23574951,23576630,1679,3818,25
23580912,23580305,23581984,1679,3819,25
23586483,23585659,23587539,1880,3820,25
23591820,23591214,23592913,1699,3821,25
23597195,23596588,23598267,1679,3822,25
23602549,23601942,23603874,1932,3823,25
23608156,23607549,23609798,2249,3824,25
23614298,23613474,23615354,1880,3825,25
23619636,23619029,23620729,1700,3826,25
23625228,23624404,23626285,1881,3827,25
23630567,23629960,23632293,2333,3828,25
23636792,23635968,23637848,1880,3829,25
23642130,23641523,23643403,1880,3830,25
23647685,23647078,23648777,1699,3831,25
23653059,23652452,23654332,1880,3832,25
23658614,23658007,23660677,2670,3833,25
23664961,23664354,23666033,1679,3834,25
23670315,23669708,23671387,1679,3835,25
23675669,23675062,23677310,2248,3836,25
23681810,23680986,23682866,1880,3837,25
23687148,23686541,23688421,1880,3838,25
23692703,23692096,23693976,1880,3839,25
23698474,23697651,23699530,1879,3840,25
23703812,23703205,23705538,2333,3841,25
23709821,23709214,23711779,2565,3842,25
23716062,23715455,23717703,2248,3843,25
23722095,23721488,23723151,1663,3844,25
23727433,23726826,23728526,1700,3845,25
23733025,23732201,23734082,1881,3846,25
23738581,23737974,23739637,1663,3847,25
23744131,23743312,23745187,1875,3848,25
23749469,23748862,23750742,1880,3849,25
23755024,23754417,23756117,1700,3850,25
23760399,23759792,23761672,1880,3851,25
23765954,23765347,23768017,2670,3852,25
23772300,23771693,23773625,1932,3853,25
23777907,23777300,23779549,2249,3854,25
23783831,23783224,23784903,1679,3855,25
23789185,23788578,23790509,1931,3856,25
23794925,23794318,23795982,1664,3857,25
23800264,23799657,23801674,2017,3858,25
23806076,23805469,23807133,1664,3859,25
23811415,23810808,23813141,2333,3860,25
23817423,23816816,23818495,1679,3861,25
23822777,23822170,23824735,2565,3862,25
23829135,23828528,23830191,1663,3863,25
23834473,23833866,23835883,2017,3864,25
23840165,23839558,23842122,2564,3865,25
23846622,23845798,23847678,1880,3866,25
23851960,23851353,23853233,1880,3867,25
23857732,23857125,23858789,1664,3868,25
23863071,23862464,23865135,2671,3869,25
23869635,23868811,23870691,1880,3870,25
23874973,23874366,23876699,2333,3871,25
23880981,23880374,23882622,2248,3872,25
23887027,23886420,23888084,1664,3873,25
23892366,23891759,23893639,1880,3874,25
23897921,23897314,23899984,2670,3875,25
23904267,23903660,23906226,2566,3876,25
23910726,23909902,23911782,1880,3877,25
23916064,23915457,23917337,1880,3878,25
23921620,23921012,23923684,2672,3879,25
23927967,23927360,23929039,1679,3880,25
23933321,23932714,23934594,1880,3881,25
23938876,23938269,23940149,1880,3882,25
23944431,23943824,23945704,1880,3883,25
23949986,23949379,23951079,1700,3884,25
23955361,23954754,23956433,1679,3885,25
23960715,23960108,23962041,1933,3886,25
23966448,23965841,23967504,1663,3887,25
23972003,23971179,23973059,1880,3888,25
23977341,23976734,23979067,2333,3889,25
23983349,23982742,23984991,2249,3890,25
23989274,23988667,23990598,1931,3891,25
23994880,23994273,23996839,2566,3892,25
24001122,24000515,24003080,2565,3893,25
24007363,24006756,24008688,1932,3894,25
24013091,24012484,24014147,1663,3895,25
24018429,24017822,24019521,1699,3896,25
24023803,24023196,24025761,2565,3897,25
24030044,24029437,24032002,2565,3898,25
24036502,24035678,24037558,1880,3899,25
24041840,24041233,24043113,1880,3900,25
24047613,24046789,24048669,1880,3901,25
24052951,24052344,24054361,2017,3902,25
24058861,24058037,24059918,1881,3903,25
24064200,24063593,24065610,2017,3904,25
24070013,24069406,24071069,1663,3905,25
24075351,24074744,24077077,2333,3906,25
24081360,24080753,24082685,1932,3907,25
24086967,24086360,24088039,1679,3908,25
24092321,24091714,24093393,1679,3909,25
24097675,24097068,24099317,2249,3910,25
24103816,24102992,24104873,1881,3911,25
24109155,24108548,24110247,1699,3912,25
24114651,24114044,24115707,1663,3913,25
24120206,24119382,24121263,1881,3914,25
24125758,24124938,24126814,1876,3915,25
24131096,24130489,24132369,1880,3916,25
24136651,24136044,24137924,1880,3917,25
24142206,24141599,24143479,1880,3918,25
24147978,24147154,24149034,1880,3919,25
24153316,24152709,24154589,1880,3920,25
24159088,24158264,24160145,1881,3921,25
24164428,24163821,24166471,2650,3922,25
24170878,24170271,24171934,1663,3923,25
24176433,24175826,24177489,1663,3924,25
24181771,24181164,24183497,2333,3925,25
24187996,24187172,24189053,1881,3926,25
24193552,24192728,24194608,1880,3927,25
24198890,24198283,24200616,2333,3928,25
24204899,24204292,24206223,1931,3929,25
24210505,24209898,24211577,1679,3930,25
24216076,24215252,24217133,1881,3931,25
24221415,24220808,24223458,2650,3932,25
24227741,24227134,24229066,1932,3933,25
24233348,24232741,24234420,1679,3934,25
24238702,24238095,24240661,2566,3935,25
24244944,24244337,24246269,1932,3936,25
24250664,24250057,24251720,1663,3937,25
24256219,24255395,24257275,1880,3938,25
24261557,24260950,24262650,1700,3939,25
24266932,24266325,24268257,1932,3940,25
24272539,24271932,24273611,1679,3941,25
24277894,24277286,24279219,1933,3942,25
24283621,24283014,24284677,1663,3943,25
24288959,24288352,24290233,1881,3944,25
24294515,24293908,24296241,2333,3945,25
24300524,24299917,24302483,2566,3946,25
24306766,24306159,24308408,2249,3947,25
24312691,24312084,24314016,1932,3948,25
24318298,24317691,24319940,2249,3949,25
24324223,24323616,24326181,2565,3950,25
24330464,24329857,24332422,2565,3951,25
24336705,24336098,24338029,1931,3952,25
24342311,24341704,24343636,1932,3953,25
24348135,24347311,24349191,1880,3954,25
24353473,24352866,24355537,2671,3955,25
24359954,24359347,24361011,1664,3956,25
24365293,24364686,24367357,2671,3957,25
24371858,24371034,24372914,1880,3958,25
24377196,24376589,24379260,2671,3959,25
24383543,24382936,24384868,1932,3960,25
24389150,24388543,24390475,1932,3961,25
24394974,24394150,24396030,1880,3962,25
24400313,24399706,24401586,1880,3963,25
24405868,24405261,24407141,1880,3964,25
24411640,24410816,24412697,1881,3965,25
24416979,24416372,24418388,2016,3966,25
24422887,24422063,24423943,1880,3967,25
24428225,24427618,24429951,2333,3968,25
24434233,24433626,24435305,1679,3969,25
24439717,24439110,24440773,1663,3970,25
24445055,24444448,24446780,2332,3971,25
24451063,24450456,24452135,1679,3972,25
24456417,24455810,24458375,2565,3973,25
24462875,24462051,24463932,1881,3974,25
24468214,24467607,24469939,2332,3975,25
24474222,24473615,24475495,1880,3976,25
24479994,24479170,24481051,1881,3977,25
24485333,24484726,24486741,2015,3978,25
24491023,24490416,24492347,1931,3979,25
24496847,24496023,24497903,1880,3980,25
24502402,24501578,24503458,1880,3981,25
24507957,24507350,24509014,1664,3982,25
24513296,24512689,24514569,1880,3983,25
24518851,24518244,24520260,2016,3984,25
24524543,24523936,24526502,2566,3985,25
24530785,24530178,24532743,2565,3986,25
24537136,24536529,24538193,1664,3987,25
24542475,24541868,24543568,1700,3988,25
24547985,24547378,24549042,1664,3989,25
24553324,24552717,24554417,1700,3990,25
24558916,24558092,24559973,1881,3991,25
24564255,24563648,24565528,1880,3992,25
24570027,24569203,24571084,1881,3993,25
24575367,24574760,24576640,1880,3994,25
24581139,24580315,24582195,1880,3995,25
24586477,24585870,24587570,1700,3996,25
24592068,24591245,24593124,1879,3997,25
24597406,24596799,24598499,1700,3998,25
24602998,24602174,24604054,1880,3999,25
24608336,24607729,24609609,1880,4000,25
24614106,24613499,24615162,1663,4001,25
24619661,24618837,24620717,1880,4002,25
24624999,24624392,24626725,2333,4003,25
24631008,24630401,24632333,1932,4004,25
24636615,24636008,24638257,2249,4005,25
24642539,24641932,24643863,1931,4006,25
24648145,24647538,24650103,2565,4007,25
24654603,24653779,24655659,1880,4008,25
24660146,24659539,24661202,1663,4009,25
24665484,24664877,24666576,1699,4010,25
24670858,24670251,24672500,2249,4011,25
24676999,24676175,24678055,1880,4012,25
24682337,24681730,24683747,2017,4013,25
24688246,24687422,24689302,1880,4014,25
24693584,24692977,24694994,2017,4015,25
24699276,24698669,24700549,1880,4016,25
24705048,24704441,24706104,1663,4017,25
24710386,24709779,24711659,1880,4018,25
24715941,24715334,24717350,2016,4019,25
24721632,24721025,24722905,1880,4020,25
24727404,24726580,24728461,1881,4021,25
24732958,24732136,24734014,1878,4022,25
24738296,24737689,24739706,2017,4023,25
24744120,24743513,24745176,1663,4024,25
24749458,24748851,24750731,1880,4025,25
24755229,24754406,24756285,1879,4026,25
24760567,24759960,24761977,2017,4027,25
24766260,24765653,24767332,1679,4028,25
24771614,24771007,24773572,2565,4029,25
24777855,24777248,24779180,1932,4030,25
24783679,24782855,24784735,1880,4031,25
24789224,24788617,24790280,1663,4032,25
24794562,24793955,24795835,1880,4033,25
24800117,24799510,24801390,1880,4034,25
24805672,24805065,24806945,1880,4035,25
24811227,24810620,24812953,2333,4036,25
24817235,24816628,24818875,2247,4037,25
24823158,24822551,24825116,2565,4038,25
24829615,24828792,24830671,1879,4039,25
24835170,24834563,24836226,1663,4040,25
24840508,24839901,24842234,2333,4041,25
24846517,24845910,24847842,1932,4042,25
24852247,24851640,24853303,1663,4043,25
24857585,24856978,24859628,2650,4044,25
24863911,24863304,24865553,2249,4045,25
24869836,24869229,24871109,1880,4046,25
24875391,24874784,24876801,2017,4047,25
24881083,24880476,24882356,1880,4048,25
24886638,24886031,24887911,1880,4049,25
24892193,24891586,24894257,2671,4050,25
24898540,24897933,24900499,2566,4051,25
24904782,24904175,24906106,1931,4052,25
24910388,24909781,24912030,2249,4053,25
24916312,24915705,24917637,1932,4054,25
24921919,24921312,24922991,1679,4055,25
24927273,24926666,24928345,1679,4056,25
24932627,24932020,24934268,2248,4057,25
24938550,24937943,24939823,1880,4058,25
24944105,24943498,24945831,2333,4059,25
24950331,24949507,24951388,1881,4060,25
24955670,24955063,24957396,2333,4061,25
24961896,24961072,24962952,1880,4062,25
24967234,24966627,24968326,1699,4063,25
24972608,24972001,24973932,1931,4064,25
24978431,24977607,24979487,1880,4065,25
24983981,24983162,24985038,1876,4066,25
24989320,24988713,24991384,2671,4067,25
24995785,24995178,24996841,1663,4068,25
25001123,25000516,25003187,2671,4069,25
25007470,25006863,25009428,2565,4070,25
25013711,25013104,25015352,2248,4071,25
25019635,25019028,25020959,1931,4072,25
25025458,25024634,25026514,1880,4073,25
25030796,25030189,25032069,1880,4074,25
25036561,25035954,25037618,1664,4075,25
25041901,25041293,25042993,1700,4076,25
25047275,25046668,25048548,1880,4077,25
25052830,25052223,25053923,1700,4078,25
25058205,25057598,25059478,1880,4079,25
25063972,25063365,25065029,1664,4080,25
25069311,25068704,25071374,2670,4081,25
25075873,25075050,25076930,1880,4082,25
25081212,25080605,25082622,2017,4083,25
25087122,25086298,25088179,1881,4084,25
25092461,25091854,25093734,1880,4085,25
25098016,25097409,25099425,2016,4086,25
25103707,25103100,25104779,1679,4087,25
25109061,25108454,25110133,1679,4088,25
25114415,25113808,25115688,1880,4089,25
25119970,25119363,25121243,1880,4090,25
25125525,25124918,25127251,2333,4091,25
25131533,25130926,25133491,2565,4092,25
25137774,25137167,25139732,2565,4093,25
25144015,25143408,25145288,1880,4094,25
25149570,25148963,25150663,1700,4095,25
25155161,25154338,25156217,1879,4096,25
25160499,25159892,25161592,1700,4097,25
25165874,25165267,25166946,1679,4098,25
25171228,25170621,25173186,2565,4099,25
25177469,25176862,25179110,2248,4100,25
25183505,25182898,25184562,1664,4101,25
25188844,25188237,25190112,1875,4102,25
25194394,25193787,25195667,1880,4103,25
25199949,25199342,25201676,2334,4104,25
25206083,25205476,25207139,1663,4105,25
25211421,25210814,25213485,2671,4106,25
25217768,25217161,25219093,1932,4107,25
25223375,25222768,25225016,2248,4108,25
25229299,25228692,25230371,1679,4109,25
25234774,25234167,25235830,1663,4110,25
25240112,25239505,25242176,2671,4111,25
25246460,25245852,25248102,2250,4112,25
25252601,25251777,25253657,1880,4113,25
25257939,25257332,25259665,2333,4114,25
25263948,25263341,25265907,2566,4115,25
25270329,25269722,25271386,1664,4116,25
25275885,25275061,25276942,1881,4117,25
25281224,25280617,25282497,1880,4118,25
25286779,25286172,25288505,2333,4119,25
25292787,25292180,25294746,2566,4120,25
25299246,25298422,25300302,1880,4121,25
25304584,25303977,25305994,2017,4122,25
25310389,25309782,25311446,1664,4123,25
25315728,25315121,25317001,1880,4124,25
25321500,25320676,25322557,1881,4125,25
25326839,25326232,25328565,2333,4126,25
25332848,25332241,25333920,1679,4127,25
25338202,25337595,25339844,2249,4128,25
25344261,25343654,25345317,1663,4129,25
25349599,25348992,25351325,2333,4130,25
25355608,25355001,25356680,1679,4131,25
25360962,25360355,25362920,2565,4132,25
25367419,25366596,25368476,1880,4133,25
25372758,25372151,25374031,1880,4134,25
25378313,25377706,25380377,2671,4135,25
25384661,25384054,25386619,2565,4136,25
25391119,25390295,25392176,1881,4137,25
25396459,25395852,25397552,1700,4138,25
25401958,25401351,25403014,1663,4139,25
25407296,25406689,25409360,2671,4140,25
25413860,25413036,25414916,1880,4141,25
25419198,25418591,25420471,1880,4142,25
25424970,25424146,25426026,1880,4143,25
25430309,25429702,25431719,2017,4144,25
25436003,25435395,25437962,2567,4145,25
25442245,25441638,25443518,1880,4146,25
25447801,25447194,25448894,1700,4147,25
25453176,25452569,25454817,2248,4148,25
25459100,25458493,25460742,2249,4149,25
25465242,25464418,25466299,1881,4150,25
25470581,25469974,25471990,2016,4151,25
25476273,25475666,25477914,2248,4152,25
25482413,25481590,25483469,1879,4153,25
25487752,25487145,25488844,1699,4154,25
25493126,25492519,25494399,1880,4155,25
25498898,25498074,25499954,1880,4156,25
25504236,25503629,25505328,1699,4157,25
25509611,25509003,25510936,1933,4158,25
25515219,25514612,25517177,2565,4159,25
25521677,25520853,25522734,1881,4160,25
25527233,25526626,25528290,1664,4161,25
25532572,25531965,25533843,1878,4162,25
25538126,25537519,25540169,2650,4163,25
25544668,25543845,25545725,1880,4164,25
25550008,25549401,25551281,1880,4165,25
25555563,25554956,25556836,1880,4166,25
25561118,25560511,25562391,1880,4167,25
25566890,25566066,25567947,1881,4168,25
25572229,25571622,25573502,1880,4169,25
25577784,25577177,25579057,1880,4170,25
25583339,25582732,25584749,2017,4171,25
25589032,25588425,25590674,2249,4172,25
25594957,25594350,25596029,1679,4173,25
25600312,25599705,25601384,1679,4174,25
25605884,25605060,25606941,1881,4175,25
25611225,25610617,25612317,1700,4176,25
25616725,25616118,25617782,1664,4177,25
25622281,25621458,25623338,1880,4178,25
25627838,25627231,25628895,1664,4179,25
25633178,25632571,25634905,2334,4180,25
25639188,25638581,25640514,1933,4181,25
25644925,25644317,25645982,1665,4182,25
25650482,25649875,25651539,1664,4183,25
25655822,25655215,25657096,1881,4184,25
25661379,25660772,25662653,1881,4185,25
25667134,25666527,25668191,1664,4186,25
25672691,25671867,25673748,1881,4187,25
25678031,25677424,25680074,2650,4188,25
25684358,25683751,25686317,2566,4189,25
25690601,25689994,25691674,1680,4190,25
25696096,25695489,25697153,1664,4191,25
25701437,25700829,25702711,1882,4192,25
25707211,25706387,25708268,1881,4193,25
25712551,25711944,25713961,2017,4194,25
25718244,25717637,25719886,2249,4195,25
25724170,25723563,25726128,2565,4196,25
25730629,25729805,25731686,1881,4197,25
25736186,25735362,25737243,1881,4198,25
25741724,25741117,25742781,1664,4199,25
25747064,25746457,25748157,1700,4200,25
25752440,25751833,25754081,2248,4201,25
25758365,25757758,25759438,1680,4202,25
25763938,25763114,25764995,1881,4203,25
25769278,25768671,25770552,1881,4204,25
25775042,25774435,25776099,1664,4205,25
25780599,25779775,25781656,1881,4206,25
25786156,25785549,25787213,1664,4207,25
25791496,25790889,25792770,1881,4208,25
25797053,25796446,25798327,1881,4209,25
25802611,25802004,25804021,2017,4210,25
25808305,25807698,25809378,1680,4211,25
25813662,25813054,25815621,2567,4212,25
25820122,25819298,25821179,1881,4213,25
25825462,25824855,25826556,1701,4214,25
25830839,25830232,25832165,1933,4215,25
25836666,25835842,25837723,1881,4216,25
25842006,25841399,25843733,2334,4217,25
25848234,25847410,25849291,1881,4218,25
25853791,25852967,25854848,1881,4219,25
25859131,25858524,25860541,2017,4220,25
25864824,25864217,25866150,1933,4221,25
25870546,25869939,25871603,1664,4222,25
25875886,25875279,25877929,2650,4223,25
25882430,25881606,25883487,1881,4224,25
25887770,25887163,25889813,2650,4225,25
25894097,25893490,25895740,2250,4226,25
25900023,25899416,25901664,2248,4227,25
25905948,25905341,25907222,1881,4228,25
25911505,25910898,25913232,2334,4229,25
25917733,25916909,25918790,1881,4230,25
25923073,25922466,25925117,2651,4231,25
25929521,25928914,25930578,1664,4232,25
25934861,25934254,25936905,2651,4233,25
25941189,25940582,25943148,2566,4234,25
25947432,25946825,25948505,1680,4235,25
25952788,25952181,25954062,1881,4236,25
25958345,25957738,25959439,1701,4237,25
25963939,25963115,25964996,1881,4238,25
25969279,25968672,25970689,2017,4239,25
25975190,25974366,25976247,1881,4240,25
25980530,25979923,25982257,2334,4241,25
25986669,25986062,25987726,1664,4242,25
25992009,25991402,25993283,1881,4243,25
25997566,25996959,25998975,2016,4244,25
26003476,26002652,26004533,1881,4245,25
26008816,26008209,26010090,1881,4246,25
26014591,26013767,26015648,1881,4247,25
26019932,26019325,26021026,1701,4248,25
26025526,26024702,26026583,1881,4249,25
26030866,26030259,26032140,1881,4250,25
26036423,26035816,26037517,1701,4251,25
26042017,26041193,26043074,1881,4252,25
26047357,26046750,26048767,2017,4253,25
26053051,26052444,26054325,1881,4254,25
26058609,26058001,26059880,1879,4255,25
26064164,26063557,26065574,2017,4256,25
26069858,26069251,26071184,1933,4257,25
26075594,26074987,26076651,1664,4258,25
26081152,26080328,26082209,1881,4259,25
26086492,26085885,26087902,2017,4260,25
26092403,26091579,26093460,1881,4261,25
26097743,26097136,26099470,2334,4262,25
26103754,26103147,26105713,2566,4263,25
26109997,26109390,26111271,1881,4264,25
26115555,26114948,26116829,1881,4265,25
26121113,26120505,26122387,1882,4266,25
26126670,26126063,26128712,2649,4267,25
26132996,26132389,26134955,2566,4268,25
26139363,26138756,26140420,1664,4269,25
26144703,26144096,26146430,2334,4270,25
26150714,26150107,26152673,2566,4271,25
26156958,26156351,26158232,1881,4272,25
26162516,26161909,26164559,2650,4273,25
26168965,26168358,26170022,1664,4274,25
26174523,26173699,26175580,1881,4275,25
26179864,26179257,26181273,2016,4276,25
26185671,26185063,26186728,1665,4277,25
26191227,26190620,26192284,1664,4278,25
26196784,26196177,26197841,1664,4279,25
26202124,26201517,26203850,2333,4280,25
26208134,26207527,26209408,1881,4281,25
26213692,26213085,26214785,1700,4282,25
26219068,26218461,26220342,1881,4283,25
26224625,26224018,26225899,1881,4284,25
26230399,26229575,26231456,1881,4285,25
26235739,26235132,26237013,1881,4286,25
26241501,26240894,26242558,1664,4287,25
26247058,26246234,26248115,1881,4288,25
26252398,26251791,26253672,1881,4289,25
26258171,26257348,26259228,1880,4290,25
26263511,26262904,26264785,1881,4291,25
26269068,26268461,26270342,1881,4292,25
26274625,26274018,26275717,1699,4293,25
26280000,26279393,26281959,2566,4294,25
26286375,26285768,26287432,1664,4295,25
26291932,26291108,26292989,1881,4296,25
26297272,26296665,26298543,1878,4297,25
26302826,26302219,26304100,1881,4298,25
26308383,26307776,26309657,1881,4299,25
26313940,26313333,26315982,2649,4300,25
26320376,26319769,26321433,1664,4301,25
26325716,26325109,26326985,1876,4302,25
26331465,26330858,26332522,1664,4303,25
26336805,26336198,26338215,2017,4304,25
26342498,26341891,26343772,1881,4305,25
26348055,26347448,26349782,2334,4306,25
26354066,26353459,26355708,2249,4307,25
26360115,26359508,26361172,1664,4308,25
26365455,26364848,26366549,1701,4309,25
26370833,26370226,26372475,2249,4310,25
26376758,26376151,26378032,1881,4311,25
26382315,26381708,26384358,2650,4312,25
26388758,26388151,26389815,1664,4313,25
26394098,26393491,26395825,2334,4314,25
26400108,26399501,26401181,1680,4315,25
26405464,26404857,26406536,1679,4316,25
26410819,26410212,26412144,1932,4317,25
26416644,26415820,26417701,1881,4318,25
26421984,26421377,26424027,2650,4319,25
26428311,26427704,26429585,1881,4320,25
26433869,26433261,26435143,1882,4321,25
26439426,26438819,26440836,2017,4322,25
26445336,26444512,26446393,1881,4323,25
26450676,26450069,26451950,1881,4324,25
26456233,26455626,26457326,1700,4325,25
26461609,26461002,26463251,2249,4326,25
26467535,26466928,26469493,2565,4327,25
26473910,26473303,26474967,1664,4328,25
26479250,26478643,26480659,2016,4329,25
26485058,26484451,26486115,1664,4330,25
26490615,26489791,26491672,1881,4331,25
26495955,26495348,26497049,1701,4332,25
26501461,26500854,26502518,1664,4333,25
26507018,26506411,26508075,1664,4334,25
26512358,26511751,26513628,1877,4335,25
26517911,26517304,26519953,2649,4336,25
26524368,26523761,26525425,1664,4337,25
26529708,26529101,26531118,2017,4338,25
26535402,26534795,26536728,1933,4339,25
26541228,26540404,26542285,1881,4340,25
26546568,26545961,26547662,1701,4341,25
26551945,26551338,26553270,1932,4342,25
26557770,26556946,26558827,1881,4343,25
26563110,26562503,26564384,1881,4344,25
26568667,26568060,26570710,2650,4345,25
26574994,26574387,26576067,1680,4346,25
26580475,26579868,26581532,1664,4347,25
26586032,26585208,26587089,1881,4348,25
26591589,26590765,26592646,1881,4349,25
26596929,26596322,26598202,1880,4350,25
26602485,26601878,26603759,1881,4351,25
26608042,26607435,26609136,1701,4352,25
26613418,26612812,26615377,2565,4353,25
26619661,26619054,26620734,1680,4354,25
26625017,26624410,26626658,2248,4355,25
26630941,26630334,26632014,1680,4356,25
26636297,26635690,26637369,1679,4357,25
26641652,26641045,26642926,1881,4358,25
26647209,26646602,26648618,2016,4359,25
26652902,26652295,26654544,2249,4360,25
26658949,26658343,26660006,1663,4361,25
26664506,26663682,26665563,1881,4362,25
26670062,26669239,26671119,1880,4363,25
26675619,26674795,26676676,1881,4364,25
26680959,26680352,26682685,2333,4365,25
26686969,26686362,26688295,1933,4366,25
26692698,26692091,26693755,1664,4367,25
26698038,26697431,26699307,1876,4368,25
26703590,26702983,26704684,1701,4369,25
26708967,26708360,26710241,1881,4370,25
26714719,26714112,26715776,1664,4371,25
26720059,26719452,26722102,2650,4372,25
26726386,26725779,26728345,2566,4373,25
26732846,26732022,26733903,1881,4374,25
26738186,26737579,26739460,1881,4375,25
26743743,26743136,26745153,2017,4376,25
26749654,26748830,26750711,1881,4377,25
26754995,26754387,26756269,1882,4378,25
26760552,26759945,26762595,2650,4379,25
26767096,26766272,26768153,1881,4380,25
26772436,26771829,26773530,1701,4381,25
26777813,26777206,26779455,2249,4382,25
26783862,26783255,26784919,1664,4383,25
26789202,26788595,26790476,1881,4384,25
26794976,26794369,26796033,1664,4385,25
26800316,26799709,26801590,1881,4386,25
26806091,26805267,26807148,1881,4387,25
26811431,26810824,26812525,1701,4388,25
26816808,26816201,26818767,2566,4389,25
26823051,26822444,26824377,1933,4390,25
26828778,26828171,26829835,1664,4391,25
26834118,26833511,26835392,1881,4392,25
26839675,26839068,26841085,2017,4393,25
26845369,26844762,26846643,1881,4394,25
26850926,26850319,26852653,2334,4395,25
26856937,26856330,26858010,1680,4396,25
26862293,26861686,26864252,2566,4397,25
26868753,26867929,26869810,1881,4398,25
26874094,26873486,26875366,1880,4399,25
26879649,26879042,26880923,1881,4400,25
26885405,26884798,26886462,1664,4401,25
26890745,26890138,26891839,1701,4402,25
26896122,26895515,26897396,1881,4403,25
26901679,26901072,26903722,2650,4404,25
26908006,26907399,26909964,2565,4405,25
26914248,26913641,26915574,1933,4406,25
26919857,26919250,26920930,1680,4407,25
26925430,26924606,26926487,1881,4408,25
26930979,26930372,26932036,1664,4409,25
26936319,26935712,26938362,2650,4410,25
26942646,26942039,26943719,1680,4411,25
26948002,26947395,26949961,2566,4412,25
26954245,26953638,26955318,1680,4413,25
26959818,26958994,26960875,1881,4414,25
26965158,26964551,26966251,1700,4415,25
26970534,26969927,26971860,1933,4416,25
26976143,26975536,26977469,1933,4417,25
26981752,26981145,26983395,2250,4418,25
26987679,26987072,26989321,2249,4419,25
26993822,26992998,26994879,1881,4420,25
26999162,26998555,27000436,1881,4421,25
27004719,27004112,27006128,2016,4422,25
27010412,27009805,27012370,2565,4423,25
27016654,27016047,27017928,1881,4424,25
27022211,27021604,27023937,2333,4425,25
27028221,27027614,27029294,1680,4426,25
27033794,27032970,27034851,1881,4427,25
27039134,27038527,27040227,1700,4428,25
27044510,27043903,27046151,2248,4429,25
27050652,27049828,27051709,1881,4430,25
27055992,27055385,27057719,2334,4431,25
27062002,27061395,27063643,2248,4432,25
27067927,27067320,27069568,2248,4433,25
27073851,27073244,27075125,1881,4434,25
27079408,27078801,27080501,1700,4435,25
27084784,27084177,27086109,1932,4436,25
27090392,27089785,27092033,2248,4437,25
27096448,27095841,27097505,1664,4438,25
27102005,27101181,27103062,1881,4439,25
27107345,27106738,27109388,2650,4440,25
27113889,27113065,27114946,1881,4441,25
27119230,27118623,27120324,1701,4442,25
27124824,27124000,27125881,1881,4443,25
27130164,27129557,27131438,1881,4444,25
27135722,27135115,27136816,1701,4445,25
27141229,27140622,27142286,1664,4446,25
27146786,27145962,27147843,1881,4447,25
27152127,27151520,27153401,1881,4448,25
27157684,27157077,27158778,1701,4449,25
27163061,27162454,27164134,1680,4450,25
27168634,27167810,27169691,1881,4451,25
27173974,27173367,27176017,2650,4452,25
27180301,27179694,27182259,2565,4453,25
27186760,27185937,27187817,1880,4454,25
27192100,27191493,27193193,1700,4455,25
27197477,27196870,27199436,2566,4456,25
27203936,27203113,27204993,1880,4457,25
27209276,27208669,27210550,1881,4458,25
27214833,27214226,27216560,2334,4459,25
27220843,27220236,27222169,1933,4460,25
27226452,27225845,27227726,1881,4461,25
27232009,27231402,27233736,2334,4462,25
27238020,27237413,27239346,1933,4463,25
27243754,27243148,27244811,1663,4464,25
27249094,27248487,27250364,1877,4465,25
27254647,27254040,27255921,1881,4466,25
27260204,27259597,27262247,2650,4467,25
27266531,27265924,27268490,2566,4468,25
27272774,27272167,27274100,1933,4469,25
27278600,27277776,27279657,1881,4470,25
27283940,27283333,27285033,1700,4471,25
27289533,27288709,27290590,1881,4472,25
27294873,27294266,27296916,2650,4473,25
27301200,27300593,27302474,1881,4474,25
27306757,27306150,27308484,2334,4475,25
27312768,27312161,27313840,1679,4476,25
27318123,27317516,27320082,2566,4477,25
27324583,27323759,27325640,1881,4478,25
27329923,27329316,27331649,2333,4479,25
27335933,27335326,27337892,2566,4480,25
27342176,27341569,27343818,2249,4481,25
27348102,27347495,27349376,1881,4482,25
27353659,27353052,27354933,1881,4483,25
27359217,27358610,27360627,2017,4484,25
27365128,27364304,27366185,1881,4485,25
27370468,27369861,27372511,2650,4486,25
27376795,27376188,27378121,1933,4487,25
27382404,27381797,27383730,1933,4488,25
27388230,27387406,27389287,1881,4489,25
27393570,27392963,27395612,2649,4490,25
27399896,27399289,27401854,2565,4491,25
27406138,27405531,27408097,2566,4492,25
27412597,27411774,27413654,1880,4493,25
27417938,27417331,27419212,1881,4494,25
27423495,27422888,27424589,1701,4495,25
27429089,27428265,27430146,1881,4496,25
27434430,27433823,27435700,1877,4497,25
27439983,27439376,27442027,2651,4498,25
27446444,27445837,27447501,1664,4499,25
27451784,27451177,27453194,2017,4500,25
27457695,27456871,27458752,1881,4501,25
27463035,27462428,27464445,2017,4502,25
27468729,27468122,27470003,1881,4503,25
27474287,27473680,27476330,2650,4504,25
27480614,27480007,27482572,2565,4505,25
27486856,27486249,27488181,1932,4506,25
27492464,27491857,27493789,1932,4507,25
27498072,27497465,27499714,2249,4508,25
27504215,27503391,27505272,1881,4509,25
27509556,27508949,27510649,1700,4510,25
27515149,27514325,27516206,1881,4511,25
27520490,27519883,27522533,2650,4512,25
27526817,27526210,27528776,2566,4513,25
27533060,27532453,27534133,1680,4514,25
27538531,27537924,27539588,1664,4515,25
27544088,27543264,27545145,1881,4516,25
27549428,27548821,27550837,2016,4517,25
27555121,27554514,27556447,1933,4518,25
27560863,27560256,27561920,1664,4519,25
27566203,27565596,27567930,2334,4520,25
27572214,27571607,27573540,1933,4521,25
27577823,27577216,27579466,2250,4522,25
27583750,27583143,27585076,1933,4523,25
27589489,27588882,27590546,1664,4524,25
27594829,27594222,27596103,1881,4525,25
27600387,27599780,27601797,2017,4526,25
27606081,27605474,27608040,2566,4527,25
27612324,27611717,27613598,1881,4528,25
27617881,27617274,27618975,1701,4529,25
27623258,27622651,27625217,2566,4530,25
27629501,27628894,27630574,1680,4531,25
27635074,27634250,27636131,1881,4532,25
27640414,27639807,27642456,2649,4533,25
27646740,27646133,27648014,1881,4534,25
27652514,27651690,27653571,1881,4535,25
27657854,27657247,27659897,2650,4536,25
27664398,27663574,27665455,1881,4537,25
27669738,27669131,27671012,1881,4538,25
27675512,27674688,27676569,1881,4539,25
27680852,27680245,27682262,2017,4540,25
27686763,27685939,27687820,1881,4541,25
27692316,27691709,27693373,1664,4542,25
27697656,27697049,27699383,2334,4543,25
27703801,27703194,27704858,1664,4544,25
27709358,27708751,27710415,1664,4545,25
27714910,27714091,27715967,1876,4546,25
27720250,27719643,27721524,1881,4547,25
27726024,27725200,27727081,1881,4548,25
27731574,27730967,27732631,1664,4549,25
27737131,27736307,27738188,1881,4550,25
27742688,27742081,27743745,1664,4551,25
27748029,27747422,27749301,1879,4552,25
27753585,27752978,27755627,2649,4553,25
27759911,27759304,27761554,2250,4554,25
27765838,27765231,27766911,1680,4555,25
27771194,27770587,27772520,1933,4556,25
27776804,27776197,27778446,2249,4557,25
27782729,27782122,27784054,1932,4558,25
27788337,27787730,27789978,2248,4559,25
27794263,27793655,27795904,2249,4560,25
27800405,27799581,27801462,1881,4561,25
27805745,27805138,27807472,2334,4562,25
27811756,27811149,27813081,1932,4563,25
27817365,27816758,27819008,2250,4564,25
27823509,27822685,27824566,1881,4565,25
27829048,27828441,27830105,1664,4566,25
27834606,27833782,27835663,1881,4567,25
27839947,27839340,27841991,2651,4568,25
27846493,27845669,27847550,1881,4569,25
27852039,27851432,27853096,1664,4570,25
27857379,27856772,27859106,2334,4571,25
27863607,27862783,27864664,1881,4572,25
27868947,27868340,27870674,2334,4573,25
27875175,27874351,27876232,1881,4574,25
27880715,27880108,27881772,1664,4575,25
27886273,27885665,27887330,1665,4576,25
27891830,27891223,27892887,1664,4577,25
27897170,27896563,27898444,1881,4578,25
27902727,27902120,27904770,2650,4579,25
27909054,27908447,27910380,1933,4580,25
27914879,27914056,27915936,1880,4581,25
27920219,27919612,27921629,2017,4582,25
27926130,27925306,27927187,1881,4583,25
27931471,27930864,27932739,1875,4584,25
27937022,27936415,27938296,1881,4585,25
27942579,27941972,27943853,1881,4586,25
27948335,27947728,27949392,1664,4587,25
27953675,27953068,27954769,1701,4588,25
27959052,27958445,27960693,2248,4589,25
27964976,27964369,27966250,1881,4590,25
27970533,27969926,27971943,2017,4591,25
27976443,27975619,27977500,1881,4592,25
27982000,27981393,27983057,1664,4593,25
27987340,27986733,27989067,2334,4594,25
27993351,27992744,27994677,1933,4595,25
27999178,27998354,28000235,1881,4596,25
28004722,28004115,28005779,1664,4597,25
28010063,28009456,28011337,1881,4598,25
28015621,28015014,28017664,2650,4599,25
28021948,28021341,28023274,1933,4600,25
28027557,28026950,28028630,1680,4601,25
28032913,28032306,28034870,2564,4602,25
28039371,28038547,28040428,1881,4603,25
28044711,28044104,28045804,1700,4604,25
28050087,28049480,28051730,2250,4605,25
28056014,28055407,28057656,2249,4606,25
28061940,28061333,28063214,1881,4607,25
28067497,28066890,28068771,1881,4608,25
28073054,28072447,28075097,2650,4609,25
28079598,28078774,28080655,1881,4610,25
28084938,28084331,28086212,1881,4611,25
28090495,28089888,28091769,1881,4612,25
28096053,28095446,28097147,1701,4613,25
28101430,28100823,28102704,1881,4614,25
28107191,28106584,28108248,1664,4615,25
28112531,28111924,28114258,2334,4616,25
28118673,28118066,28119730,1664,4617,25
28124014,28123407,28125283,1876,4618,25
28129566,28128959,28131292,2333,4619,25
28135576,28134969,28136648,1679,4620,25
28140932,28140324,28142574,2250,4621,25
28147075,28146251,28148132,1881,4622,25
28152633,28152026,28153690,1664,4623,25
28157973,28157366,28160017,2651,4624,25
28164301,28163694,28165374,1680,4625,25
28169657,28169050,28171298,2248,4626,25
28175582,28174975,28177540,2565,4627,25
28182042,28181218,28183099,1881,4628,25
28187382,28186775,28188656,1881,4629,25
28192939,28192332,28194349,2017,4630,25
28198633,28198026,28200591,2565,4631,25
28204875,28204268,28205948,1680,4632,25
28210231,28209624,28211556,1932,4633,25
28215839,28215232,28217113,1881,4634,25
28221613,28220789,28222670,1881,4635,25
28227161,28226554,28228218,1664,4636,25
28232501,28231894,28234228,2334,4637,25
28238512,28237905,28239786,1881,4638,25
28244070,28243463,28245797,2334,4639,25
28250298,28249474,28251355,1881,4640,25
28255856,28255032,28256913,1881,4641,25
28261406,28260799,28262463,1664,4642,25
28266746,28266139,28268473,2334,4643,25
28272757,28272150,28274031,1881,4644,25
28278313,28277707,28280378,2671,4645,25
28284662,28284055,28285936,1881,4646,25
28290436,28289612,28291493,1881,4647,25
28295776,28295169,28297047,1878,4648,25
28301330,28300723,28302604,1881,4649,25
28307088,28306481,28308145,1664,4650,25
28312428,28311821,28313522,1701,4651,25
28318023,28317199,28319080,1881,4652,25
28323579,28322972,28324636,1664,4653,25
28328920,28328313,28330963,2650,4654,25
28335247,28334640,28336521,1881,4655,25
28340804,28340197,28342214,2017,4656,25
28346498,28345891,28347824,1933,4657,25
28352107,28351500,28354066,2566,4658,25
28358567,28357743,28359624,1881,4659,25
28364124,28363516,28365181,1665,4660,25
28369464,28368857,28370737,1880,4661,25
28375020,28374413,28376430,2017,4662,25
28380714,28380107,28382673,2566,4663,25
28386958,28386351,28388031,1680,4664,25
28392531,28391707,28393588,1881,4665,25
28397872,28397265,28399146,1881,4666,25
28403430,28402823,28404704,1881,4667,25
28408988,28408381,28411031,2650,4668,25
28415315,28414708,28417274,2566,4669,25
28421559,28420952,28422632,1680,4670,25
28427046,28426439,28428103,1664,4671,25
28432387,28431780,28434430,2650,4672,25
28438714,28438107,28439988,1881,4673,25
28444488,28443664,28445545,1881,4674,25
28450045,28449438,28451102,1664,4675,25
28455385,28454778,28456795,2017,4676,25
28461198,28460591,28462255,1664,4677,25
28466539,28465932,28468583,2651,4678,25
28472868,28472261,28474194,1933,4679,25
28478478,28477871,28479752,1881,4680,25
28484036,28483429,28485310,1881,4681,25
28489594,28488987,28491321,2334,4682,25
28495605,28494998,28497563,2565,4683,25
28501848,28501241,28503807,2566,4684,25
28508308,28507485,28509365,1880,4685,25
28513649,28513041,28514923,1882,4686,25
28519206,28518599,28520933,2334,4687,25
28525340,28524733,28526397,1664,4688,25
28530681,28530074,28532408,2334,4689,25
28536692,28536085,28538018,1933,4690,25
28542302,28541695,28544261,2566,4691,25
28548545,28547938,28549618,1680,4692,25
28554118,28553294,28555175,1881,4693,25
28559458,28558851,28561185,2334,4694,25
28565686,28564862,28566743,1881,4695,25
28571027,28570420,28573070,2650,4696,25
28577355,28576748,28578997,2249,4697,25
28583394,28582786,28584451,1665,4698,25
28588734,28588127,28589827,1700,4699,25
28594110,28593503,28595436,1933,4700,25
28599719,28599112,28600993,1881,4701,25
28605276,28604669,28607320,2651,4702,25
28611605,28610998,28612879,1881,4703,25
28617163,28616556,28618890,2334,4704,25
28623174,28622567,28624246,1679,4705,25
28628746,28627922,28629803,1881,4706,25
28634086,28633479,28636151,2672,4707,25
28640436,28639829,28641710,1881,4708,25
28646211,28645387,28647268,1881,4709,25
28651769,28650945,28652826,1881,4710,25
28657109,28656502,28658379,1877,4711,25
28662663,28662056,28664706,2650,4712,25
28668991,28668384,28670316,1932,4713,25
28674817,28673993,28675874,1881,4714,25
28680157,28679550,28681884,2334,4715,25
28686168,28685561,28688126,2565,4716,25
28692523,28691916,28693580,1664,4717,25
28698080,28697473,28699137,1664,4718,25
28703637,28702813,28704694,1881,4719,25
28708977,28708370,28710251,1881,4720,25
28714534,28713927,28715808,1881,4721,25
28720091,28719484,28721365,1881,4722,25
28725648,28725041,28726742,1701,4723,25
28731242,28730418,28732299,1881,4724,25
28736791,28736184,28737848,1664,4725,25
28742131,28741524,28744175,2651,4726,25
28748459,28747852,28749733,1881,4727,25
28754234,28753626,28755291,1665,4728,25
28759574,28758967,28761618,2651,4729,25
28765902,28765295,28767545,2250,4730,25
28772046,28771222,28773103,1881,4731,25
28777387,28776780,28778661,1881,4732,25
28782946,28782338,28784216,1878,4733,25
28788499,28787892,28789773,1881,4734,25
28794273,28793449,28795330,1881,4735,25
28799614,28799007,28801024,2017,4736,25
28805525,28804701,28806582,1881,4737,25
28810865,28810258,28812275,2017,4738,25
28816559,28815952,28817885,1933,4739,25
28822168,28821561,28823493,1932,4740,25
28827993,28827169,28829050,1881,4741,25
28833534,28832927,28834591,1664,4742,25
28838874,28838267,28840148,1881,4743,25
28844432,28843824,28845524,1700,4744,25
28849807,28849200,28850880,1680,4745,25
28855163,28854556,28856437,1881,4746,25
28860720,28860113,28862130,2017,4747,25
28866631,28865807,28867688,1881,4748,25
28871971,28871364,28873245,1881,4749,25
28877734,28877126,28878791,1665,4750,25
28883074,28882467,28885117,2650,4751,25
28889401,28888794,28891359,2565,4752,25
28895643,28895036,28896917,1881,4753,25
28901200,28900593,28902474,1881,4754,25
28906757,28906150,28908031,1881,4755,25
28912314,28911707,28913588,1881,4756,25
28917872,28917265,28919143,1878,4757,25
28923641,28922819,28924698,1879,4758,25
28928981,28928374,28930708,2334,4759,25
28935208,28934385,28936265,1880,4760,25
28940548,28939941,28941822,1881,4761,25
28946105,28945498,28947379,1881,4762,25
28951662,28951055,28952936,1881,4763,25
28957219,28956612,28958311,1699,4764,25
28962811,28961987,28963868,1881,4765,25
28968151,28967544,28969878,2334,4766,25
28974162,28973555,28975235,1680,4767,25
28979518,28978911,28980591,1680,4768,25
28984874,28984267,28986832,2565,4769,25
28991245,28990638,28992302,1664,4770,25
28996585,28995978,28997679,1701,4771,25
29002179,29001355,29003236,1881,4772,25
29007520,29006913,29009247,2334,4773,25
29013530,29012923,29015172,2249,4774,25
29019456,29018849,29021414,2565,4775,25
29025914,29025091,29026971,1880,4776,25
29031255,29030647,29033298,2651,4777,25
29037582,29036975,29039224,2249,4778,25
29043508,29042901,29045150,2249,4779,25
29049434,29048827,29050507,1680,4780,25
29054790,29054183,29056433,2250,4781,25
29060934,29060110,29061991,1881,4782,25
29066274,29065667,29067548,1881,4783,25
29072049,29071225,29073106,1881,4784,25
29077603,29076996,29078660,1664,4785,25
29082943,29082336,29084985,2649,4786,25
29089391,29088784,29090448,1664,4787,25
29094948,29094341,29096005,1664,4788,25
29100505,29099898,29101562,1664,4789,25
29105846,29105239,29107255,2016,4790,25
29111756,29110932,29112813,1881,4791,25
29117097,29116490,29119141,2651,4792,25
29123425,29122818,29124751,1933,4793,25
29129035,29128427,29130994,2567,4794,25
29135395,29134788,29136452,1664,4795,25
29140736,29140129,29141830,1701,4796,25
29146114,29145507,29147388,1881,4797,25
29151886,29151279,29152943,1664,4798,25
29157443,29156836,29158500,1664,4799,25
29162784,29162176,29164194,2018,4800,25
29168478,29167871,29170437,2566,4801,25
29174938,29174114,29175995,1881,4802,25
29180278,29179671,29181688,2017,4803,25
29186097,29185490,29187154,1664,4804,25
29191437,29190830,29192847,2017,4805,25
29197130,29196523,29198772,2249,4806,25
29203056,29202449,29204382,1933,4807,25
29208791,29208184,29209848,1664,4808,25
29214132,29213524,29215225,1701,4809,25
29219725,29218901,29220782,1881,4810,25
29225065,29224458,29226158,1700,4811,25
29230441,29229834,29231514,1680,4812,25
29236014,29235190,29237071,1881,4813,25
29241571,29240747,29242628,1881,4814,25
29246911,29246304,29248185,1881,4815,25
29252468,29251861,29254194,2333,4816,25
29258612,29258005,29259669,1664,4817,25
29263952,29263345,29265045,1700,4818,25
29269544,29268721,29270601,1880,4819,25
29274884,29274277,29276927,2650,4820,25
29281211,29280604,29282485,1881,4821,25
29286768,29286161,29288178,2017,4822,25
29292462,29291855,29293788,1933,4823,25
29298287,29297464,29299344,1880,4824,25
29303844,29303237,29304901,1664,4825,25
29309401,29308794,29310458,1664,4826,25
29314742,29314135,29315836,1701,4827,25
29320336,29319512,29321393,1881,4828,25
29325677,29325070,29326951,1881,4829,25
29331234,29330627,29333276,2649,4830,25
29337560,29336953,29339519,2566,4831,25
29344021,29343197,29345078,1881,4832,25
29349361,29348755,29350635,1880,4833,25
29355136,29354528,29356193,1665,4834,25
29360477,29359870,29361886,2016,4835,25
29366280,29365673,29367337,1664,4836,25
29371620,29371013,29373029,2016,4837,25
29377530,29376706,29378587,1881,4838,25
29382870,29382263,29384913,2650,4839,25
29389414,29388590,29390471,1881,4840,25
29394971,29394147,29396028,1881,4841,25
29400311,29399704,29401403,1699,4842,25
29405903,29405079,29406960,1881,4843,25
29411244,29410637,29412654,2017,4844,25
29417046,29416439,29418103,1664,4845,25
29422603,29421779,29423660,1881,4846,25
29428160,29427553,29429217,1664,4847,25
29433500,29432893,29434593,1700,4848,25
29438877,29438270,29440836,2566,4849,25
29445121,29444514,29446395,1881,4850,25
29450895,29450071,29451952,1881,4851,25
29456237,29455629,29457964,2335,4852,25
29462465,29461641,29463522,1881,4853,25
29467805,29467198,29469216,2018,4854,25
29473717,29472893,29474774,1881,4855,25
29479057,29478450,29480150,1700,4856,25
29484433,29483826,29486391,2565,4857,25
29490675,29490068,29492000,1932,4858,25
29496283,29495676,29497356,1680,4859,25
29501753,29501146,29502810,1664,4860,25
29507093,29506486,29508367,1881,4861,25
29512650,29512043,29514693,2650,4862,25
29518977,29518370,29520251,1881,4863,25
29524534,29523927,29526577,2650,4864,25
29530861,29530254,29532502,2248,4865,25
29536786,29536179,29538060,1881,4866,25
29542343,29541736,29544386,2650,4867,25
29548671,29548064,29549744,1680,4868,25
29554027,29553420,29555668,2248,4869,25
29559952,29559345,29561226,1881,4870,25
29565509,29564902,29567552,2650,4871,25
29572054,29571230,29573111,1881,4872,25
29577395,29576788,29578669,1881,4873,25
29583154,29582547,29584211,1664,4874,25
29588494,29587887,29590537,2650,4875,25
29594822,29594215,29596780,2565,4876,25
29601063,29600457,29602705,2248,4877,25
29606989,29606382,29608315,1933,4878,25
29612730,29612123,29613787,1664,4879,25
29618288,29617464,29619345,1881,4880,25
29623628,29623021,29624899,1878,4881,25
29629182,29628575,29630456,1881,4882,25
29634956,29634132,29636013,1881,4883,25
29640296,29639689,29641570,1881,4884,25
29645853,29645246,29646947,1701,4885,25
29651447,29650623,29652504,1881,4886,25
29656787,29656180,29658197,2017,4887,25
29662481,29661874,29663807,1933,4888,25
29668090,29667483,29669163,1680,4889,25
29673663,29672839,29674720,1881,4890,25
29679004,29678397,29680414,2017,4891,25
29684698,29684091,29685972,1881,4892,25
29690255,29689648,29692298,2650,4893,25
29696582,29695975,29697654,1679,4894,25
29702154,29701330,29703211,1881,4895,25
29707494,29706887,29708904,2017,4896,25
29713188,29712581,29715147,2566,4897,25
29719561,29718954,29720618,1664,4898,25
29724901,29724294,29726169,1875,4899,25
29730452,29729845,29732495,2650,4900,25
29736997,29736173,29738054,1881,4901,25
29742338,29741731,29743608,1877,4902,25
29747891,29747284,29749165,1881,4903,25
29753448,29752841,29754542,1701,4904,25
29758825,29758218,29760466,2248,4905,25
29764750,29764143,29766076,1933,4906,25
29770576,29769752,29771633,1881,4907,25
29775917,29775310,29777191,1881,4908,25
29781475,29780868,29782749,1881,4909,25
29787231,29786624,29788288,1664,4910,25
29792571,29791964,29793845,1881,4911,25
29798129,29797522,29799402,1880,4912,25
29803686,29803079,29804780,1701,4913,25
29809062,29808456,29810704,2248,4914,25
29815205,29814381,29816262,1881,4915,25
29820762,29819938,29821819,1881,4916,25
29826309,29825702,29827366,1664,4917,25
29831649,29831042,29833059,2017,4918,25
29837560,29836736,29838617,1881,4919,25
29842901,29842294,29843995,1701,4920,25
29848278,29847671,29849351,1680,4921,25
29853851,29853027,29854908,1881,4922,25
29859191,29858584,29860285,1701,4923,25
29864681,29864074,29865738,1664,4924,25
29870021,29869414,29872065,2651,4925,25
29876350,29875743,29877992,2249,4926,25
29882493,29881669,29883550,1881,4927,25
29887834,29887227,29889245,2018,4928,25
29893529,29892922,29894803,1881,4929,25
29899087,29898480,29900497,2017,4930,25
29904998,29904174,29906055,1881,4931,25
29910338,29909731,29911612,1881,4932,25
29915895,29915288,29917169,1881,4933,25
29921670,29920846,29922727,1881,4934,25
29927010,29926403,29928104,1701,4935,25
29932387,29931780,29934346,2566,4936,25
29938764,29938157,29939821,1664,4937,25
29944105,29943498,29945831,2333,4938,25
29950115,29949508,29951758,2250,4939,25
29956180,29955573,29957237,1664,4940,25
29961520,29960913,29963563,2650,4941,25
29967848,29967240,29969807,2567,4942,25
29974308,29973484,29975365,1881,4943,25
29979649,29979042,29981693,2651,4944,25
29986195,29985371,29987252,1881,4945,25
29991535,29990928,29992809,1881,4946,25
29997310,29996486,29998367,1881,4947,25
30002651,30002044,30004061,2017,4948,25
30008345,30007738,30009988,2250,4949,25
30014272,30013665,30015598,1933,4950,25
30019882,30019275,30021156,1881,4951,25
30025440,30024833,30026714,1881,4952,25
30030998,30030391,30032092,1701,4953,25
30036375,30035768,30037649,1881,4954,25
30041933,30041326,30043027,1701,4955,25
30047528,30046704,30048585,1881,4956,25
30052869,30052262,30054143,1881,4957,25
30058639,30058032,30059696,1664,4958,25
30063980,30063373,30066024,2651,4959,25
30070309,30069702,30071952,2250,4960,25
30076236,30075629,30077562,1933,4961,25
30081981,30081374,30083038,1664,4962,25
30087322,30086714,30088732,2018,4963,25
30093132,30092525,30094189,1664,4964,25
30098473,30097866,30099747,1881,4965,25
30104248,30103424,30105305,1881,4966,25
30109589,30108982,30110860,1878,4967,25
30115143,30114536,30116553,2017,4968,25
30121054,30120230,30122111,1881,4969,25
30126394,30125787,30128119,2332,4970,25
30132403,30131796,30133476,1680,4971,25
30137760,30137153,30139034,1881,4972,25
30143318,30142711,30144592,1881,4973,25
30148876,30148269,30150603,2334,4974,25
30154997,30154390,30156054,1664,4975,25
30160337,30159730,30161611,1881,4976,25
30165894,30165287,30166987,1700,4977,25
30171270,30170663,30172913,2250,4978,25
30177197,30176590,30179156,2566,4979,25
30183656,30182833,30184713,1880,4980,25
30188996,30188389,30190723,2334,4981,25
30195007,30194400,30196333,1933,4982,25
30200616,30200009,30202575,2566,4983,25
30206860,30206253,30208186,1933,4984,25
30212687,30211863,30213744,1881,4985,25
30218028,30217421,30220072,2651,4986,25
30224356,30223749,30225630,1881,4987,25
30230116,30229509,30231173,1664,4988,25
30235673,30235066,30236730,1664,4989,25
30241231,30240624,30242288,1664,4990,25
30246571,30245964,30247980,2016,4991,25
30252264,30251657,30253590,1933,4992,25
30257874,30257267,30258947,1680,4993,25
30263448,30262624,30264505,1881,4994,25
30268788,30268181,30270515,2334,4995,25
30275016,30274192,30276073,1881,4996,25
30280357,30279750,30281631,1881,4997,25
30285915,30285308,30287641,2333,4998,25
30292142,30291318,30293199,1881,4999,25
30297482,30296875,30298893,2018,5000,25
30303693,30302570,30304825,2255,1,50
30309139,30308233,30310488,2255,2,50
30314801,30313895,30316412,2517,3,50
30320725,30319819,30323518,3699,4,50
30327831,30326926,30329990,3064,5,50
30334304,30333398,30335653,2255,6,50
30339967,30339061,30341895,2834,7,50
30346209,30345303,30348369,3066,8,50
30352683,30351777,30354032,2255,9,50
30358345,30357439,30359694,2255,10,50
30364095,30363190,30365939,2749,11,50
30370341,30369435,30372734,3299,12,50
30377137,30376231,30379213,2982,13,50
30383616,30382710,30384764,2054,14,50
30389166,30388260,30390313,2053,15,50
30394932,30393809,30396064,2255,16,50
30400466,30399560,30401815,2255,17,50
30406217,30405311,30407566,2255,18,50
30411968,30411062,30414761,3699,19,50
30419164,30418258,30420513,2255,20,50
30424915,30424009,30427708,3699,21,50
30432111,30431205,30433258,2053,22,50
30437660,30436754,30440053,3299,23,50
30444456,30443550,30446195,2645,24,50
30450598,30449692,30452335,2643,25,50
30456738,30455832,30459130,3298,26,50
30463533,30462627,30464681,2054,27,50
30469084,30468178,30470232,2054,28,50
30474635,30473729,30475782,2053,29,50
30480184,30479278,30481331,2053,30,50
30485732,30484827,30488124,3297,31,50
30492527,30491621,30495236,3615,32,50
30499855,30498733,30500987,2254,33,50
30505389,30504483,30506578,2095,34,50
30510980,30510074,30513056,2982,35,50
30517459,30516553,30520167,3614,36,50
30524569,30523664,30525918,2254,37,50
30530321,30529415,30531670,2255,38,50
30536073,30535167,30537422,2255,39,50
30541824,30540919,30543350,2431,40,50
30547752,30546847,30549174,2327,41,50
30553575,30552670,30555650,2980,42,50
30560053,30559147,30561813,2666,43,50
30566216,30565310,30567565,2255,44,50
30571967,30571061,30573811,2750,45,50
30578214,30577308,30579563,2255,46,50
30583965,30583059,30585493,2434,47,50
30589896,30588990,30592288,3298,48,50
30596691,30595785,30599400,3615,49,50
30603803,30602897,30604951,2054,50,50
30609354,30608448,30611430,2982,51,50
30615834,30614928,30617910,2982,52,50
30622530,30621407,30623662,2255,53,50
30628065,30627159,30630541,3382,54,50
30634944,30634038,30636092,2054,55,50
30640495,30639589,30641917,2328,56,50
30646320,30645414,30648080,2666,57,50
30652483,30651577,30654559,2982,58,50
30658962,30658056,30660311,2255,59,50
30664713,30663808,30666062,2254,60,50
30670465,30669559,30673259,3700,61,50
30677879,30676756,30679011,2255,62,50
30683414,30682508,30684763,2255,63,50
30689165,30688260,30690354,2094,64,50
30694756,30693851,30696178,2327,65,50
30700581,30699675,30702003,2328,66,50
30706406,30705500,30708482,2982,67,50
30712886,30711980,30714033,2053,68,50
30718436,30717530,30719857,2327,69,50
30724477,30723354,30725609,2255,70,50
30730011,30729105,30731538,2433,71,50
30735939,30735034,30737288,2254,72,50
30741690,30740784,30743849,3065,73,50
30748252,30747346,30750328,2982,74,50
30754730,30753825,30757122,3297,75,50
30761525,30760619,30762673,2054,76,50
30767076,30766170,30769467,3297,77,50
30773870,30772964,30776263,3299,78,50
30780883,30779760,30782015,2255,79,50
30786416,30785511,30788259,2748,80,50
30792661,30791756,30795053,3297,81,50
30799455,30798550,30800602,2052,82,50
30805004,30804099,30806353,2254,83,50
30810755,30809849,30813548,3699,84,50
30817951,30817045,30819098,2053,85,50
30823500,30822594,30825893,3299,86,50
30830296,30829390,30832688,3298,87,50
30837091,30836185,30838851,2666,88,50
30843254,30842348,30845646,3298,89,50
30850049,30849143,30852757,3614,90,50
30857160,30856254,30859869,3615,91,50
30864272,30863366,30866980,3614,92,50
30871383,30870477,30872531,2054,93,50
30876933,30876028,30878355,2327,94,50
30882758,30881852,30885467,3615,95,50
30889870,30888964,30892263,3299,96,50
30896665,30895759,30899374,3615,97,50
30903777,30902871,30905536,2665,98,50
30910155,30909033,30911287,2254,99,50
30915688,30914783,30917037,2254,100,50
30921528,30920622,30923267,2645,101,50
30927759,30926853,30929095,2242,102,50
30933586,30932680,30934935,2255,103,50
30939426,30938520,30942135,3615,104,50
30946627,30945721,30947976,2255,105,50
30952467,30951561,30953615,2054,106,50
30958106,30957200,30959443,2243,107,50
30963934,30963029,30965905,2876,108,50
30970614,30969491,30971746,2255,109,50
30976237,30975331,30978313,2982,110,50
30982805,30981899,30984142,2243,111,50
30988633,30987727,30989982,2255,112,50
30994472,30993567,30995893,2326,113,50
31000383,30999478,31003007,3529,114,50
31007499,31006593,31010123,3530,115,50
31014831,31013709,31015963,2254,116,50
31020454,31019548,31023162,3614,117,50
31027653,31026748,31029306,2558,118,50
31033798,31032892,31036105,3213,119,50
31040596,31039691,31041945,2254,120,50
31046436,31045530,31047785,2255,121,50
31052493,31051370,31053625,2255,122,50
31058116,31057210,31059875,2665,123,50
31064367,31063461,31065705,2244,124,50
31070195,31069290,31072503,3213,125,50
31076994,31076088,31078985,2897,126,50
31083477,31082571,31084826,2255,127,50
31089317,31088411,31090464,2053,128,50
31094955,31094050,31096304,2254,129,50
31100794,31099889,31102553,2664,130,50
31107045,31106139,31109037,2898,131,50
31113529,31112623,31115183,2560,132,50
31119675,31118769,31121012,2243,133,50
31125502,31124597,31126838,2241,134,50
31131547,31130424,31132679,2255,135,50
31137170,31136264,31139246,2982,136,50
31143737,31142832,31146045,3213,137,50
31150536,31149630,31151873,2243,138,50
31156364,31155458,31158989,3531,139,50
31163480,31162575,31164828,2253,140,50
31169319,31168413,31171374,2961,141,50
31176082,31174959,31177214,2255,142,50
31181705,31180799,31184413,3614,143,50
31188904,31187999,31190242,2243,144,50
31194733,31193827,31197358,3531,145,50
31201850,31200944,31203503,2559,146,50
31207994,31207088,31209343,2255,147,50
31213834,31212928,31215593,2665,148,50
31220085,31219179,31221739,2560,149,50
31226231,31225325,31228538,3213,150,50
31233030,31232124,31235655,3531,151,50
31240147,31239241,31242455,3214,152,50
31246947,31246041,31249254,3213,153,50
31253745,31252840,31255093,2253,154,50
31259801,31258678,31260933,2255,155,50
31265423,31264518,31268132,3614,156,50
31272624,31271718,31273973,2255,157,50
31278681,31277558,31279813,2255,158,50
31284304,31283398,31285452,2054,159,50
31289943,31289037,31291292,2255,160,50
31295784,31294878,31297860,2982,161,50
31302353,31301447,31304323,2876,162,50
31308814,31307909,31311439,3530,163,50
31315932,31315026,31317903,2877,164,50
31322395,31321489,31325020,3531,165,50
31329729,31328606,31330861,2255,166,50
31335353,31334447,31337092,2645,167,50
31341584,31340678,31343554,2876,168,50
31348046,31347141,31350353,3212,169,50
31354846,31353940,31356499,2559,170,50
31360991,31360085,31362961,2876,171,50
31367453,31366547,31369106,2559,172,50
31373597,31372692,31375251,2559,173,50
31379743,31378837,31381396,2559,174,50
31386105,31384982,31387237,2255,175,50
31391729,31390823,31394122,3299,176,50
31398614,31397708,31400922,3214,177,50
31405415,31404509,31407723,3214,178,50
31412432,31411310,31413564,2254,179,50
31418272,31417150,31419404,2254,180,50
31423895,31422990,31425632,2642,181,50
31430124,31429218,31431473,2255,182,50
31435965,31435059,31438358,3299,183,50
31442850,31441945,31444187,2242,184,50
31448896,31447773,31450028,2255,185,50
31454520,31453614,31456596,2982,186,50
31461306,31460183,31462438,2255,187,50
31466929,31466023,31468350,2327,188,50
31472842,31471936,31475466,3530,189,50
31479958,31479052,31482583,3531,190,50
31487075,31486169,31488728,2559,191,50
31493220,31492314,31494569,2255,192,50
31499061,31498155,31500410,2255,193,50
31504902,31503996,31506978,2982,194,50
31511471,31510565,31512808,2243,195,50
31517300,31516394,31519270,2876,196,50
31523762,31522857,31525099,2242,197,50
31529590,31528685,31530928,2243,198,50
31535420,31534514,31536769,2255,199,50
31541260,31540355,31543020,2665,200,50
31547513,31546607,31548849,2242,201,50
31553340,31552435,31555965,3530,202,50
31560457,31559551,31562428,2877,203,50
31566921,31566015,31568270,2255,204,50
31572762,31571856,31574837,2981,205,50
31579330,31578424,31580678,2254,206,50
31585170,31584264,31587561,3297,207,50
31592054,31591148,31594679,3531,208,50
31599172,31598266,31600521,2255,209,50
31605230,31604107,31606362,2255,210,50
31610854,31609948,31614343,4395,211,50
31618835,31617930,31620827,2897,212,50
31625319,31624414,31637356,12942,213,50
31641938,31641032,31643287,2255,214,50
31647779,31646873,31649200,2327,215,50
31653692,31652786,31655041,2255,216,50
31659533,31658627,31660882,2255,217,50
31665375,31664469,31666523,2054,218,50
31671015,31670109,31673322,3213,219,50
31677815,31676909,31679153,2244,220,50
31683861,31682739,31684993,2254,221,50
31689485,31688579,31691223,2644,222,50
31695716,31694810,31697687,2877,223,50
31702180,31701274,31704150,2876,224,50
31708643,31707737,31710297,2560,225,50
31714790,31713884,31717415,3531,226,50
31721908,31721002,31723879,2877,227,50
31728372,31727466,31730680,3214,228,50
31735173,31734267,31736510,2243,229,50
31741003,31740097,31742657,2560,230,50
31747150,31746244,31748486,2242,231,50
31753195,31752072,31754327,2255,232,50
31758819,31757913,31760168,2255,233,50
31764660,31763754,31766082,2328,234,50
31770574,31769668,31772545,2877,235,50
31777038,31776132,31779662,3530,236,50
31784155,31783249,31786462,3213,237,50
31790955,31790049,31792303,2254,238,50
31796795,31795889,31799504,3615,239,50
31803997,31803091,31805346,2255,240,50
31809838,31808932,31810986,2054,241,50
31815478,31814572,31816827,2255,242,50
31821318,31820413,31822667,2254,243,50
31827159,31826253,31829235,2982,244,50
31833728,31832822,31835065,2243,245,50
31839558,31838652,31841865,3213,246,50
31846358,31845452,31847706,2254,247,50
31852198,31851293,31854274,2981,248,50
31858767,31857861,31860421,2560,249,50
31864914,31864008,31866885,2877,250,50
31871378,31870472,31873685,3213,251,50
31878178,31877272,31880803,3531,252,50
31885296,31884390,31886645,2255,253,50
31891137,31890231,31893845,3614,254,50
31898554,31897432,31899686,2254,255,50
31904178,31903272,31906254,2982,256,50
31910747,31909841,31912096,2255,257,50
31916589,31915683,31919298,3615,258,50
31923791,31922885,31925140,2255,259,50
31929632,31928726,31931708,2982,260,50
31936418,31935295,31937550,2255,261,50
31942042,31941137,31944752,3615,262,50
31949245,31948339,31950594,2255,263,50
31955086,31954180,31956435,2255,264,50
31960927,31960021,31962349,2328,265,50
31966840,31965935,31969148,3213,266,50
31973640,31972735,31975947,3212,267,50
31980440,31979534,31982747,3213,268,50
31987240,31986334,31989865,3531,269,50
31994358,31993452,31995696,2244,270,50
32000188,31999282,32002495,3213,271,50
32006988,32006082,32008336,2254,272,50
32012827,32011922,32014903,2981,273,50
32019394,32018489,32022018,3529,274,50
32026511,32025605,32028819,3214,275,50
32033311,32032405,32035935,3530,276,50
32040427,32039521,32041776,2255,277,50
32046268,32045362,32047690,2328,278,50
32052182,32051276,32053530,2254,279,50
32058022,32057116,32060097,2981,280,50
32064807,32063684,32065939,2255,281,50
32070430,32069525,32071851,2326,282,50
32076343,32075437,32078968,3531,283,50
32083461,32082555,32084809,2254,284,50
32089301,32088395,32092010,3615,285,50
32096503,32095597,32098811,3214,286,50
32103304,32102398,32105275,2877,287,50
32109768,32108862,32111117,2255,288,50
32115608,32114703,32116956,2253,289,50
32121664,32120542,32122796,2254,290,50
32127288,32126382,32129025,2643,291,50
32133518,32132612,32135826,3214,292,50
32140319,32139413,32141667,2254,293,50
32146159,32145253,32148551,3298,294,50
32153259,32152137,32154391,2254,295,50
32158883,32157977,32160030,2053,296,50
32164522,32163616,32165871,2255,297,50
32170363,32169457,32171784,2327,298,50
32176276,32175370,32177930,2560,299,50
32182422,32181516,32183758,2242,300,50
32188249,32187344,32189598,2254,301,50
32194089,32193184,32196165,2981,302,50
32200658,32199752,32202007,2255,303,50
32206715,32205593,32207847,2254,304,50
32212339,32211433,32213688,2255,305,50
32218180,32217274,32219327,2053,306,50
32224036,32222913,32225168,2255,307,50
32229661,32228755,32231010,2255,308,50
32235502,32234596,32236851,2255,309,50
32241343,32240437,32243418,2981,310,50
32248128,32247005,32249260,2255,311,50
32253751,32252846,32254899,2053,312,50
32259391,32258485,32260739,2254,313,50
32265231,32264325,32266580,2255,314,50
32271072,32270166,32273781,3615,315,50
32278273,32277367,32279622,2255,316,50
32284330,32283208,32285462,2254,317,50
32289954,32289048,32291101,2053,318,50
32295592,32294687,32298216,3529,319,50
32302710,32301803,32305017,3214,320,50
32309510,32308604,32310859,2255,321,50
32315351,32314445,32316772,2327,322,50
32321264,32320358,32322613,2255,323,50
32327105,32326199,32329181,2982,324,50
32333673,32332768,32335643,2875,325,50
32340136,32339230,32341473,2243,326,50
32346181,32345059,32347313,2254,327,50
32351805,32350899,32354196,3297,328,50
32358688,32357783,32360996,3213,329,50
32365489,32364583,32367797,3214,330,50
32372289,32371383,32373638,2255,331,50
32378347,32377224,32379479,2255,332,50
32383971,32383065,32386046,2981,333,50
32390539,32389633,32391888,2255,334,50
32396380,32395474,32398119,2645,335,50
32402611,32401706,32403960,2254,336,50
32408452,32407546,32410190,2644,337,50
32414900,32413777,32416032,2255,338,50
32420740,32419618,32421872,2254,339,50
32426364,32425458,32428102,2644,340,50
32432595,32431689,32433932,2243,341,50
32438424,32437518,32439760,2242,342,50
32444253,32443346,32446224,2878,343,50
32450933,32449811,32452065,2254,344,50
32456556,32455651,32458632,2981,345,50
32463125,32462219,32464474,2255,346,50
32468965,32468060,32470113,2053,347,50
32474605,32473699,32477230,3531,348,50
32481722,32480817,32484345,3528,349,50
32488838,32487932,32490186,2254,350,50
32494677,32493772,32496732,2960,351,50
32501225,32500319,32502574,2255,352,50
32507066,32506160,32509775,3615,353,50
32514484,32513362,32515616,2254,354,50
32520108,32519202,32522501,3299,355,50
32526994,32526088,32528647,2559,356,50
32533139,32532233,32534792,2559,357,50
32539284,32538378,32540938,2560,358,50
32545431,32544525,32547085,2560,359,50
32551795,32550672,32552927,2255,360,50
32557419,32556513,32560127,3614,361,50
32564620,32563714,32565968,2254,362,50
32570460,32569554,32573169,3615,363,50
32577662,32576756,32578998,2242,364,50
32583489,32582584,32585797,3213,365,50
32590290,32589384,32591944,2560,366,50
32596437,32595531,32597786,2255,367,50
32602278,32601372,32603699,2327,368,50
32608191,32607285,32610815,3530,369,50
32615308,32614402,32616961,2559,370,50
32621453,32620547,32623424,2877,371,50
32627917,32627011,32629255,2244,372,50
32633747,32632841,32635717,2876,373,50
32640209,32639304,32641546,2242,374,50
32646256,32645133,32647388,2255,375,50
32651879,32650974,32654588,3614,376,50
32659081,32658175,32660419,2244,377,50
32664911,32664005,32666260,2255,378,50
32670968,32669846,32672100,2254,379,50
32676592,32675686,32677740,2054,380,50
32682232,32681326,32683569,2243,381,50
32688061,32687155,32689715,2560,382,50
32694207,32693302,32695555,2253,383,50
32700047,32699141,32701785,2644,384,50
32706278,32705372,32708586,3214,385,50
32713079,32712173,32715704,3531,386,50
32720196,32719291,32722504,3213,387,50
32726997,32726091,32728968,2877,388,50
32733460,32732555,32736085,3530,389,50
32740578,32739672,32743202,3530,390,50
32747695,32746789,32750002,3213,391,50
32754495,32753589,32756466,2877,392,50
32760959,32760053,32763584,3531,393,50
32768077,32767171,32769413,2242,394,50
32773905,32772999,32775242,2243,395,50
32779732,32778827,32781722,2895,396,50
32786214,32785308,32788837,3529,397,50
32793329,32792423,32795637,3214,398,50
32800129,32799223,32801466,2243,399,50
32805958,32805052,32807306,2254,400,50
32811798,32810892,32813536,2644,401,50
32818028,32817122,32819364,2242,402,50
32823855,32822949,32826480,3531,403,50
32830972,32830066,32833597,3531,404,50
32838305,32837183,32839437,2254,405,50
32843928,32843023,32846637,3614,406,50
32851129,32850223,32853437,3214,407,50
32857929,32857023,32859583,2560,408,50
32864292,32863169,32865424,2255,409,50
32869916,32869010,32872308,3298,410,50
32876801,32875895,32878149,2254,411,50
32882640,32881735,32884060,2325,412,50
32888552,32887646,32890206,2560,413,50
32894698,32893792,32896352,2560,414,50
32900844,32899938,32903467,3529,415,50
32907959,32907053,32910266,3213,416,50
32914758,32913852,32916095,2243,417,50
32920587,32919681,32921936,2255,418,50
32926428,32925522,32927850,2328,419,50
32932341,32931436,32933678,2242,420,50
32938170,32937264,32940794,3530,421,50
32945287,32944381,32946624,2243,422,50
32951116,32950210,32952464,2254,423,50
32956956,32956050,32959347,3297,424,50
32963840,32962934,32965494,2560,425,50
32969986,32969080,32971334,2254,426,50
32975826,32974920,32978217,3297,427,50
32982709,32981803,32984046,2243,428,50
32988537,32987632,32990190,2558,429,50
32994682,32993776,32996990,3214,430,50
33001482,33000576,33003790,3214,431,50
33008283,33007377,33010908,3531,432,50
33015401,33014495,33016749,2254,433,50
33021240,33020335,33022999,2664,434,50
33027491,33026586,33029482,2896,435,50
33033973,33033068,33035309,2241,436,50
33039801,33038895,33041455,2560,437,50
33045947,33045041,33047296,2255,438,50
33051788,33050882,33053864,2982,439,50
33058356,33057450,33059705,2255,440,50
33064197,33063291,33066906,3615,441,50
33071399,33070493,33073707,3214,442,50
33078200,33077294,33079854,2560,443,50
33084346,33083441,33085695,2254,444,50
33090404,33089281,33091536,2255,445,50
33096028,33095122,33097376,2254,446,50
33101868,33100962,33103289,2327,447,50
33107998,33106875,33109130,2255,448,50
33113622,33112716,33114970,2254,449,50
33119462,33118556,33122170,3614,450,50
33126880,33125757,33128012,2255,451,50
33132504,33131598,33134580,2982,452,50
33139073,33138167,33140726,2559,453,50
33145217,33144312,33147525,3213,454,50
33152235,33151112,33153367,2255,455,50
33157859,33156953,33159597,2644,456,50
33164090,33163184,33166397,3213,457,50
33171107,33169984,33172239,2255,458,50
33176731,33175825,33179440,3615,459,50
33183933,33183027,33185281,2254,460,50
33189773,33188867,33191194,2327,461,50
33195686,33194780,33197023,2243,462,50
33201732,33200609,33202864,2255,463,50
33207356,33206450,33208705,2255,464,50
33213197,33212291,33214344,2053,465,50
33218836,33217930,33221460,3530,466,50
33225952,33225046,33227301,2255,467,50
33231793,33230887,33232941,2054,468,50
33237649,33236527,33238781,2254,469,50
33243273,33242367,33245032,2665,470,50
33249525,33248619,33250874,2255,471,50
33255365,33254460,33257441,2981,472,50
33261933,33261028,33263282,2254,473,50
33267774,33266868,33269534,2666,474,50
33274027,33273121,33276335,3214,475,50
33280828,33279922,33283135,3213,476,50
33287628,33286722,33289282,2560,477,50
33293774,33292868,33296398,3530,478,50
33300889,33299984,33302226,2242,479,50
33306718,33305812,33308709,2897,480,50
33313200,33312295,33314549,2254,481,50
33319041,33318135,33320800,2665,482,50
33325292,33324386,33327917,3531,483,50
33332626,33331503,33333758,2255,484,50
33338250,33337344,33339397,2053,485,50
33343889,33342983,33345880,2897,486,50
33350373,33349467,33352680,3213,487,50
33357173,33356267,33358510,2243,488,50
33363001,33362096,33364350,2254,489,50
33368841,33367936,33369988,2052,490,50
33374480,33373574,33376788,3214,491,50
33381497,33380375,33382629,2254,492,50
33387120,33386215,33389512,3297,493,50
33394005,33393099,33396313,3214,494,50
33400806,33399900,33402142,2242,495,50
33406634,33405728,33407982,2254,496,50
33412473,33411568,33413822,2254,497,50
33418313,33417408,33420706,3298,498,50
33425199,33424293,33427824,3531,499,50
33432317,33431411,33433666,2255,500,50
33438375,33437252,33439507,2255,501,50
33443998,33443093,33445144,2051,502,50
33449636,33448730,33451290,2560,503,50
33456000,33454877,33457132,2255,504,50
33461624,33460718,33463362,2644,505,50
33467855,33466949,33469204,2255,506,50
33473912,33472790,33475044,2254,507,50
33479536,33478630,33482244,3614,508,50
33486737,33485831,33488708,2877,509,50
33493199,33492294,33494536,2242,510,50
33499028,33498122,33500377,2255,511,50
33504869,33503963,33507578,3615,512,50
33512071,33511165,33513419,2254,513,50
33517910,33517005,33519985,2980,514,50
33524478,33523572,33525815,2243,515,50
33530307,33529401,33532298,2897,516,50
33536791,33535885,33538445,2560,517,50
33542937,33542032,33544591,2559,518,50
33549083,33548177,33550432,2255,519,50
33554924,33554018,33556346,2328,520,50
33560838,33559932,33563146,3214,521,50
33567639,33566733,33568987,2254,522,50
33573479,33572573,33574626,2053,523,50
33579118,33578212,33581426,3214,524,50
33585918,33585013,33587267,2254,525,50
33591758,33590853,33594149,3296,526,50
33598641,33597735,33600633,2898,527,50
33605126,33604220,33607750,3530,528,50
33612242,33611337,33613578,2241,529,50
33618070,33617164,33620377,3213,530,50
33624869,33623963,33626861,2898,531,50
33631354,33630448,33633007,2559,532,50
33637499,33636593,33640124,3531,533,50
33644616,33643710,33647240,3530,534,50
33651733,33650827,33653070,2243,535,50
33657562,33656656,33659216,2560,536,50
33663708,33662802,33665057,2255,537,50
33669549,33668643,33671287,2644,538,50
33675779,33674874,33677771,2897,539,50
33682264,33681358,33683612,2254,540,50
33688104,33687198,33689453,2255,541,50
33693944,33693039,33695703,2664,542,50
33700196,33699290,33702504,3214,543,50
33706996,33706090,33708345,2255,544,50
33712837,33711931,33715230,3299,545,50
33719723,33718817,33721072,2255,546,50
33725565,33724658,33727957,3299,547,50
33732667,33731544,33733799,2255,548,50
33738507,33737385,33739639,2254,549,50
33744131,33743225,33745868,2643,550,50
33750361,33749455,33751710,2255,551,50
33756418,33755296,33757550,2254,552,50
33762041,33761136,33764117,2981,553,50
33768610,33767704,33770263,2559,554,50
33774755,33773849,33776746,2897,555,50
33781239,33780333,33782577,2244,556,50
33787068,33786163,33789376,3213,557,50
33793869,33792963,33796176,3213,558,50
33800668,33799762,33803292,3530,559,50
33807784,33806878,33810409,3531,560,50
33814901,33813996,33816250,2254,561,50
33820741,33819836,33821889,2053,562,50
33826381,33825475,33828373,2898,563,50
33832865,33831959,33835490,3531,564,50
33839982,33839076,33841320,2244,565,50
33845812,33844906,33848120,3214,566,50
33852611,33851706,33853960,2254,567,50
33858452,33857546,33859873,2327,568,50
33864364,33863459,33866355,2896,569,50
33870848,33869942,33872817,2875,570,50
33877310,33876404,33878659,2255,571,50
33883151,33882245,33885543,3298,572,50
33890035,33889130,33891384,2254,573,50
33896093,33894970,33897225,2255,574,50
33901717,33900811,33902865,2054,575,50
33907356,33906451,33909010,2559,576,50
33913502,33912596,33914838,2242,577,50
33919330,33918424,33920679,2255,578,50
33925171,33924265,33926318,2053,579,50
33930809,33929904,33932462,2558,580,50
33936954,33936048,33938291,2243,581,50
33942783,33941877,33944132,2255,582,50
33948624,33947718,33951332,3614,583,50
33955825,33954919,33958133,3214,584,50
33962625,33961720,33963974,2254,585,50
33968466,33967560,33969815,2255,586,50
33974307,33973401,33976065,2664,587,50
33980775,33979652,33981907,2255,588,50
33986399,33985493,33988158,2665,589,50
33992651,33991745,33994959,3214,590,50
33999669,33998546,34000801,2255,591,50
34005292,34004387,34006641,2254,592,50
34011133,34010227,34012554,2327,593,50
34017046,34016140,34018384,2244,594,50
34022876,34021970,34024868,2898,595,50
34029361,34028455,34031015,2560,596,50
34035509,34034602,34037478,2876,597,50
34041971,34041065,34043319,2254,598,50
34047810,34046905,34049159,2254,599,50
34053651,34052745,34055073,2328,600,50
34059565,34058659,34060902,2243,601,50
34065394,34064488,34068019,3531,602,50
34072512,34071606,34074820,3214,603,50
34079313,34078407,34081620,3213,604,50
34086330,34085207,34087462,2255,605,50
34091954,34091048,34093692,2644,606,50
34098401,34097279,34099533,2254,607,50
34104025,34103119,34106417,3298,608,50
34110909,34110004,34113534,3530,609,50
34118025,34117120,34120016,2896,610,50
34124509,34123603,34126817,3214,611,50
34131310,34130404,34132659,2255,612,50
34137368,34136245,34138500,2255,613,50
34142992,34142086,34144414,2328,614,50
34148906,34148000,34151531,3531,615,50
34156024,34155118,34157994,2876,616,50
34162703,34161581,34163835,2254,617,50
34168327,34167421,34170720,3299,618,50
34175213,34174307,34177521,3214,619,50
34182014,34181108,34183363,2255,620,50
34187855,34186949,34189593,2644,621,50
34194086,34193180,34196710,3530,622,50
34201203,34200297,34203173,2876,623,50
34207665,34206760,34210289,3529,624,50
34214999,34213876,34216131,2255,625,50
34220623,34219717,34223332,3615,626,50
34228041,34226919,34229173,2254,627,50
34233665,34232759,34235741,2982,628,50
34240450,34239328,34241582,2254,629,50
34246074,34245168,34247423,2255,630,50
34251915,34251009,34253336,2327,631,50
34258044,34256922,34259176,2254,632,50
34263668,34262762,34265089,2327,633,50
34269581,34268675,34271889,3214,634,50
34276382,34275476,34278689,3213,635,50
34283182,34282276,34285807,3531,636,50
34290300,34289394,34292271,2877,637,50
34296764,34295858,34298113,2255,638,50
34302604,34301699,34303750,2051,639,50
34308460,34307337,34309592,2255,640,50
34314084,34313178,34315232,2054,641,50
34319724,34318818,34322032,3214,642,50
34326525,34325619,34328833,3214,643,50
34333324,34332419,34334978,2559,644,50
34339470,34338564,34340806,2242,645,50
34345298,34344392,34346635,2243,646,50
34351343,34350221,34352475,2254,647,50
34357184,34356062,34358316,2254,648,50
34362807,34361902,34364156,2254,649,50
34368865,34367742,34369997,2255,650,50
34374489,34373583,34376565,2982,651,50
34381058,34380152,34382407,2255,652,50
34386900,34385994,34389293,3299,653,50
34393786,34392880,34396409,3529,654,50
34400901,34399996,34403209,3213,655,50
34407702,34406796,34409356,2560,656,50
34413848,34412942,34416156,3214,657,50
34420649,34419743,34421998,2255,658,50
34426490,34425584,34427911,2327,659,50
34432403,34431497,34433751,2254,660,50
34438243,34437337,34439665,2328,661,50
34444157,34443251,34446781,3530,662,50
34451489,34450367,34452621,2254,663,50
34457113,34456207,34459506,3299,664,50
34463999,34463093,34465348,2255,665,50
34469840,34468934,34471578,2644,666,50
34476070,34475165,34478694,3529,667,50
34483187,34482281,34485495,3214,668,50
34489987,34489082,34491640,2558,669,50
34496132,34495226,34498102,2876,670,50
34502595,34501689,34505220,3531,671,50
34509713,34508807,34511367,2560,672,50
34515858,34514953,34517207,2254,673,50
34521699,34520793,34523047,2254,674,50
34527538,34526633,34530247,3614,675,50
34534740,34533834,34536711,2877,676,50
34541204,34540298,34542541,2243,677,50
34547032,34546127,34548381,2254,678,50
34552873,34551967,34555266,3299,679,50
34559759,34558853,34562384,3531,680,50
34566877,34565971,34568226,2255,681,50
34572718,34571812,34575426,3614,682,50
34579919,34579013,34582542,3529,683,50
34587251,34586129,34588383,2254,684,50
34592875,34591969,34595584,3615,685,50
34600076,34599171,34602700,3529,686,50
34607193,34606287,34609501,3214,687,50
34613994,34613088,34615331,2243,688,50
34619822,34618917,34621476,2559,689,50
34625968,34625062,34628591,3529,690,50
34633300,34632178,34634432,2254,691,50
34638923,34638018,34641632,3614,692,50
34646125,34645219,34648432,3213,693,50
34652924,34652018,34654915,2897,694,50
34659408,34658502,34660745,2243,695,50
34665236,34664331,34666573,2242,696,50
34671065,34670159,34673690,3531,697,50
34678183,34677277,34679532,2255,698,50
34684024,34683118,34686100,2982,699,50
34690593,34689687,34692563,2876,700,50
34697055,34696150,34698709,2559,701,50
34703417,34702295,34704549,2254,702,50
34709041,34708135,34711434,3299,703,50
34715927,34715021,34718235,3214,704,50
34722728,34721822,34724077,2255,705,50
34728569,34727663,34730645,2982,706,50
34735354,34734232,34736486,2254,707,50
34740978,34740072,34742716,2644,708,50
34747209,34746303,34748862,2559,709,50
34753354,34752448,34755661,3213,710,50
34760154,34759248,34762778,3530,711,50
34767271,34766365,34768608,2243,712,50
34773316,34772194,34774448,2254,713,50
34778940,34778034,34780700,2666,714,50
34785192,34784287,34787163,2876,715,50
34791656,34790750,34792993,2243,716,50
34797485,34796579,34798823,2244,717,50
34803316,34802410,34805286,2876,718,50
34809779,34808873,34811128,2255,719,50
34815621,34814715,34816970,2255,720,50
34821462,34820556,34823200,2644,721,50
34827692,34826787,34830317,3530,722,50
34834811,34833904,34836160,2256,723,50
34840652,34839746,34843361,3615,724,50
34847854,34846947,34849203,2256,725,50
34853695,34852789,34855433,2644,726,50
34859926,34859020,34861275,2255,727,50
34865767,34864861,34867505,2644,728,50
34871998,34871092,34873347,2255,729,50
34877839,34876933,34879188,2255,730,50
34883680,34882774,34886389,3615,731,50
34890882,34889976,34892231,2255,732,50
34896940,34895817,34898072,2255,733,50
34902563,34901658,34904322,2664,734,50
34908815,34907909,34910164,2255,735,50
34914655,34913750,34915803,2053,736,50
34920295,34919389,34921644,2255,737,50
34926136,34925230,34928529,3299,738,50
34933022,34932116,34934993,2877,739,50
34939486,34938580,34946207,7627,740,50
34950816,34949910,34951948,2038,741,50
34956440,34955534,34957789,2255,742,50
34962281,34961375,34964990,3615,743,50
34969483,34968577,34970831,2254,744,50
34975323,34974417,34976471,2054,745,50
34980963,34980057,34982954,2897,746,50
34987445,34986540,34989098,2558,747,50
34993808,34992685,34994940,2255,748,50
34999432,34998526,35000853,2327,749,50
35005344,35004439,35006692,2253,750,50
35011185,35010279,35013893,3614,751,50
35018386,35017480,35019734,2254,752,50
35024226,35023321,35025986,2665,753,50
35030479,35029573,35033102,3529,754,50
35037811,35036689,35038943,2254,755,50
35043434,35042529,35044582,2053,756,50
35049074,35048168,35050423,2255,757,50
35054915,35054009,35056063,2054,758,50
35060555,35059649,35062546,2897,759,50
35067039,35066133,35069008,2875,760,50
35073501,35072595,35074838,2243,761,50
35079330,35078424,35080983,2559,762,50
35085475,35084569,35087782,3213,763,50
35092275,35091369,35093928,2559,764,50
35098420,35097514,35101043,3529,765,50
35105536,35104630,35108161,3531,766,50
35112654,35111748,35113991,2243,767,50
35118483,35117577,35119832,2255,768,50
35124325,35123419,35126401,2982,769,50
35130894,35129988,35133518,3530,770,50
35138011,35137105,35140635,3530,771,50
35145128,35144222,35146477,2255,772,50
35150969,35150063,35152116,2053,773,50
35156607,35155702,35157945,2243,774,50
35162436,35161531,35165060,3529,775,50
35169552,35168647,35171521,2874,776,50
35176014,35175108,35178638,3530,777,50
35183131,35182225,35185755,3530,778,50
35190247,35189342,35192872,3530,779,50
35197364,35196459,35199335,2876,780,50
35203828,35202922,35206453,3531,781,50
35210946,35210040,35212917,2877,782,50
35217410,35216504,35219718,3214,783,50
35224427,35223305,35225559,2254,784,50
35230051,35229145,35231400,2255,785,50
35235892,35234986,35237241,2255,786,50
35241733,35240827,35242881,2054,787,50
35247373,35246467,35248722,2255,788,50
35253431,35252308,35254563,2255,789,50
35259055,35258149,35260477,2328,790,50
35264969,35264063,35266318,2255,791,50
35270810,35269904,35272159,2255,792,50
35276651,35275745,35278727,2982,793,50
35283219,35282314,35285527,3213,794,50
35290019,35289114,35292010,2896,795,50
35296503,35295597,35299127,3530,796,50
35303620,35302714,35306245,3531,797,50
35310738,35309832,35312392,2560,798,50
35316885,35315979,35318223,2244,799,50
35322715,35321809,35324063,2254,800,50
35328555,35327649,35329702,2053,801,50
35334194,35333288,35336501,3213,802,50
35340993,35340087,35342330,2243,803,50
35346822,35345916,35348171,2255,804,50
35352663,35351757,35353811,2054,805,50
35358303,35357397,35359640,2243,806,50
35364132,35363226,35365785,2559,807,50
35370277,35369371,35371625,2254,808,50
35376117,35375211,35377466,2255,809,50
35382174,35381052,35383306,2254,810,50
35387798,35386892,35388946,2054,811,50
35393437,35392532,35394774,2242,812,50
35399266,35398360,35400614,2254,813,50
35405106,35404200,35407498,3298,814,50
35411991,35411085,35413340,2255,815,50
35417832,35416926,35420224,3298,816,50
35424717,35423811,35427024,3213,817,50
35431517,35430611,35433824,3213,818,50
35438315,35437410,35439663,2253,819,50
35444155,35443249,35446546,3297,820,50
35451038,35450132,35453663,3531,821,50
35458155,35457250,35459504,2254,822,50
35463996,35463090,35465144,2054,823,50
35469636,35468730,35471943,3213,824,50
35476653,35475530,35477785,2255,825,50
35482276,35481371,35483698,2327,826,50
35488190,35487284,35490498,3214,827,50
35494991,35494085,35496960,2875,828,50
35501453,35500547,35502802,2255,829,50
35507293,35506388,35509031,2643,830,50
35513524,35512618,35516148,3530,831,50
35520641,35519735,35522295,2560,832,50
35527004,35525882,35528136,2254,833,50
35532628,35531722,35534365,2643,834,50
35538858,35537952,35541165,3213,835,50
35545658,35544752,35548282,3530,836,50
35552775,35551869,35555083,3214,837,50
35559793,35558670,35560925,2255,838,50
35565416,35564511,35567175,2664,839,50
35571885,35570762,35573017,2255,840,50
35577509,35576603,35578656,2053,841,50
35583147,35582242,35584496,2254,842,50
35588988,35588082,35591064,2982,843,50
35595557,35594651,35597865,3214,844,50
35602358,35601452,35604012,2560,845,50
35608721,35607599,35609853,2254,846,50
35614345,35613439,35617054,3615,847,50
35621546,35620641,35623199,2558,848,50
35627909,35626786,35629041,2255,849,50
35633533,35632627,35635271,2644,850,50
35639980,35638858,35641112,2254,851,50
35645603,35644698,35646751,2053,852,50
35651243,35650337,35653551,3214,853,50
35658044,35657138,35660014,2876,854,50
35664507,35663601,35666161,2560,855,50
35670654,35669748,35672623,2875,856,50
35677116,35676210,35679424,3214,857,50
35683917,35683011,35685570,2559,858,50
35690278,35689156,35691410,2254,859,50
35695903,35694997,35697642,2645,860,50
35702135,35701229,35704760,3531,861,50
35709253,35708347,35711224,2877,862,50
35715717,35714811,35717370,2559,863,50
35721862,35720956,35723515,2559,864,50
35728008,35727102,35730316,3214,865,50
35734809,35733903,35737434,3531,866,50
35741927,35741021,35743265,2244,867,50
35747757,35746851,35749106,2255,868,50
35753598,35752692,35755990,3298,869,50
35760483,35759577,35763107,3530,870,50
35767600,35766694,35769253,2559,871,50
35773745,35772840,35775094,2254,872,50
35779586,35778680,35780734,2054,873,50
35785226,35784320,35787197,2877,874,50
35791690,35790784,35793028,2244,875,50
35797520,35796614,35799827,3213,876,50
35804320,35803414,35805658,2244,877,50
35810149,35809244,35811486,2242,878,50
35815978,35815073,35818603,3530,879,50
35823096,35822190,35825404,3214,880,50
35829897,35828991,35831246,2255,881,50
35835739,35834833,35836886,2053,882,50
35841378,35840473,35843032,2559,883,50
35847524,35846618,35848861,2243,884,50
35853352,35852447,35855977,3530,885,50
35860470,35859564,35862778,3214,886,50
35867271,35866365,35869579,3214,887,50
35874072,35873166,35876043,2877,888,50
35880752,35879630,35881884,2254,889,50
35886376,35885470,35889085,3615,890,50
35893578,35892672,35894927,2255,891,50
35899419,35898513,35901157,2644,892,50
35905650,35904744,35907958,3214,893,50
35912451,35911545,35914105,2560,894,50
35918598,35917692,35920906,3214,895,50
35925398,35924493,35926747,2254,896,50
35931455,35930333,35932587,2254,897,50
35937078,35936173,35938427,2254,898,50
35942919,35942013,35944268,2255,899,50
35948760,35947854,35949908,2054,900,50
35954400,35953495,35957024,3529,901,50
35961516,35960611,35963170,2559,902,50
35967662,35966757,35969315,2558,903,50
35973807,35972901,35975778,2877,904,50
35980271,35979365,35981620,2255,905,50
35986112,35985206,35988505,3299,906,50
35992998,35992092,35994651,2559,907,50
35999143,35998237,36000492,2255,908,50
36004984,36004079,36007376,3297,909,50
36011868,36010963,36013522,2559,910,50
36018014,36017108,36019363,2255,911,50
36023855,36022949,36026564,3615,912,50
36031057,36030151,36032394,2243,913,50
36036887,36035981,36038224,2243,914,50
36042717,36041811,36044370,2559,915,50
36048861,36047956,36050853,2897,916,50
36055345,36054440,36056682,2242,917,50
36061174,36060268,36063799,3531,918,50
36068508,36067386,36069640,2254,919,50
36074132,36073226,36076840,3614,920,50
36081333,36080427,36082669,2242,921,50
36087377,36086255,36088509,2254,922,50
36093000,36092095,36094760,2665,923,50
36099253,36098347,36101223,2876,924,50
36105716,36104810,36107369,2559,925,50
36111861,36110955,36113198,2243,926,50
36117690,36116784,36119998,3214,927,50
36124491,36123585,36126798,3213,928,50
36131508,36130385,36132640,2255,929,50
36137132,36136226,36138554,2328,930,50
36143046,36142140,36145671,3531,931,50
36150164,36149258,36152472,3214,932,50
36156964,36156058,36158618,2560,933,50
36163111,36162205,36165081,2876,934,50
36169574,36168668,36170911,2243,935,50
36175402,36174497,36177710,3213,936,50
36182203,36181297,36183552,2255,937,50
36188043,36187138,36189190,2052,938,50
36193682,36192776,36195990,3214,939,50
36200483,36199577,36202137,2560,940,50
36206847,36205724,36207979,2255,941,50
36212471,36211565,36213820,2255,942,50
36218311,36217406,36221020,3614,943,50
36225729,36224607,36226861,2254,944,50
36231353,36230447,36232774,2327,945,50
36237266,36236360,36238920,2560,946,50
36243413,36242507,36245067,2560,947,50
36249560,36248654,36251214,2560,948,50
36255707,36254801,36258332,3531,949,50
36263042,36261919,36264174,2255,950,50
36268666,36267760,36270425,2665,951,50
36274918,36274012,36277226,3214,952,50
36281719,36280813,36283068,2255,953,50
36287777,36286654,36288909,2255,954,50
36293619,36292496,36294751,2255,955,50
36299242,36298337,36300664,2327,956,50
36305155,36304250,36307146,2896,957,50
36311855,36310733,36312987,2254,958,50
36317479,36316573,36319239,2666,959,50
36323732,36322826,36325724,2898,960,50
36330216,36329311,36331565,2254,961,50
36336056,36335151,36337478,2327,962,50
36341970,36341065,36343308,2243,963,50
36347801,36346895,36349150,2255,964,50
36353859,36352736,36354991,2255,965,50
36359482,36358577,36360831,2254,966,50
36365323,36364417,36366471,2054,967,50
36371179,36370057,36372311,2254,968,50
36376804,36375898,36379512,3614,969,50
36384005,36383099,36385354,2255,970,50
36389846,36388940,36391267,2327,971,50
36395759,36394853,36397108,2255,972,50
36401600,36400694,36402748,2054,973,50
36407240,36406334,36409865,3531,974,50
36414575,36413452,36415707,2255,975,50
36420415,36419293,36421547,2254,976,50
36426039,36425133,36428748,3615,977,50
36433240,36432335,36434588,2253,978,50
36439080,36438174,36440429,2255,979,50
36444921,36444015,36446270,2255,980,50
36450762,36449857,36452838,2981,981,50
36457330,36456425,36459638,3213,982,50
36464130,36463225,36465467,2242,983,50
36469959,36469053,36471613,2560,984,50
36476106,36475200,36477760,2560,985,50
36482252,36481347,36484875,3528,986,50
36489367,36488462,36490716,2254,987,50
36495207,36494302,36496946,2644,988,50
36501655,36500533,36502787,2254,989,50
36507279,36506373,36508628,2255,990,50
36513120,36512214,36514469,2255,991,50
36518961,36518055,36521037,2982,992,50
36525747,36524624,36526879,2255,993,50
36531370,36530465,36533445,2980,994,50
36537937,36537032,36539286,2254,995,50
36543778,36542872,36544926,2054,996,50
36549418,36548512,36550756,2244,997,50
36555247,36554342,36556585,2243,998,50
36561077,36560172,36563701,3529,999,50
36568192,36567287,36569541,2254,1000,50
36574121,36573216,36575459,2243,1001,50
36580040,36579134,36581926,2792,1002,50
36586508,36585602,36588711,3109,1003,50
36593293,36592387,36594863,2476,1004,50
36599444,36598538,36601330,2792,1005,50
36606128,36605006,36607260,2254,1006,50
36611841,36610935,36614149,3214,1007,50
36618731,36617825,36620301,2476,1008,50
36624882,36623976,36626135,2159,1009,50
36630715,36629810,36633256,3446,1010,50
36637838,36636932,36640378,3446,1011,50
36644960,36644054,36646846,2792,1012,50
36651427,36650521,36652680,2159,1013,50
36657261,36656355,36658610,2255,1014,50
36663191,36662285,36664529,2244,1015,50
36669109,36668204,36670362,2158,1016,50
36674943,36674037,36676829,2792,1017,50
36681627,36680505,36682759,2254,1018,50
36687340,36686434,36688993,2559,1019,50
36693574,36692668,36695460,2792,1020,50
36700041,36699136,36702582,3446,1021,50
36707164,36706258,36708513,2255,1022,50
36713094,36712188,36714443,2255,1023,50
36719023,36718118,36720372,2254,1024,50
36724953,36724047,36726289,2242,1025,50
36730870,36729964,36732219,2255,1026,50
36736800,36735894,36738770,2876,1027,50
36743352,36742446,36745554,3108,1028,50
36750134,36749229,36752337,3108,1029,50
36756919,36756013,36758268,2255,1030,50
36762849,36761943,36764820,2877,1031,50
36769401,36768495,36771604,3109,1032,50
36776402,36775280,36777534,2254,1033,50
36782115,36781209,36783464,2255,1034,50
36788044,36787139,36789697,2558,1035,50
36794279,36793373,36795531,2158,1036,50
36800112,36799206,36801680,2474,1037,50
36806261,36805355,36808463,3108,1038,50
36813045,36812139,36814298,2159,1039,50
36818879,36817973,36820448,2475,1040,50
36825029,36824123,36826378,2255,1041,50
36830958,36830053,36832612,2559,1042,50
36837193,36836287,36838761,2474,1043,50
36843342,36842436,36845544,3108,1044,50
36850342,36849220,36851474,2254,1045,50
36856055,36855149,36858679,3530,1046,50
36863261,36862355,36865463,3108,1047,50
36870262,36869139,36871394,2255,1048,50
36875973,36875068,36877627,2559,1049,50
36882207,36881302,36883556,2254,1050,50
36888137,36887231,36889474,2243,1051,50
36894055,36893149,36895941,2792,1052,50
36900523,36899617,36901871,2254,1053,50
36906669,36905546,36907801,2255,1054,50
36912381,36911476,36915006,3530,1055,50
36919588,36918682,36921790,3108,1056,50
36926371,36925466,36927624,2158,1057,50
36932421,36931299,36933553,2254,1058,50
36938134,36937228,36940759,3531,1059,50
36945341,36944435,36946909,2474,1060,50
36951706,36950584,36952838,2254,1061,50
36957419,36956513,36959073,2560,1062,50
36963654,36962748,36965857,3109,1063,50
36970438,36969532,36972008,2476,1064,50
36976589,36975683,36977938,2255,1065,50
36982519,36981613,36984490,2877,1066,50
36989071,36988166,36991611,3445,1067,50
36996408,36995286,36997540,2254,1068,50
37002120,37001215,37004745,3530,1069,50
37009327,37008421,37010897,2476,1070,50
37015478,37014572,37016731,2159,1071,50
37021312,37020406,37022882,2476,1072,50
37027462,37026557,37029031,2474,1073,50
37033612,37032706,37035498,2792,1074,50
37040297,37039174,37041429,2255,1075,50
37046010,37045104,37047359,2255,1076,50
37051939,37051034,37053275,2241,1077,50
37057855,37056950,37059741,2791,1078,50
37064323,37063417,37065672,2255,1079,50
37070252,37069347,37071589,2242,1080,50
37076387,37075264,37077519,2255,1081,50
37082100,37081194,37083448,2254,1082,50
37088028,37087123,37090653,3530,1083,50
37095235,37094329,37096584,2255,1084,50
37101165,37100259,37103789,3530,1085,50
37108371,37107465,37110574,3109,1086,50
37115156,37114250,37116505,2255,1087,50
37121086,37120180,37122435,2255,1088,50
37127016,37126110,37128353,2243,1089,50
37132933,37132028,37134282,2254,1090,50
37138863,37137957,37140212,2255,1091,50
37144793,37143887,37146764,2877,1092,50
37151346,37150440,37153231,2791,1093,50
37157813,37156907,37159162,2255,1094,50
37163743,37162837,37165080,2243,1095,50
37169660,37168755,37172200,3445,1096,50
37176781,37175875,37179321,3446,1097,50
37183903,37182997,37185252,2255,1098,50
37189833,37188927,37192457,3530,1099,50
37197256,37196133,37198388,2255,1100,50
37202969,37202063,37204623,2560,1101,50
37209204,37208298,37210553,2255,1102,50
37215134,37214228,37216471,2243,1103,50
37221052,37220146,37223591,3445,1104,50
37228172,37227266,37229521,2255,1105,50
37234102,37233196,37235754,2558,1106,50
37240335,37239429,37242875,3446,1107,50
37247674,37246551,37248806,2255,1108,50
37253387,37252481,37255695,3214,1109,50
37260277,37259371,37262163,2792,1110,50
37266745,37265839,37268314,2475,1111,50
37272894,37271989,37274243,2254,1112,50
37278824,37277918,37280478,2560,1113,50
37285059,37284153,37286408,2255,1114,50
37290989,37290083,37292338,2255,1115,50
37296919,37296013,37298572,2559,1116,50
37303153,37302247,37305039,2792,1117,50
37309620,37308715,37310873,2158,1118,50
37315454,37314548,37317339,2791,1119,50
37321921,37321015,37323173,2158,1120,50
37327754,37326848,37329103,2255,1121,50
37333684,37332778,37335654,2876,1122,50
37340236,37339330,37341585,2255,1123,50
37346166,37345260,37348137,2877,1124,50
37352719,37351813,37354068,2255,1125,50
37358648,37357743,37360618,2875,1126,50
37365199,37364294,37366769,2475,1127,50
37371349,37370444,37373552,3108,1128,50
37378133,37377227,37379386,2159,1129,50
37384183,37383061,37385315,2254,1130,50
37389896,37388990,37392520,3530,1131,50
37397102,37396196,37399641,3445,1132,50
37404222,37403317,37405571,2254,1133,50
37410152,37409246,37411490,2244,1134,50
37416071,37415165,37417640,2475,1135,50
37422221,37421315,37424761,3446,1136,50
37429343,37428437,37430911,2474,1137,50
37435491,37434586,37436743,2157,1138,50
37441323,37440418,37443524,3106,1139,50
37448105,37447199,37449674,2475,1140,50
37454255,37453349,37456457,3108,1141,50
37461039,37460133,37462388,2255,1142,50
37466969,37466063,37468318,2255,1143,50
37472899,37471993,37474869,2876,1144,50
37479450,37478545,37481336,2791,1145,50
37485918,37485012,37487267,2255,1146,50
37491848,37490942,37493818,2876,1147,50
37498617,37497494,37499749,2255,1148,50
37504329,37503424,37506637,3213,1149,50
37511218,37510313,37513421,3108,1150,50
37518220,37517097,37519352,2255,1151,50
37523933,37523027,37525282,2255,1152,50
37529862,37528957,37531831,2874,1153,50
37536413,37535507,37537762,2255,1154,50
37542343,37541437,37543692,2255,1155,50
37548273,37547367,37550581,3214,1156,50
37555163,37554257,37557702,3445,1157,50
37562284,37561378,37563633,2255,1158,50
37568214,37567308,37569552,2244,1159,50
37574133,37573227,37576674,3447,1160,50
37581256,37580350,37582826,2476,1161,50
37587407,37586501,37588977,2476,1162,50
37593775,37592652,37594907,2255,1163,50
37599704,37598582,37600836,2254,1164,50
37605417,37604511,37607725,3214,1165,50
37612308,37611401,37613657,2256,1166,50
37618238,37617332,37620546,3214,1167,50
37625127,37624221,37626476,2255,1168,50
37631056,37630151,37632404,2253,1169,50
37636985,37636079,37639271,3192,1170,50
37643853,37642947,37646372,3425,1171,50
37650954,37650048,37653494,3446,1172,50
37658076,37657170,37659962,2792,1173,50
37664543,37663638,37667083,3445,1174,50
37671665,37670759,37672918,2159,1175,50
37677499,37676593,37678848,2255,1176,50
37683429,37682523,37684777,2254,1177,50
37689358,37688452,37691666,3214,1178,50
37696247,37695341,37698448,3107,1179,50
37703028,37702123,37704913,2790,1180,50
37709495,37708589,37710844,2255,1181,50
37715425,37714519,37716774,2255,1182,50
37721355,37720449,37723009,2560,1183,50
37727591,37726685,37728940,2255,1184,50
37733521,37732615,37735829,3214,1185,50
37740409,37739504,37741758,2254,1186,50
37746339,37745433,37748310,2877,1187,50
37752892,37751986,37754241,2255,1188,50
37758821,37757916,37761446,3530,1189,50
37766027,37765121,37768567,3446,1190,50
37773148,37772242,37775687,3445,1191,50
37780267,37779362,37781616,2254,1192,50
37786197,37785291,37788821,3530,1193,50
37793402,37792497,37794751,2254,1194,50
37799331,37798426,37800680,2254,1195,50
37805261,37804355,37806610,2255,1196,50
37811191,37810285,37812540,2255,1197,50
37817121,37816215,37819429,3214,1198,50
37824011,37823105,37825264,2159,1199,50
37830061,37828939,37831193,2254,1200,50
37835773,37834868,37837744,2876,1201,50
37842325,37841420,37844528,3108,1202,50
37849326,37848204,37850458,2254,1203,50
37855039,37854133,37856387,2254,1204,50
37860968,37860062,37863255,3193,1205,50
37867837,37866931,37869407,2476,1206,50
37873988,37873082,37876529,3447,1207,50
37881328,37880205,37882460,2255,1208,50
37887040,37886135,37888389,2254,1209,50
37892970,37892064,37895277,3213,1210,50
37899859,37898953,37901429,2476,1211,50
37906227,37905104,37907359,2255,1212,50
37911940,37911034,37913911,2877,1213,50
37918493,37917587,37919842,2255,1214,50
37924639,37923517,37925771,2254,1215,50
37930352,37929446,37931689,2243,1216,50
37936270,37935364,37937619,2255,1217,50
37942199,37941294,37943852,2558,1218,50
37948649,37947527,37949781,2254,1219,50
37954362,37953456,37956015,2559,1220,50
37960596,37959690,37962482,2792,1221,50
37967281,37966158,37968413,2255,1222,50
37973210,37972088,37974342,2254,1223,50
37978923,37978017,37981231,3214,1224,50
37985813,37984907,37987382,2475,1225,50
37991963,37991057,37993312,2255,1226,50
37998110,37996987,37999242,2255,1227,50
38003823,38002917,38005794,2877,1228,50
38010376,38009470,38011725,2255,1229,50
38016523,38015400,38017655,2255,1230,50
38022236,38021330,38023585,2255,1231,50
38028166,38027260,38030473,3213,1232,50
38035055,38034149,38036404,2255,1233,50
38040985,38040079,38043292,3213,1234,50
38047873,38046967,38050392,3425,1235,50
38054974,38054068,38057493,3425,1236,50
38062075,38061169,38064594,3425,1237,50
38069176,38068270,38071378,3108,1238,50
38075960,38075054,38077846,2792,1239,50
38082428,38081522,38083681,2159,1240,50
38088262,38087356,38089514,2158,1241,50
38094095,38093189,38095444,2255,1242,50
38100025,38099119,38101679,2560,1243,50
38106261,38105355,38107610,2255,1244,50
38112191,38111285,38114162,2877,1245,50
38118744,38117838,38121263,3425,1246,50
38125845,38124939,38127731,2792,1247,50
38132313,38131407,38134832,3425,1248,50
38139413,38138508,38141616,3108,1249,50
38146198,38145292,38147547,2255,1250,50
38152127,38151222,38154098,2876,1251,50
38158680,38157774,38159932,2158,1252,50
38164513,38163607,38166082,2475,1253,50
38170880,38169757,38172012,2255,1254,50
38176810,38175687,38177942,2255,1255,50
38182522,38181617,38183871,2254,1256,50
38188452,38187546,38189801,2255,1257,50
38194382,38193476,38195731,2255,1258,50
38200312,38199406,38202283,2877,1259,50
38206865,38205959,38208118,2159,1260,50
38212699,38211793,38214585,2792,1261,50
38219383,38218261,38220515,2254,1262,50
38225096,38224190,38227404,3214,1263,50
38231986,38231080,38234505,3425,1264,50
38239087,38238181,38240436,2255,1265,50
38245017,38244111,38247325,3214,1266,50
38251906,38251001,38253159,2158,1267,50
38257741,38256835,38259090,2255,1268,50
38263671,38262765,38265642,2877,1269,50
38270224,38269318,38271794,2476,1270,50
38276375,38275469,38278916,3447,1271,50
38283498,38282592,38285699,3107,1272,50
38290281,38289375,38291851,2476,1273,50
38296432,38295526,38298635,3109,1274,50
38303217,38302311,38305103,2792,1275,50
38309685,38308779,38312204,3425,1276,50
38316786,38315880,38318989,3109,1277,50
38323570,38322665,38324919,2254,1278,50
38329501,38328595,38330850,2255,1279,50
38335431,38334525,38337718,3193,1280,50
38342300,38341394,38343869,2475,1281,50
38348667,38347544,38349799,2255,1282,50
38354379,38353474,38356349,2875,1283,50
38360931,38360025,38362280,2255,1284,50
38366861,38365955,38368831,2876,1285,50
38373413,38372507,38374762,2255,1286,50
38379560,38378437,38380692,2255,1287,50
38385273,38384367,38387897,3530,1288,50
38392479,38391573,38393732,2159,1289,50
38398313,38397407,38399882,2475,1290,50
38404464,38403558,38405813,2255,1291,50
38410394,38409488,38412702,3214,1292,50
38417284,38416378,38418633,2255,1293,50
38423214,38422308,38425522,3214,1294,50
38430104,38429198,38431453,2255,1295,50
38436034,38435128,38438342,3214,1296,50
38442923,38442017,38444272,2255,1297,50
38449069,38447947,38450201,2254,1298,50
38454782,38453876,38456752,2876,1299,50
38461334,38460428,38462587,2159,1300,50
38467168,38466262,38468517,2255,1301,50
38473097,38472192,38474445,2253,1302,50
38479026,38478120,38480364,2244,1303,50
38484945,38484039,38486197,2158,1304,50
38490778,38489872,38492030,2158,1305,50
38496611,38495705,38498497,2792,1306,50
38503295,38502173,38504427,2254,1307,50
38509008,38508102,38510662,2560,1308,50
38515243,38514337,38516592,2255,1309,50
38521173,38520267,38522510,2243,1310,50
38527090,38526185,38529630,3445,1311,50
38534211,38533305,38536097,2792,1312,50
38540896,38539773,38542028,2255,1313,50
38546608,38545703,38547957,2254,1314,50
38552538,38551632,38555163,3531,1315,50
38559745,38558839,38562285,3446,1316,50
38566866,38565960,38569405,3445,1317,50
38573987,38573081,38575336,2255,1318,50
38580134,38579011,38581266,2255,1319,50
38585847,38584941,38587817,2876,1320,50
38592398,38591493,38594284,2791,1321,50
38599083,38597960,38600215,2255,1322,50
38604795,38603890,38606448,2558,1323,50
38611029,38610123,38613232,3109,1324,50
38617813,38616907,38619066,2159,1325,50
38623647,38622741,38624900,2159,1326,50
38629480,38628575,38630829,2254,1327,50
38635410,38634504,38636759,2255,1328,50
38641340,38640434,38642689,2255,1329,50
38647270,38646364,38649578,3214,1330,50
38654159,38653254,38655728,2474,1331,50
38660309,38659403,38661879,2476,1332,50
38666460,38665554,38667809,2255,1333,50
38672390,38671484,38674043,2559,1334,50
38678624,38677718,38680826,3108,1335,50
38685406,38684501,38687946,3445,1336,50
38692528,38691622,38694098,2476,1337,50
38698679,38697773,38700881,3108,1338,50
38705463,38704557,38707665,3108,1339,50
38712247,38711341,38714132,2791,1340,50
38718714,38717808,38720063,2255,1341,50
38724644,38723738,38725982,2244,1342,50
38730563,38729657,38731912,2255,1343,50
38736709,38735587,38737841,2254,1344,50
38742422,38741516,38743771,2255,1345,50
38748351,38747446,38750975,3529,1346,50
38755557,38754651,38756809,2158,1347,50
38761390,38760484,38762739,2255,1348,50
38767320,38766414,38769291,2877,1349,50
38773872,38772966,38775221,2255,1350,50
38780019,38778896,38781151,2255,1351,50
38785731,38784826,38787384,2558,1352,50
38792182,38791059,38793314,2255,1353,50
38797895,38796989,38799244,2255,1354,50
38803825,38802919,38805174,2255,1355,50
38809755,38808849,38811104,2255,1356,50
38815685,38814779,38817656,2877,1357,50
38822236,38821331,38824776,3445,1358,50
38829358,38828452,38830928,2476,1359,50
38835726,38834603,38836858,2255,1360,50
38841439,38840533,38842788,2255,1361,50
38847368,38846463,38848716,2253,1362,50
38853297,38852391,38855268,2877,1363,50
38859850,38858944,38861199,2255,1364,50
38865779,38864874,38868402,3528,1365,50
38872984,38872078,38874237,2159,1366,50
38878818,38877912,38880704,2792,1367,50
38885286,38884380,38886635,2255,1368,50
38891216,38890310,38892869,2559,1369,50
38897667,38896545,38898799,2254,1370,50
38903596,38902474,38904728,2254,1371,50
38909309,38908403,38910657,2254,1372,50
38915237,38914332,38916585,2253,1373,50
38921166,38920260,38923791,3531,1374,50
38928373,38927467,38929943,2476,1375,50
38934524,38933618,38935873,2255,1376,50
38940454,38939548,38942741,3193,1377,50
38947323,38946417,38949208,2791,1378,50
38953790,38952884,38955360,2476,1379,50
38959940,38959035,38961289,2254,1380,50
38965869,38964964,38967217,2253,1381,50
38971797,38970892,38974083,3191,1382,50
38978664,38977759,38980013,2254,1383,50
38984594,38983688,38986881,3193,1384,50
38991463,38990557,38993349,2792,1385,50
38997931,38997025,39000134,3109,1386,50
39004933,39003810,39006065,2255,1387,50
39010646,39009740,39011983,2243,1388,50
39016781,39015658,39017913,2255,1389,50
39022494,39021588,39024465,2877,1390,50
39029047,39028141,39031249,3108,1391,50
39035831,39034925,39038034,3109,1392,50
39042833,39041710,39043965,2255,1393,50
39048546,39047640,39049895,2255,1394,50
39054476,39053570,39057101,3531,1395,50
39061899,39060777,39063031,2254,1396,50
39067612,39066706,39069266,2560,1397,50
39073847,39072942,39075417,2475,1398,50
39079998,39079092,39082201,3109,1399,50
39086782,39085876,39088035,2159,1400,50
39092615,39091710,39093868,2158,1401,50
39098449,39097543,39099798,2255,1402,50
39104379,39103473,39106350,2877,1403,50
39110932,39110026,39112184,2158,1404,50
39116982,39115859,39118114,2255,1405,50
39122695,39121789,39125320,3531,1406,50
39129902,39128996,39131251,2255,1407,50
39135832,39134926,39137181,2255,1408,50
39141762,39140856,39143416,2560,1409,50
39147998,39147092,39149347,2255,1410,50
39153929,39153023,39155900,2877,1411,50
39160482,39159576,39161831,2255,1412,50
39166412,39165506,39168066,2560,1413,50
39172648,39171742,39175188,3446,1414,50
39179986,39178864,39181118,2254,1415,50
39185699,39184793,39187037,2244,1416,50
39191618,39190712,39192871,2159,1417,50
39197453,39196547,39198802,2255,1418,50
39203383,39202477,39206008,3531,1419,50
39210807,39209684,39211939,2255,1420,50
39216736,39215614,39217868,2254,1421,50
39222449,39221543,39225073,3530,1422,50
39229655,39228749,39231224,2475,1423,50
39235805,39234899,39238008,3109,1424,50
39242590,39241684,39243939,2255,1425,50
39248520,39247614,39251144,3530,1426,50
39255726,39254820,39257928,3108,1427,50
39262727,39261604,39263859,2255,1428,50
39268440,39267534,39269778,2244,1429,50
39274359,39273453,39276245,2792,1430,50
39281043,39279921,39282175,2254,1431,50
39286756,39285850,39288093,2243,1432,50
39292673,39291768,39294022,2254,1433,50
39298603,39297697,39299952,2255,1434,50
39304533,39303627,39306186,2559,1435,50
39310768,39309862,39312971,3109,1436,50
39317553,39316647,39319123,2476,1437,50
39323703,39322798,39326242,3444,1438,50
39330822,39329917,39332708,2791,1439,50
39337289,39336383,39339175,2792,1440,50
39343756,39342850,39346274,3424,1441,50
39350856,39349950,39352425,2475,1442,50
39357006,39356100,39358355,2255,1443,50
39362936,39362030,39364285,2255,1444,50
39368866,39367960,39371490,3530,1445,50
39376071,39375165,39378272,3107,1446,50
39382854,39381948,39384106,2158,1447,50
39388686,39387781,39390035,2254,1448,50
39394832,39393710,39395964,2254,1449,50
39400545,39399639,39402516,2877,1450,50
39407315,39406192,39408447,2255,1451,50
39413027,39412122,39414376,2254,1452,50
39418957,39418051,39421265,3214,1453,50
39425846,39424941,39427195,2254,1454,50
39431776,39430870,39433747,2877,1455,50
39438544,39437422,39439676,2254,1456,50
39444257,39443351,39446565,3214,1457,50
39451145,39450240,39452494,2254,1458,50
39457074,39456169,39459044,2875,1459,50
39463842,39462719,39464974,2255,1460,50
39469772,39468649,39470904,2255,1461,50
39475485,39474579,39476821,2242,1462,50
39481402,39480496,39483288,2792,1463,50
39487869,39486963,39490071,3108,1464,50
39494653,39493747,39496223,2476,1465,50
39500803,39499898,39503343,3445,1466,50
39507925,39507019,39510128,3109,1467,50
39514926,39513804,39516058,2254,1468,50
39520639,39519733,39522610,2877,1469,50
39527192,39526286,39529395,3109,1470,50
39533977,39533071,39535326,2255,1471,50
39539907,39539001,39541256,2255,1472,50
39545837,39544931,39547185,2254,1473,50
39551766,39550860,39553104,2244,1474,50
39557685,39556779,39559253,2474,1475,50
39563833,39562928,39566036,3108,1476,50
39570618,39569712,39571967,2255,1477,50
39576547,39575642,39577896,2254,1478,50
39582477,39581571,39584447,2876,1479,50
39589028,39588123,39591569,3446,1480,50
39596151,39595245,39597403,2158,1481,50
39601984,39601078,39604525,3447,1482,50
39609107,39608201,39611625,3424,1483,50
39616207,39615301,39617776,2475,1484,50
39622357,39621451,39623706,2255,1485,50
39628287,39627381,39630912,3531,1486,50
39635494,39634588,39636746,2158,1487,50
39641327,39640421,39643868,3447,1488,50
39648450,39647544,39650335,2791,1489,50
39655134,39654011,39656266,2255,1490,50
39660846,39659941,39663154,3213,1491,50
39667952,39666830,39669084,2254,1492,50
39673665,39672759,39675319,2560,1493,50
39680117,39678995,39681249,2254,1494,50
39685830,39684924,39688454,3530,1495,50
39693035,39692129,39695236,3107,1496,50
39699816,39698911,39701165,2254,1497,50
39705746,39704840,39707094,2254,1498,50
39711675,39710769,39714299,3530,1499,50
39718879,39717974,39720132,2158,1500,50
39724713,39723807,39726599,2792,1501,50
39731181,39730275,39732434,2159,1502,50
39737015,39736109,39738364,2255,1503,50
39742945,39742039,39745569,3530,1504,50
39750151,39749245,39752353,3108,1505,50
39756935,39756029,39759136,3107,1506,50
39763717,39762811,39765287,2476,1507,50
39769868,39768962,39771438,2476,1508,50
39776018,39775113,39778221,3108,1509,50
39782803,39781897,39784056,2159,1510,50
39788637,39787731,39791178,3447,1511,50
39795760,39794854,39797109,2255,1512,50
39801689,39800784,39803027,2243,1513,50
39807608,39806702,39810149,3447,1514,50
39814731,39813825,39816617,2792,1515,50
39821199,39820293,39822768,2475,1516,50
39827565,39826443,39828697,2254,1517,50
39833278,39832372,39834615,2243,1518,50
39839196,39838290,39840545,2255,1519,50
39845126,39844220,39847095,2875,1520,50
39851677,39850771,39852929,2158,1521,50
39857510,39856604,39859713,3109,1522,50
39864511,39863389,39865643,2254,1523,50
39870224,39869318,39871573,2255,1524,50
39876154,39875248,39878125,2877,1525,50
39882707,39881801,39884910,3109,1526,50
39889708,39888586,39890840,2254,1527,50
39895421,39894515,39898045,3530,1528,50
39902627,39901721,39903976,2255,1529,50
39908557,39907651,39909906,2255,1530,50
39914487,39913581,39916141,2560,1531,50
39920723,39919817,39922072,2255,1532,50
39926653,39925747,39928002,2255,1533,50
39932584,39931678,39934238,2560,1534,50
39938821,39937914,39941340,3426,1535,50
39945923,39945016,39947272,2256,1536,50
39951853,39950947,39954478,3531,1537,50
39959059,39958154,39960629,2475,1538,50
39965426,39964304,39966558,2254,1539,50
39971139,39970233,39972488,2255,1540,50
39977068,39976163,39979376,3213,1541,50
39983957,39983051,39986498,3447,1542,50
39991296,39990174,39992428,2254,1543,50
39997008,39996103,39998357,2254,1544,50
40002939,40002033,40004909,2876,1545,50
40009491,40008585,40011693,3108,1546,50
40016274,40015368,40017844,2476,1547,50
40022425,40021519,40024627,3108,1548,50
40029208,40028303,40030778,2475,1549,50
40035359,40034453,40037900,3447,1550,50
40042482,40041576,40043735,2159,1551,50
40048316,40047410,40050202,2792,1552,50
40054784,40053878,40056670,2792,1553,50
40061469,40060346,40062601,2255,1554,50
40067181,40066276,40068530,2254,1555,50
40073111,40072205,40075735,3530,1556,50
40080317,40079411,40081569,2158,1557,50
40086150,40085244,40088689,3445,1558,50
40093488,40092365,40094620,2255,1559,50
40099201,40098295,40100550,2255,1560,50
40105131,40104225,40106467,2242,1561,50
40111048,40110142,40113251,3109,1562,50
40117833,40116927,40119403,2476,1563,50
40124201,40123078,40125333,2255,1564,50
40129914,40129008,40131883,2875,1565,50
40136465,40135559,40138668,3109,1566,50
40143250,40142344,40145136,2792,1567,50
40149717,40148811,40150970,2159,1568,50
40155551,40154645,40156900,2255,1569,50
40161481,40160575,40162830,2255,1570,50
40167627,40166505,40168759,2254,1571,50
40173557,40172434,40174689,2255,1572,50
40179270,40178364,40181578,3214,1573,50
40186159,40185254,40188045,2791,1574,50
40192627,40191721,40194197,2476,1575,50
40198994,40197872,40200126,2254,1576,50
40204923,40203801,40206055,2254,1577,50
40210636,40209730,40212606,2876,1578,50
40217187,40216282,40218536,2254,1579,50
40223117,40222211,40225404,3193,1580,50
40229986,40229080,40231335,2255,1581,50
40235916,40235010,40237265,2255,1582,50
40241846,40240940,40244154,3214,1583,50
40248735,40247830,40250084,2254,1584,50
40254665,40253759,40256635,2876,1585,50
40261217,40260311,40262786,2475,1586,50
40267367,40266461,40268716,2255,1587,50
40273297,40272391,40274646,2255,1588,50
40279444,40278321,40280576,2255,1589,50
40285374,40284251,40286506,2255,1590,50
40291087,40290181,40292436,2255,1591,50
40297017,40296112,40299325,3213,1592,50
40303907,40303001,40306427,3426,1593,50
40311225,40310103,40312357,2254,1594,50
40316938,40316032,40319246,3214,1595,50
40323828,40322922,40325397,2475,1596,50
40329978,40329072,40332180,3108,1597,50
40336762,40335856,40338648,2792,1598,50
40343230,40342324,40344579,2255,1599,50
40349160,40348254,40350509,2255,1600,50
40355091,40354185,40357378,3193,1601,50
40361959,40361054,40364162,3108,1602,50
40368744,40367838,40370629,2791,1603,50
40375210,40374305,40377749,3444,1604,50
40382331,40381425,40383680,2255,1605,50
40388262,40387356,40389611,2255,1606,50
40394192,40393286,40395529,2243,1607,50
40400111,40399205,40402313,3108,1608,50
40406894,40405989,40409435,3446,1609,50
40414017,40413111,40415587,2476,1610,50
40420169,40419263,40422055,2792,1611,50
40426638,40425732,40427987,2255,1612,50
40432569,40431663,40434877,3214,1613,50
40439459,40438554,40441029,2475,1614,50
40445611,40444705,40448152,3447,1615,50
40452734,40451828,40454304,2476,1616,50
40458886,40457980,40460772,2792,1617,50
40465354,40464448,40466703,2255,1618,50
40471284,40470379,40472938,2559,1619,50
40477520,40476614,40478772,2158,1620,50
40483353,40482448,40484922,2474,1621,50
40489504,40488598,40490853,2255,1622,50
40495435,40494529,40497089,2560,1623,50
40501672,40500766,40502925,2159,1624,50
40507506,40506601,40508855,2254,1625,50
40513437,40512531,40516061,3530,1626,50
40520644,40519738,40522529,2791,1627,50
40527112,40526206,40529315,3109,1628,50
40533898,40532992,40535467,2475,1629,50
40540049,40539143,40542569,3426,1630,50
40547152,40546246,40549355,3109,1631,50
40553938,40553032,40555190,2158,1632,50
40559772,40558866,40561121,2255,1633,50
40565703,40564797,40567039,2242,1634,50
40571620,40570715,40572969,2254,1635,50
40577551,40576645,40578900,2255,1636,50
40583481,40582576,40585135,2559,1637,50
40589717,40588811,40591603,2792,1638,50
40596185,40595279,40597534,2255,1639,50
40602116,40601210,40603770,2560,1640,50
40608352,40607446,40609701,2255,1641,50
40614282,40613377,40616907,3530,1642,50
40621489,40620583,40622838,2255,1643,50
40627421,40626514,40628770,2256,1644,50
40633569,40632446,40634701,2255,1645,50
40639283,40638377,40641592,3215,1646,50
40646174,40645268,40648377,3109,1647,50
40652959,40652053,40654845,2792,1648,50
40659428,40658522,40661947,3425,1649,50
40666529,40665623,40667782,2159,1650,50
40672580,40671458,40673712,2254,1651,50
40678511,40677388,40679643,2255,1652,50
40684225,40683319,40685878,2559,1653,50
40690460,40689554,40691809,2255,1654,50
40696390,40695485,40699015,3530,1655,50
40703597,40702691,40705799,3108,1656,50
40710599,40709476,40711731,2255,1657,50
40716313,40715407,40717967,2560,1658,50
40722548,40721643,40723897,2254,1659,50
40728479,40727573,40731104,3531,1660,50
40735687,40734781,40737036,2255,1661,50
40741618,40740712,40743271,2559,1662,50
40747853,40746947,40750371,3424,1663,50
40754953,40754048,40757155,3107,1664,50
40761738,40760832,40763308,2476,1665,50
40767889,40766984,40769775,2791,1666,50
40774357,40773451,40775706,2255,1667,50
40780288,40779382,40782575,3193,1668,50
40787375,40786252,40788507,2255,1669,50
40793089,40792183,40794438,2255,1670,50
40799020,40798114,40800674,2560,1671,50
40805255,40804350,40807141,2791,1672,50
40811722,40810817,40813290,2473,1673,50
40817872,40816966,40819441,2475,1674,50
40824023,40823117,40826541,3424,1675,50
40831124,40830218,40833644,3426,1676,50
40838227,40837321,40840747,3426,1677,50
40845546,40844423,40846678,2255,1678,50
40851260,40850354,40853230,2876,1679,50
40857813,40856907,40859698,2791,1680,50
40864281,40863375,40865534,2159,1681,50
40870116,40869210,40871685,2475,1682,50
40876267,40875361,40878153,2792,1683,50
40882736,40881830,40884305,2475,1684,50
40888887,40887981,40891090,3109,1685,50
40895673,40894767,40897022,2255,1686,50
40901604,40900698,40903258,2560,1687,50
40907841,40906935,40909726,2791,1688,50
40914308,40913402,40915657,2255,1689,50
40920239,40919333,40922864,3531,1690,50
40927447,40926541,40929967,3426,1691,50
40934549,40933643,40935801,2158,1692,50
40940383,40939477,40941636,2159,1693,50
40946218,40945312,40948421,3109,1694,50
40953004,40952098,40954353,2255,1695,50
40958935,40958029,40960905,2876,1696,50
40965488,40964582,40967691,3109,1697,50
40972491,40971368,40973623,2255,1698,50
40978206,40977300,40979860,2560,1699,50
40984443,40983537,40985697,2160,1700,50
40990279,40989373,40991848,2475,1701,50
40996431,40995525,40997780,2255,1702,50
41002580,41001457,41003712,2255,1703,50
41008294,41007389,41010919,3530,1704,50
41015503,41014597,41017073,2476,1705,50
41021872,41020750,41023004,2254,1706,50
41027586,41026681,41029240,2559,1707,50
41033822,41032917,41035171,2254,1708,50
41039971,41038848,41041103,2255,1709,50
41045685,41044780,41047340,2560,1710,50
41051923,41051017,41053272,2255,1711,50
41057855,41056949,41060143,3194,1712,50
41064727,41063821,41066076,2255,1713,50
41070659,41069753,41072008,2255,1714,50
41076590,41075685,41078898,3213,1715,50
41083481,41082575,41084830,2255,1716,50
41089629,41088507,41090761,2254,1717,50
41095343,41094438,41097631,3193,1718,50
41102214,41101308,41104100,2792,1719,50
41108682,41107777,41109935,2158,1720,50
41114518,41113612,41115867,2255,1721,50
41120450,41119544,41122421,2877,1722,50
41127005,41126099,41129525,3426,1723,50
41134109,41133203,41135458,2255,1724,50
41140041,41139135,41141695,2560,1725,50
41146278,41145372,41148798,3426,1726,50
41153598,41152476,41154730,2254,1727,50
41159313,41158407,41160662,2255,1728,50
41165244,41164339,41167215,2876,1729,50
41171798,41170892,41174318,3426,1730,50
41178901,41177995,41181103,3108,1731,50
41185688,41184781,41187573,2792,1732,50
41192156,41191250,41194358,3108,1733,50
41198941,41198036,41200290,2254,1734,50
41205090,41203967,41206223,2256,1735,50
41210806,41209900,41213094,3194,1736,50
41217678,41216772,41220197,3425,1737,50
41224780,41223874,41226129,2255,1738,50
41230712,41229806,41232367,2561,1739,50
41236951,41236045,41239471,3426,1740,50
41244053,41243148,41246256,3108,1741,50
41250840,41249934,41253043,3109,1742,50
41257627,41256721,41259829,3108,1743,50
41264413,41263507,41265666,2159,1744,50
41270249,41269343,41271818,2475,1745,50
41276402,41275495,41278921,3426,1746,50
41283505,41282599,41285074,2475,1747,50
41289656,41288751,41291005,2254,1748,50
41295588,41294682,41297876,3194,1749,50
41302460,41301554,41304347,2793,1750,50
41308931,41308025,41311134,3109,1751,50
41315717,41314812,41316969,2157,1752,50
41321551,41320646,41322805,2159,1753,50
41327387,41326482,41328736,2254,1754,50
41333535,41332413,41334667,2254,1755,50
41339250,41338344,41340599,2255,1756,50
41345182,41344276,41346531,2255,1757,50
41351114,41350208,41352769,2561,1758,50
41357352,41356446,41358701,2255,1759,50
41363284,41362378,41365909,3531,1760,50
41370492,41369586,41371841,2255,1761,50
41376424,41375518,41378395,2877,1762,50
41382978,41382072,41384327,2255,1763,50
41389126,41388004,41390259,2255,1764,50
41394842,41393936,41396180,2244,1765,50
41400763,41399857,41402112,2255,1766,50
41406695,41405789,41408666,2877,1767,50
41413250,41412344,41415453,3109,1768,50
41420037,41419131,41421923,2792,1769,50
41426507,41425601,41427761,2160,1770,50
41432344,41431438,41433598,2160,1771,50
41438180,41437275,41440699,3424,1772,50
41445282,41444377,41447484,3107,1773,50
41452067,41451161,41453416,2255,1774,50
41457999,41457093,41459337,2244,1775,50
41463920,41463014,41465174,2160,1776,50
41469757,41468851,41471107,2256,1777,50
41475689,41474784,41477343,2559,1778,50
41482142,41481020,41483275,2255,1779,50
41488074,41486952,41489206,2254,1780,50
41493789,41492883,41495444,2561,1781,50
41500027,41499121,41501597,2476,1782,50
41506180,41505274,41508382,3108,1783,50
41512966,41512060,41514536,2476,1784,50
41519118,41518213,41521004,2791,1785,50
41525587,41524681,41528107,3426,1786,50
41532691,41531785,41534578,2793,1787,50
41539161,41538255,41540510,2255,1788,50
41545092,41544187,41546747,2560,1789,50
41551331,41550425,41552680,2255,1790,50
41557263,41556357,41558917,2560,1791,50
41563501,41562595,41564850,2255,1792,50
41569433,41568527,41570771,2244,1793,50
41575354,41574448,41577240,2792,1794,50
41581823,41580917,41583173,2256,1795,50
41587756,41586850,41589411,2561,1796,50
41593995,41593089,41595249,2160,1797,50
41599832,41598926,41602036,3110,1798,50
41606619,41605714,41611671,5957,1799,50
41616255,41615349,41617509,2160,1800,50
41622092,41621186,41623344,2158,1801,50
41627927,41627021,41630447,3426,1802,50
41635030,41634125,41636917,2792,1803,50
41641500,41640594,41643703,3109,1804,50
41648502,41647380,41649634,2254,1805,50
41654217,41653311,41656842,3531,1806,50
41661641,41660519,41662774,2255,1807,50
41667356,41666451,41669644,3193,1808,50
41674228,41673322,41675577,2255,1809,50
41680159,41679254,41682784,3530,1810,50
41687367,41686461,41689887,3426,1811,50
41694470,41693564,41696040,2476,1812,50
41700623,41699717,41701972,2255,1813,50
41706554,41705649,41707903,2254,1814,50
41712486,41711580,41714457,2877,1815,50
41719041,41718135,41720390,2255,1816,50
41725189,41724067,41726322,2255,1817,50
41730905,41729999,41732560,2561,1818,50
41737143,41736237,41739663,3426,1819,50
41744247,41743341,41746132,2791,1820,50
41750716,41749810,41752285,2475,1821,50
41756867,41755962,41758121,2159,1822,50
41762704,41761798,41764907,3109,1823,50
41769491,41768585,41771060,2475,1824,50
41775643,41774737,41778163,3426,1825,50
41782747,41781841,41784000,2159,1826,50
41788582,41787677,41789931,2254,1827,50
41794514,41793608,41797139,3531,1828,50
41801940,41800817,41803073,2256,1829,50
41807655,41806750,41809004,2254,1830,50
41813586,41812681,41815874,3193,1831,50
41820458,41819552,41821807,2255,1832,50
41826390,41825484,41828044,2560,1833,50
41832627,41831721,41833881,2160,1834,50
41838681,41837558,41839814,2256,1835,50
41844397,41843491,41846051,2560,1836,50
41850634,41849729,41852204,2475,1837,50
41856786,41855881,41859326,3445,1838,50
41863910,41863004,41865163,2159,1839,50
41869745,41868840,41871094,2254,1840,50
41875677,41874771,41877965,3194,1841,50
41882549,41881643,41883898,2255,1842,50
41888481,41887575,41889830,2255,1843,50
41894413,41893507,41896068,2561,1844,50
41900650,41899745,41903170,3425,1845,50
41907754,41906848,41910274,3426,1846,50
41915075,41913952,41916208,2256,1847,50
41920791,41919885,41922140,2255,1848,50
41926723,41925817,41929011,3194,1849,50
41933595,41932689,41934944,2255,1850,50
41939527,41938621,41942152,3531,1851,50
41946736,41945830,41948938,3108,1852,50
41953737,41952615,41954869,2254,1853,50
41959668,41958546,41960800,2254,1854,50
41965599,41964477,41966731,2254,1855,50
41971314,41970408,41973602,3194,1856,50
41978186,41977280,41980072,2792,1857,50
41984655,41983750,41987174,3424,1858,50
41991757,41990852,41993642,2790,1859,50
41998225,41997319,41999479,2160,1860,50
42004062,42003156,42005411,2255,1861,50
42009994,42009088,42011964,2876,1862,50
42016548,42015642,42017897,2255,1863,50
42022480,42021574,42024451,2877,1864,50
42029035,42028129,42031238,3109,1865,50
42036039,42034916,42037171,2255,1866,50
42041754,42040848,42043103,2255,1867,50
42047686,42046780,42049340,2560,1868,50
42053924,42053017,42056444,3427,1869,50
42061028,42060122,42062282,2160,1870,50
42067082,42065959,42068214,2255,1871,50
42072797,42071891,42074452,2561,1872,50
42079034,42078129,42080287,2158,1873,50
42084870,42083964,42086219,2255,1874,50
42090802,42089896,42092140,2244,1875,50
42096723,42095817,42097976,2159,1876,50
42102559,42101653,42104761,3108,1877,50
42109345,42108439,42111232,2793,1878,50
42115815,42114909,42118334,3425,1879,50
42122918,42122011,42124267,2256,1880,50
42128849,42127944,42130187,2243,1881,50
42134769,42133864,42136972,3108,1882,50
42141556,42140650,42143759,3109,1883,50
42148342,42147437,42150544,3107,1884,50
42155128,42154222,42157015,2793,1885,50
42161599,42160693,42162948,2255,1886,50
42167531,42166625,42169185,2560,1887,50
42173768,42172862,42175654,2792,1888,50
42180238,42179332,42182758,3426,1889,50
42187559,42186436,42188692,2256,1890,50
42193275,42192369,42194624,2255,1891,50
42199207,42198301,42201178,2877,1892,50
42205977,42204855,42207110,2255,1893,50
42211693,42210787,42214318,3531,1894,50
42219118,42217996,42220251,2255,1895,50
42224834,42223928,42226805,2877,1896,50
42231389,42230483,42233909,3426,1897,50
42238493,42237587,42240380,2793,1898,50
42244963,42244057,42246532,2475,1899,50
42251115,42250209,42252464,2255,1900,50
42257046,42256141,42259017,2876,1901,50
42263817,42262695,42264950,2255,1902,50
42269532,42268627,42271187,2560,1903,50
42275770,42274864,42277657,2793,1904,50
42282239,42281334,42283809,2475,1905,50
42288392,42287486,42289961,2475,1906,50
42294544,42293638,42295893,2255,1907,50
42300476,42299570,42302447,2877,1908,50
42307030,42306124,42309550,3426,1909,50
42314133,42313227,42316336,3109,1910,50
42320918,42320013,42322267,2254,1911,50
42326850,42325944,42328199,2255,1912,50
42332998,42331876,42334130,2254,1913,50
42338713,42337807,42340062,2255,1914,50
42344645,42343739,42346299,2560,1915,50
42350882,42349977,42352769,2792,1916,50
42357353,42356447,42358702,2255,1917,50
42363502,42362379,42364634,2255,1918,50
42369434,42368311,42370566,2255,1919,50
42375366,42374243,42376498,2255,1920,50
42381081,42380175,42382736,2561,1921,50
42387319,42386413,42388573,2160,1922,50
42393155,42392250,42395675,3425,1923,50
42400258,42399353,42401607,2254,1924,50
42406190,42405284,42407539,2255,1925,50
42412122,42411216,42414748,3532,1926,50
42419331,42418425,42420584,2159,1927,50
42425384,42424261,42426517,2256,1928,50
42431100,42430194,42432755,2561,1929,50
42437339,42436433,42438593,2160,1930,50
42443176,42442270,42445379,3109,1931,50
42449962,42449056,42451216,2160,1932,50
42456016,42454893,42457148,2255,1933,50
42461731,42460825,42463080,2255,1934,50
42467663,42466757,42469318,2561,1935,50
42474119,42472996,42475252,2256,1936,50
42479834,42478929,42481183,2254,1937,50
42485765,42484860,42488390,3530,1938,50
42492974,42492068,42494860,2792,1939,50
42499444,42498538,42500793,2255,1940,50
42505376,42504470,42506725,2255,1941,50
42511308,42510402,42512657,2255,1942,50
42517240,42516334,42518893,2559,1943,50
42523476,42522570,42526017,3447,1944,50
42530601,42529695,42531950,2255,1945,50
42536533,42535627,42538187,2560,1946,50
42542771,42541865,42544120,2255,1947,50
42548920,42547797,42550052,2255,1948,50
42554634,42553729,42556943,3214,1949,50
42561527,42560621,42562876,2255,1950,50
42567458,42566553,42569766,3213,1951,50
42574349,42573443,42576552,3109,1952,50
42581135,42580229,42583654,3425,1953,50
42588237,42587332,42590439,3107,1954,50
42595022,42594117,42597542,3425,1955,50
42602126,42601220,42603696,2476,1956,50
42608278,42607373,42610797,3424,1957,50
42615380,42614474,42616729,2255,1958,50
42621312,42620406,42623283,2877,1959,50
42627867,42626961,42629753,2792,1960,50
42634335,42633430,42636855,3425,1961,50
42641439,42640533,42642788,2255,1962,50
42647370,42646464,42649341,2877,1963,50
42653925,42653019,42655274,2255,1964,50
42659857,42658951,42661206,2255,1965,50
42665789,42664883,42667126,2243,1966,50
42671709,42670803,42672963,2160,1967,50
42677545,42676639,42678798,2159,1968,50
42683381,42682475,42685584,3109,1969,50
42690166,42689261,42692053,2792,1970,50
42696637,42695731,42697986,2255,1971,50
42702569,42701663,42705194,3531,1972,50
42709777,42708871,42711979,3108,1973,50
42716562,42715656,42717814,2158,1974,50
42722397,42721491,42723746,2255,1975,50
42728328,42727423,42730952,3529,1976,50
42735752,42734629,42736885,2256,1977,50
42741468,42740562,42742817,2255,1978,50
42747400,42746494,42750024,3530,1979,50
42754608,42753702,42756178,2476,1980,50
42760761,42759855,42762647,2792,1981,50
42767229,42766324,42769116,2792,1982,50
42773700,42772794,42774953,2159,1983,50
42779536,42778630,42780789,2159,1984,50
42785372,42784466,42786942,2476,1985,50
42791525,42790619,42792874,2255,1986,50
42797456,42796551,42798805,2254,1987,50
42803388,42802482,42804737,2255,1988,50
42809320,42808414,42810669,2255,1989,50
42815252,42814346,42817877,3531,1990,50
42822460,42821554,42823809,2255,1991,50
42828392,42827486,42830680,3194,1992,50
42835264,42834358,42837151,2793,1993,50
42841734,42840828,42843083,2255,1994,50
42847883,42846760,42849016,2256,1995,50
42853599,42852693,42854948,2255,1996,50
42859531,42858625,42861184,2559,1997,50
42865767,42864861,42867116,2255,1998,50
42871699,42870793,42873353,2560,1999,50
42877936,42877031,42879285,2254,2000,50
42883868,42882962,42886493,3531,2001,50
42891077,42890171,42892426,2255,2002,50
42897009,42896103,42898979,2876,2003,50
42903780,42902657,42904913,2256,2004,50
42909495,42908590,42912120,3530,2005,50
42916703,42915798,42919244,3446,2006,50
42923828,42922922,42925082,2160,2007,50
42929665,42928759,42931014,2255,2008,50
42935597,42934691,42937568,2877,2009,50
42942152,42941246,42944039,2793,2010,50
42948623,42947717,42950826,3109,2011,50
42955627,42954504,42956760,2256,2012,50
42961344,42960438,42963315,2877,2013,50
42967899,42966993,42970418,3425,2014,50
42975002,42974096,42976351,2255,2015,50
42980935,42980029,42982273,2244,2016,50
42987074,42985951,42988207,2256,2017,50
42992790,42991885,42994444,2559,2018,50
42999027,42998121,43000376,2255,2019,50
43004958,43004053,43007266,3213,2020,50
43012067,43010944,43013199,2255,2021,50
43017782,43016876,43019131,2255,2022,50
43023714,43022808,43025063,2255,2023,50
43029646,43028740,43030995,2255,2024,50
43035577,43034672,43037863,3191,2025,50
43042447,43041541,43043699,2158,2026,50
43048499,43047376,43049632,2256,2027,50
43054431,43053309,43055563,2254,2028,50
43060146,43059240,43061800,2560,2029,50
43066384,43065478,43067733,2255,2030,50
43072316,43071410,43073665,2255,2031,50
43078248,43077342,43080219,2877,2032,50
43084803,43083897,43086372,2475,2033,50
43091172,43090050,43092304,2254,2034,50
43096887,43095981,43099175,3194,2035,50
43103759,43102853,43105013,2160,2036,50
43109596,43108690,43111799,3109,2037,50
43116382,43115477,43117731,2254,2038,50
43122314,43121409,43124940,3531,2039,50
43129524,43128618,43132044,3426,2040,50
43136628,43135722,43139148,3426,2041,50
43143732,43142826,43145302,2476,2042,50
43150102,43148979,43151235,2256,2043,50
43155818,43154912,43157167,2255,2044,50
43161751,43160845,43163089,2244,2045,50
43167673,43166767,43169022,2255,2046,50
43173606,43172700,43174955,2255,2047,50
43179538,43178632,43180887,2255,2048,50
43185470,43184564,43186819,2255,2049,50
43191402,43190497,43194028,3531,2050,50
43198612,43197706,43200182,2476,2051,50
43204982,43203859,43206114,2255,2052,50
43210697,43209791,43212046,2255,2053,50
43216630,43215724,43218284,2560,2054,50
43222868,43221962,43224217,2255,2055,50
43228799,43227894,43230770,2876,2056,50
43235570,43234448,43236702,2254,2057,50
43241502,43240380,43242635,2255,2058,50
43247218,43246312,43249505,3193,2059,50
43254089,43253183,43255343,2160,2060,50
43259927,43259021,43261180,2159,2061,50
43265764,43264858,43267113,2255,2062,50
43271696,43270790,43273033,2243,2063,50
43277616,43276710,43280135,3425,2064,50
43284719,43283813,43286604,2791,2065,50
43291188,43290282,43293074,2792,2066,50
43297658,43296752,43299545,2793,2067,50
43304345,43303223,43305477,2254,2068,50
43310277,43309155,43311410,2255,2069,50
43315993,43315087,43317647,2560,2070,50
43322231,43321325,43323580,2255,2071,50
43328164,43327258,43329513,2255,2072,50
43334095,43333190,43335444,2254,2073,50
43340027,43339121,43341681,2560,2074,50
43346265,43345359,43347518,2159,2075,50
43352102,43351196,43353451,2255,2076,50
43358034,43357128,43359383,2255,2077,50
43363967,43363061,43365316,2255,2078,50
43369900,43368994,43371249,2255,2079,50
43375832,43374926,43377169,2243,2080,50
43381752,43380846,43383322,2476,2081,50
43387906,43387000,43389160,2160,2082,50
43393744,43392838,43394997,2159,2083,50
43399580,43398674,43402100,3426,2084,50
43406684,43405778,43409204,3426,2085,50
43414005,43412882,43415138,2256,2086,50
43419721,43418815,43421692,2877,2087,50
43426275,43425370,43427624,2254,2088,50
43432424,43431301,43433557,2256,2089,50
43438140,43437234,43439477,2243,2090,50
43444060,43443154,43445630,2476,2091,50
43450214,43449308,43452417,3109,2092,50
43457001,43456095,43458350,2255,2093,50
43462933,43462027,43465558,3531,2094,50
43470142,43469236,43472345,3109,2095,50
43477146,43476023,43478279,2256,2096,50
43482862,43481956,43485488,3532,2097,50
43490288,43489166,43491421,2255,2098,50
43496003,43495098,43497974,2876,2099,50
43502558,43501652,43503907,2255,2100,50
43508489,43507584,43510797,3213,2101,50
43515381,43514475,43516730,2255,2102,50
43521314,43520408,43522652,2244,2103,50
43527235,43526329,43529122,2793,2104,50
43533706,43532800,43535908,3108,2105,50
43540491,43539586,43542377,2791,2106,50
43546960,43546055,43548309,2254,2107,50
43552892,43551986,43554241,2255,2108,50
43558823,43557918,43560794,2876,2109,50
43565378,43564472,43566727,2255,2110,50
43571310,43570404,43572647,2243,2111,50
43577231,43576325,43578801,2476,2112,50
43583384,43582478,43584733,2255,2113,50
43589316,43588410,43590665,2255,2114,50
43595248,43594342,43597873,3531,2115,50
43602457,43601551,43603806,2255,2116,50
43608606,43607483,43609739,2256,2117,50
43614321,43613416,43616291,2875,2118,50
43620875,43619969,43622224,2255,2119,50
43626807,43625902,43629432,3530,2120,50
43634015,43633110,43636535,3425,2121,50
43641119,43640213,43643638,3425,2122,50
43648222,43647316,43649792,2476,2123,50
43654375,43653469,43655945,2476,2124,50
43660528,43659622,43661781,2159,2125,50
43666365,43665459,43668885,3426,2126,50
43673469,43672563,43675039,2476,2127,50
43679622,43678716,43680876,2160,2128,50
43685676,43684553,43686809,2256,2129,50
43691392,43690486,43693047,2561,2130,50
43697631,43696725,43698980,2255,2131,50
43703562,43702657,43704900,2243,2132,50
43709483,43708577,43711369,2792,2133,50
43715952,43715047,43717206,2159,2134,50
43721789,43720883,43723138,2255,2135,50
43727720,43726815,43729691,2876,2136,50
43734275,43733369,43736795,3426,2137,50
43741379,43740473,43742632,2159,2138,50
43747216,43746310,43749418,3108,2139,50
43754002,43753096,43755889,2793,2140,50
43760473,43759567,43762992,3425,2141,50
43767575,43766670,43768827,2157,2142,50
43773410,43772504,43774759,2255,2143,50
43779559,43778437,43780691,2254,2144,50
43785275,43784369,43786930,2561,2145,50
43791514,43790608,43794034,3426,2146,50
43798617,43797712,43799966,2254,2147,50
43804550,43803644,43805887,2243,2148,50
43810688,43809565,43811821,2256,2149,50
43816405,43815499,43817754,2255,2150,50
43822337,43821431,43823686,2255,2151,50
43828270,43827364,43829619,2255,2152,50
43834202,43833296,43835855,2559,2153,50
43840438,43839532,43842323,2791,2154,50
43847123,43846001,43848256,2255,2155,50
43852838,43851933,43855463,3530,2156,50
43860047,43859141,43861396,2255,2157,50
43865979,43865073,43868267,3194,2158,50
43873068,43871945,43874201,2256,2159,50
43878785,43877879,43880134,2255,2160,50
43884718,43883811,43887343,3532,2161,50
43891926,43891021,43893496,2475,2162,50
43898080,43897174,43900283,3109,2163,50
43904867,43903961,43906437,2476,2164,50
43911021,43910115,43912908,2793,2165,50
43917492,43916586,43918841,2255,2166,50
43923424,43922518,43924773,2255,2167,50
43929356,43928450,43930705,2255,2168,50
43935288,43934382,43937576,3194,2169,50
43942159,43941254,43943508,2254,2170,50
43948091,43947185,43950716,3531,2171,50
43955300,43954394,43957187,2793,2172,50
43961770,43960865,43963119,2254,2173,50
43967702,43966796,43969051,2255,2174,50
43973851,43972729,43974984,2255,2175,50
43979568,43978662,43980917,2255,2176,50
43985499,43984594,43986848,2254,2177,50
43991432,43990526,43992769,2243,2178,50
43997353,43996447,43998702,2255,2179,50
44003286,44002380,44004635,2255,2180,50
44009218,44008312,44011843,3531,2181,50
44016427,44015521,44017681,2160,2182,50
44022264,44021358,44024784,3426,2183,50
44029369,44028462,44030719,2257,2184,50
44035303,44034397,44036652,2255,2185,50
44041234,44040329,44043859,3530,2186,50
44048443,44047537,44050645,3108,2187,50
44055229,44054323,44056578,2255,2188,50
44061162,44060256,44063133,2877,2189,50
44067933,44066811,44069066,2255,2190,50
44073650,44072744,44075621,2877,2191,50
44080205,44079299,44081457,2158,2192,50
44086040,44085134,44088560,3426,2193,50
44093144,44092238,44094714,2476,2194,50
44099298,44098392,44101185,2793,2195,50
44105986,44104863,44107119,2256,2196,50
44111702,44110796,44114327,3531,2197,50
44119128,44118005,44120261,2256,2198,50
44124845,44123939,44127469,3530,2199,50
44132053,44131147,44134573,3426,2200,50
44139156,44138251,44141043,2792,2201,50
44145627,44144721,44146976,2255,2202,50
44151559,44150654,44154183,3529,2203,50
44158984,44157861,44160117,2256,2204,50
44164917,44163794,44166049,2255,2205,50
44170632,44169726,44171981,2255,2206,50
44176564,44175658,44178535,2877,2207,50
44183119,44182213,44184468,2255,2208,50
44189051,44188146,44190400,2254,2209,50
44195199,44194077,44196332,2255,2210,50
44200914,44200009,44202263,2254,2211,50
44206847,44205941,44209135,3194,2212,50
44213719,44212813,44214973,2160,2213,50
44219557,44218651,44220906,2255,2214,50
44225490,44224584,44226828,2244,2215,50
44231412,44230506,44232982,2476,2216,50
44237566,44236660,44239453,2793,2217,50
44244037,44243131,44245386,2255,2218,50
44249969,44249063,44252594,3531,2219,50
44257395,44256272,44258527,2255,2220,50
44263111,44262205,44264460,2255,2221,50
44269042,44268137,44271351,3214,2222,50
44275935,44275029,44277821,2792,2223,50
44282405,44281499,44283754,2255,2224,50
44288337,44287432,44289686,2254,2225,50
44294269,44293363,44296239,2876,2226,50
44301040,44299917,44302173,2256,2227,50
44306756,44305851,44308105,2254,2228,50
44312689,44311783,44314976,3193,2229,50
44319560,44318654,44321446,2792,2230,50
44326030,44325124,44327916,2792,2231,50
44332500,44331594,44333850,2256,2232,50
44338433,44337528,44341058,3530,2233,50
44345642,44344736,44348162,3426,2234,50
44352746,44351840,44354949,3109,2235,50
44359533,44358627,44361103,2476,2236,50
44365686,44364781,44367256,2475,2237,50
44372057,44370934,44373189,2255,2238,50
44377988,44376866,44379121,2255,2239,50
44383922,44382799,44385055,2256,2240,50
44389638,44388732,44391926,3194,2241,50
44396510,44395604,44398080,2476,2242,50
44402663,44401757,44404549,2792,2243,50
44409133,44408227,44411336,3109,2244,50
44415920,44415014,44417269,2255,2245,50
44421852,44420946,44423507,2561,2246,50
44428090,44427185,44430294,3109,2247,50
44434879,44433973,44436228,2255,2248,50
44440811,44439905,44443437,3532,2249,50
44448021,44447115,44449591,2476,2250,50
44454175,44453269,44456061,2792,2251,50
44460644,44459739,44461994,2255,2252,50
44466577,44465672,44467926,2254,2253,50
44472510,44471604,44474798,3194,2254,50
44479382,44478476,44481268,2792,2255,50
44485852,44484946,44487201,2255,2256,50
44491784,44490878,44493122,2244,2257,50
44497705,44496799,44499054,2255,2258,50
44503637,44502732,44504986,2254,2259,50
44509569,44508663,44510918,2255,2260,50
44515718,44514596,44516851,2255,2261,50
44521435,44520529,44523406,2877,2262,50
44527990,44527084,44530193,3109,2263,50
44534778,44533872,44537298,3426,2264,50
44541882,44540976,44543136,2160,2265,50
44547719,44546814,44548973,2159,2266,50
44553558,44552651,44555762,3111,2267,50
44560347,44559440,44562867,3427,2268,50
44567451,44566545,44568800,2255,2269,50
44573383,44572477,44575038,2561,2270,50
44579621,44578716,44582141,3425,2271,50
44586725,44585819,44587978,2159,2272,50
44592561,44591656,44594130,2474,2273,50
44598714,44597808,44601234,3426,2274,50
44606035,44604912,44607168,2256,2275,50
44611752,44610846,44614377,3531,2276,50
44618961,44618055,44621481,3426,2277,50
44626065,44625159,44627319,2160,2278,50
44631902,44630997,44633472,2475,2279,50
44638056,44637150,44640576,3426,2280,50
44645160,44644254,44647046,2792,2281,50
44651847,44650724,44652979,2255,2282,50
44657563,44656657,44659218,2561,2283,50
44663802,44662896,44665151,2255,2284,50
44669734,44668828,44671389,2561,2285,50
44675973,44675067,44677542,2475,2286,50
44682124,44681219,44683473,2254,2287,50
44688056,44687151,44689405,2254,2288,50
44693989,44693083,44695327,2244,2289,50
44700127,44699005,44701260,2255,2290,50
44705843,44704937,44713259,8322,2291,50
44717842,44716937,44720382,3445,2292,50
44724965,44724060,44727169,3109,2293,50
44731753,44730848,44733102,2254,2294,50
44737685,44736780,44740311,3531,2295,50
44744894,44743989,44746243,2254,2296,50
44750827,44749921,44752176,2255,2297,50
44756760,44755854,44758109,2255,2298,50
44762692,44761786,44764041,2255,2299,50
44768625,44767719,44769963,2244,2300,50
44774547,44773641,44775896,2255,2301,50
44780479,44779574,44783104,3530,2302,50
44787688,44786782,44789258,2476,2303,50
44793842,44792936,44795412,2476,2304,50
44799996,44799090,44801883,2793,2305,50
44806467,44805561,44808987,3426,2306,50
44813571,44812665,44814920,2255,2307,50
44819504,44818598,44822129,3531,2308,50
44826929,44825807,44828061,2254,2309,50
44832644,44831738,44834952,3214,2310,50
44839536,44838630,44842055,3425,2311,50
44846639,44845733,44848525,2792,2312,50
44853109,44852203,44855312,3109,2313,50
44859896,44858990,44861466,2476,2314,50
44866050,44865144,44867399,2255,2315,50
44871982,44871076,44873331,2255,2316,50
44877914,44877008,44879568,2560,2317,50
44884151,44883246,44886354,3108,2318,50
44891155,44890032,44892288,2256,2319,50
44896871,44895965,44898220,2255,2320,50
44903019,44901897,44904151,2254,2321,50
44908734,44907829,44910072,2243,2322,50
44914655,44913749,44916225,2476,2323,50
44920808,44919902,44922157,2255,2324,50
44926741,44925835,44928090,2255,2325,50
44932673,44931767,44934644,2877,2326,50
44939228,44938322,44941114,2792,2327,50
44945698,44944792,44946950,2158,2328,50
44951534,44950628,44952787,2159,2329,50
44957371,44956465,44959574,3109,2330,50
44964158,44963252,44966678,3426,2331,50
44971262,44970356,44972516,2160,2332,50
44977099,44976193,44979302,3109,2333,50
44983885,44982980,44985454,2474,2334,50
44990037,44989132,44991387,2255,2335,50
44995970,44995064,44997319,2255,2336,50
45001902,45000996,45003557,2561,2337,50
45008140,45007235,45009393,2158,2338,50
45013976,45013070,45015863,2793,2339,50
45020447,45019541,45022333,2792,2340,50
45026917,45026011,45029120,3109,2341,50
45033704,45032798,45035273,2475,2342,50
45039856,45038951,45041205,2254,2343,50
45045789,45044883,45047444,2561,2344,50
45052028,45051122,45054231,3109,2345,50
45058816,45057910,45061018,3108,2346,50
45065601,45064696,45067804,3108,2347,50
45072388,45071482,45074274,2792,2348,50
45078858,45077952,45080427,2475,2349,50
45085226,45084104,45086359,2255,2350,50
45090941,45090036,45092290,2254,2351,50
45097090,45095967,45098222,2255,2352,50
45102805,45101899,45104143,2244,2353,50
45108726,45107820,45110075,2255,2354,50
45114658,45113752,45117284,3532,2355,50
45121868,45120962,45124388,3426,2356,50
45128972,45128066,45131175,3109,2357,50
45135759,45134853,45137011,2158,2358,50
45141593,45140688,45142847,2159,2359,50
45147430,45146524,45148684,2160,2360,50
45153267,45152361,45155787,3426,2361,50
45160371,45159465,45162257,2792,2362,50
45167057,45165935,45168190,2255,2363,50
45172772,45171867,45174110,2243,2364,50
45178694,45177788,45180043,2255,2365,50
45184625,45183720,45185974,2254,2366,50
45190557,45189652,45192845,3193,2367,50
45197428,45196523,45199947,3424,2368,50
45204531,45203625,45206733,3108,2369,50
45211534,45210411,45212667,2256,2370,50
45217250,45216344,45218599,2255,2371,50
45223398,45222276,45224531,2255,2372,50
45229115,45228209,45230464,2255,2373,50
45235046,45234141,45236384,2243,2374,50
45240967,45240061,45242316,2255,2375,50
45246900,45245994,45248555,2561,2376,50
45253139,45252233,45254709,2476,2377,50
45259291,45258386,45260640,2254,2378,50
45265223,45264318,45266876,2558,2379,50
45271459,45270553,45273662,3109,2380,50
45278246,45277340,45279595,2255,2381,50
45284179,45283273,45285528,2255,2382,50
45290111,45289205,45291460,2255,2383,50
45296260,45295137,45297393,2256,2384,50
45301975,45301070,45303629,2559,2385,50
45308212,45307307,45310098,2791,2386,50
45314681,45313776,45317221,3445,2387,50
45322021,45320899,45323154,2255,2388,50
45327737,45326831,45329086,2255,2389,50
45333885,45332763,45335018,2255,2390,50
45339602,45338696,45340940,2244,2391,50
45345524,45344618,45346778,2160,2392,50
45351362,45350456,45352931,2475,2393,50
45357514,45356608,45358863,2255,2394,50
45363446,45362541,45364784,2243,2395,50
45369367,45368462,45370716,2254,2396,50
45375300,45374394,45376649,2255,2397,50
45381232,45380326,45382581,2255,2398,50
45387165,45386259,45388820,2561,2399,50
45393404,45392498,45394658,2160,2400,50
45399240,45398335,45401126,2791,2401,50
45405710,45404804,45408230,3426,2402,50
45413031,45411908,45414164,2256,2403,50
45418748,45417842,45421374,3532,2404,50
45425958,45425052,45427307,2255,2405,50
45432107,45430984,45433240,2256,2406,50
45437824,45436918,45439162,2244,2407,50
45443963,45442840,45445096,2256,2408,50
45449680,45448774,45451029,2255,2409,50
45455612,45454706,45456961,2255,2410,50
45461544,45460638,45464168,3530,2411,50
45468752,45467846,45470322,2476,2412,50
45475123,45474000,45476256,2256,2413,50
45480840,45479934,45482189,2255,2414,50
45486772,45485866,45488121,2255,2415,50
45492703,45491798,45494041,2243,2416,50
45498625,45497719,45500194,2475,2417,50
45504777,45503871,45506030,2159,2418,50
45510614,45509708,45511868,2160,2419,50
45516452,45515545,45518655,3110,2420,50
45523239,45522333,45524809,2476,2421,50
45529392,45528486,45531279,2793,2422,50
45536080,45534957,45537213,2256,2423,50
45541796,45540890,45543134,2244,2424,50
45547718,45546812,45549067,2255,2425,50
45553651,45552745,45555000,2255,2426,50
45559584,45558678,45562209,3531,2427,50
45567009,45565887,45568142,2255,2428,50
45572726,45571820,45574379,2559,2429,50
45578962,45578056,45580214,2158,2430,50
45584798,45583892,45587318,3426,2431,50
45591902,45590996,45594104,3108,2432,50
45598905,45597782,45600038,2256,2433,50
45604621,45603715,45607246,3531,2434,50
45612046,45610924,45613179,2255,2435,50
45617763,45616857,45619112,2255,2436,50
45623695,45622789,45625666,2877,2437,50
45630466,45629344,45631599,2255,2438,50
45636182,45635276,45638153,2877,2439,50
45642737,45641831,45644086,2255,2440,50
45648670,45647764,45651295,3531,2441,50
45656095,45654973,45657228,2255,2442,50
45661812,45660906,45664437,3531,2443,50
45669021,45668115,45670274,2159,2444,50
45674858,45673952,45676744,2792,2445,50
45681328,45680422,45683847,3425,2446,50
45688431,45687525,45689780,2255,2447,50
45694579,45693457,45695712,2255,2448,50
45700295,45699390,45701950,2560,2449,50
45706534,45705628,45708104,2476,2450,50
45712687,45711781,45713939,2158,2451,50
45718522,45717616,45721063,3447,2452,50
45725646,45724741,45727850,3109,2453,50
45732435,45731529,45734954,3425,2454,50
45739538,45738632,45741107,2475,2455,50
45745690,45744785,45748209,3424,2456,50
45753011,45751888,45754144,2256,2457,50
45758728,45757822,45761353,3531,2458,50
45765936,45765031,45768477,3446,2459,50
45773278,45772155,45774410,2255,2460,50
45779209,45778087,45780342,2255,2461,50
45784926,45784020,45786275,2255,2462,50
45790859,45789953,45793147,3194,2463,50
45797948,45796825,45799081,2256,2464,50
45803665,45802759,45805014,2255,2465,50
45809598,45808692,45812224,3532,2466,50
45816808,45815902,45818157,2255,2467,50
45822741,45821835,45825029,3194,2468,50
45829613,45828707,45830962,2255,2469,50
45835546,45834640,45837200,2560,2470,50
45841784,45840878,45843354,2476,2471,50
45847938,45847032,45850141,3109,2472,50
45854724,45853819,45856073,2254,2473,50
45860656,45859751,45862310,2559,2474,50
45866894,45865988,45869097,3109,2475,50
45873682,45872776,45876202,3426,2476,50
45880786,45879880,45882356,2476,2477,50
45886940,45886034,45888194,2160,2478,50
45892778,45891872,45894127,2255,2479,50
45898711,45897805,45900999,3194,2480,50
45905583,45904677,45906835,2158,2481,50
45911417,45910512,45912671,2159,2482,50
45917254,45916348,45918603,2255,2483,50
45923187,45922281,45925812,3531,2484,50
45930396,45929490,45931649,2159,2485,50
45936449,45935326,45937582,2256,2486,50
45942166,45941260,45943515,2255,2487,50
45948098,45947192,45949753,2561,2488,50
45954337,45953431,45955907,2476,2489,50
45960491,45959585,45962061,2476,2490,50
45966644,45965739,45969185,3446,2491,50
45973769,45972863,45975654,2791,2492,50
45980238,45979332,45982758,3426,2493,50
45987341,45986436,45988690,2254,2494,50
45993273,45992368,45995581,3213,2495,50
46000165,45999259,46002685,3426,2496,50
46007269,46006363,46008618,2255,2497,50
46013201,46012295,46015489,3194,2498,50
46020073,46019168,46021422,2254,2499,50
46026005,46025099,46027976,2877,2500,50
46032560,46031654,46034129,2475,2501,50
46038713,46037807,46041253,3446,2502,50
46045837,46044931,46047186,2255,2503,50
46051770,46050864,46054058,3194,2504,50
46058642,46057736,46061162,3426,2505,50
46065746,46064840,46067000,2160,2506,50
46071584,46070678,46072934,2256,2507,50
46077517,46076612,46078855,2243,2508,50
46083439,46082533,46085642,3109,2509,50
46090226,46089320,46091575,2255,2510,50
46096158,46095252,46098783,3531,2511,50
46103367,46102461,46104716,2255,2512,50
46109300,46108394,46110638,2244,2513,50
46115222,46114316,46116475,2159,2514,50
46121058,46120153,46123598,3445,2515,50
46128182,46127276,46129531,2255,2516,50
46134330,46133208,46135463,2255,2517,50
46140263,46139140,46141396,2256,2518,50
46145980,46145074,46148267,3193,2519,50
46153068,46151945,46154201,2256,2520,50
46158785,46157879,46160134,2255,2521,50
46164718,46163812,46166067,2255,2522,50
46170866,46169744,46171999,2255,2523,50
46176582,46175676,46177931,2255,2524,50
46182732,46181609,46183864,2255,2525,50
46188446,46187541,46190755,3214,2526,50
46195339,46194433,46197859,3426,2527,50
46202443,46201537,46204013,2476,2528,50
46208597,46207691,46210482,2791,2529,50
46215066,46214160,46216319,2159,2530,50
46220902,46219996,46222789,2793,2531,50
46227373,46226467,46228722,2255,2532,50
46233305,46232399,46234654,2255,2533,50
46239237,46238331,46241208,2877,2534,50
46245791,46244886,46247361,2475,2535,50
46252160,46251038,46253293,2255,2536,50
46257877,46256971,46260503,3532,2537,50
46265087,46264181,46266973,2792,2538,50
46271557,46270651,46272906,2255,2539,50
46277489,46276583,46279797,3214,2540,50
46284381,46283475,46286268,2793,2541,50
46290852,46289946,46292739,2793,2542,50
46297323,46296417,46299527,3110,2543,50
46304328,46303205,46305461,2256,2544,50
46310261,46309139,46311394,2255,2545,50
46315977,46315071,46318265,3194,2546,50
46322849,46321944,46325369,3425,2547,50
46329953,46329047,46331839,2792,2548,50
46336639,46335517,46337771,2254,2549,50
46342354,46341448,46344008,2560,2550,50
46348808,46347686,46349940,2254,2551,50
46354523,46353617,46356811,3194,2552,50
46361394,46360489,46363914,3425,2553,50
46368715,46367593,46369848,2255,2554,50
46374431,46373525,46376086,2561,2555,50
46380886,46379764,46382019,2255,2556,50
46386603,46385697,46387941,2244,2557,50
46392741,46391619,46393874,2255,2558,50
46398458,46397552,46401083,3531,2559,50
46405667,46404761,46407016,2255,2560,50
46411600,46410694,46413887,3193,2561,50
46418472,46417566,46420992,3426,2562,50
46425577,46424671,46427780,3109,2563,50
46432365,46431459,46433935,2476,2564,50
46438519,46437613,46439772,2159,2565,50
46444356,46443450,46446243,2793,2566,50
46451045,46449922,46452178,2256,2567,50
46456762,46455856,46458100,2244,2568,50
46462684,46461778,46463937,2159,2569,50
46468521,46467615,46470091,2476,2570,50
46474675,46473769,46477195,3426,2571,50
46481779,46480873,46484299,3426,2572,50
46488884,46487978,46490770,2792,2573,50
46495355,46494449,46497242,2793,2574,50
46501825,46500920,46503174,2254,2575,50
46507758,46506852,46510384,3532,2576,50
46514968,46514063,46516317,2254,2577,50
46520901,46519995,46522250,2255,2578,50
46526833,46525928,46529119,3191,2579,50
46533703,46532798,46534957,2159,2580,50
46539541,46538635,46540890,2255,2581,50
46545474,46544568,46547445,2877,2582,50
46552030,46551124,46553379,2255,2583,50
46557963,46557057,46559312,2255,2584,50
46563896,46562990,46565245,2255,2585,50
46569829,46568923,46571484,2561,2586,50
46576068,46575162,46577322,2160,2587,50
46581906,46581000,46583255,2255,2588,50
46587839,46586933,46590465,3532,2589,50
46595050,46594144,46596303,2159,2590,50
46600887,46599981,46602140,2159,2591,50
46606941,46605818,46608074,2256,2592,50
46612658,46611752,46615283,3531,2593,50
46619868,46618962,46621122,2160,2594,50
46625706,46624800,46627275,2475,2595,50
46631858,46630953,46633207,2254,2596,50
46637791,46636885,46640078,3193,2597,50
46644880,46643757,46646012,2255,2598,50
46650596,46649690,46651934,2244,2599,50
46656518,46655612,46658405,2793,2600,50
46662990,46662084,46664339,2255,2601,50
46668922,46668017,46671231,3214,2602,50
46676033,46674910,46677166,2256,2603,50
46681749,46680844,46683719,2875,2604,50
46688304,46687398,46689653,2255,2605,50
46694454,46693331,46695586,2255,2606,50
46700170,46699264,46701825,2561,2607,50
46706410,46705504,46708296,2792,2608,50
46712881,46711975,46714135,2160,2609,50
46718718,46717813,46720067,2254,2610,50
46724651,46723745,46726000,2255,2611,50
46730584,46729678,46731921,2243,2612,50
46736505,46735599,46737854,2255,2613,50
46742438,46741532,46743787,2255,2614,50
46748371,46747465,46750995,3530,2615,50
46755579,46754673,46756928,2255,2616,50
46761512,46760606,46762861,2255,2617,50
46767444,46766539,46769415,2876,2618,50
46774217,46773094,46775350,2256,2619,50
46779934,46779028,46781283,2255,2620,50
46785867,46784961,46788493,3532,2621,50
46793077,46792171,46795597,3426,2622,50
46800182,46799276,46802069,2793,2623,50
46806870,46805748,46808003,2255,2624,50
46812587,46811681,46813936,2255,2625,50
46818520,46817614,46819869,2255,2626,50
46824453,46823547,46827078,3531,2627,50
46831662,46830757,46834181,3424,2628,50
46838766,46837860,46840019,2159,2629,50
46844603,46843697,46846173,2476,2630,50
46850757,46849851,46852106,2255,2631,50
46856690,46855784,46859315,3531,2632,50
46864117,46862994,46865249,2255,2633,50
46869832,46868927,46871181,2254,2634,50
46875765,46874859,46877736,2877,2635,50
46882538,46881415,46883671,2256,2636,50
46888254,46887349,46890880,3531,2637,50
46895465,46894559,46897035,2476,2638,50
46901836,46900713,46902968,2255,2639,50
46907552,46906646,46908901,2255,2640,50
46913485,46912579,46916110,3531,2641,50
46920912,46919789,46922045,2256,2642,50
46926629,46925723,46927978,2255,2643,50
46932562,46931656,46933911,2255,2644,50
46938495,46937589,46939833,2244,2645,50
46944417,46943511,46946620,3109,2646,50
46951204,46950299,46953723,3424,2647,50
46958307,46957402,46959560,2158,2648,50
46964360,46963238,46965493,2255,2649,50
46970077,46969171,46971415,2244,2650,50
46975999,46975093,46977253,2160,2651,50
46981837,46980931,46984040,3109,2652,50
46988625,46987719,46989879,2160,2653,50
46994463,46993557,46996034,2477,2654,50
47000618,46999712,47002821,3109,2655,50
47007406,47006500,47008976,2476,2656,50
47013560,47012654,47014909,2255,2657,50
47019492,47018587,47021147,2560,2658,50
47025732,47024826,47027619,2793,2659,50
47032421,47031298,47033554,2256,2660,50
47038137,47037232,47040108,2876,2661,50
47044692,47043787,47046041,2254,2662,50
47050624,47049719,47052932,3213,2663,50
47057517,47056611,47059403,2792,2664,50
47063988,47063082,47066508,3426,2665,50
47071093,47070187,47072443,2256,2666,50
47077027,47076121,47078682,2561,2667,50
47083267,47082361,47084521,2160,2668,50
47089105,47088199,47090674,2475,2669,50
47095259,47094353,47096512,2159,2670,50
47101097,47100191,47103616,3425,2671,50
47108201,47107295,47109455,2160,2672,50
47114039,47113133,47116242,3109,2673,50
47120827,47119921,47123347,3426,2674,50
47127931,47127026,47130450,3424,2675,50
47135035,47134129,47136605,2476,2676,50
47141189,47140283,47143709,3426,2677,50
47148294,47147388,47150498,3110,2678,50
47155082,47154177,47156968,2791,2679,50
47161552,47160647,47163755,3108,2680,50
47168556,47167434,47169689,2255,2681,50
47174272,47173367,47175610,2243,2682,50
47180194,47179288,47181543,2255,2683,50
47186127,47185222,47188751,3529,2684,50
47193336,47192430,47194905,2475,2685,50
47199488,47198583,47200837,2254,2686,50
47205421,47204515,47206770,2255,2687,50
47211354,47210448,47213325,2877,2688,50
47218125,47217003,47219257,2254,2689,50
47223841,47222935,47225190,2255,2690,50
47229774,47228868,47232061,3193,2691,50
47236863,47235740,47237996,2256,2692,50
47242580,47241674,47245205,3531,2693,50
47249789,47248884,47251041,2157,2694,50
47255625,47254719,47257194,2475,2695,50
47261778,47260872,47263348,2476,2696,50
47267932,47267026,47270135,3109,2697,50
47274720,47273814,47275974,2160,2698,50
47280557,47279652,47281906,2254,2699,50
47286490,47285584,47287839,2255,2700,50
47292639,47291517,47293772,2255,2701,50
47298356,47297450,47300643,3193,2702,50
47305228,47304322,47306578,2256,2703,50
47311162,47310256,47313450,3194,2704,50
47318251,47317129,47319384,2255,2705,50
47323968,47323062,47325317,2255,2706,50
47329902,47328995,47331251,2256,2707,50
47335835,47334929,47338459,3530,2708,50
47343043,47342137,47344392,2255,2709,50
47349192,47348070,47350325,2255,2710,50
47354909,47354003,47356258,2255,2711,50
47361058,47359936,47362190,2254,2712,50
47366774,47365868,47369398,3530,2713,50
47373982,47373076,47376185,3109,2714,50
47380770,47379864,47382023,2159,2715,50
47386607,47385701,47387956,2255,2716,50
47392540,47391634,47394510,2876,2717,50
47399095,47398189,47401297,3108,2718,50
47405882,47404976,47408402,3426,2719,50
47412987,47412081,47415190,3109,2720,50
47419775,47418869,47421124,2255,2721,50
47425707,47424802,47427045,2243,2722,50
47431845,47430723,47432977,2254,2723,50
47437560,47436655,47440185,3530,2724,50
47444769,47443864,47446022,2158,2725,50
47450606,47449700,47451955,2255,2726,50
47456539,47455633,47459163,3530,2727,50
47463748,47462842,47465001,2159,2728,50
47469585,47468679,47471472,2793,2729,50
47476057,47475151,47478577,3426,2730,50
47483162,47482256,47484732,2476,2731,50
47489316,47488410,47491835,3425,2732,50
47496420,47495514,47498622,3108,2733,50
47503207,47502301,47504460,2159,2734,50
47509044,47508138,47510614,2476,2735,50
47515415,47514292,47516548,2256,2736,50
47521132,47520226,47523103,2877,2737,50
47527686,47526781,47529889,3108,2738,50
47534472,47533567,47535724,2157,2739,50
47540307,47539402,47542827,3425,2740,50
47547412,47546506,47549932,3426,2741,50
47554517,47553611,47555770,2159,2742,50
47560354,47559448,47561923,2475,2743,50
47566506,47565601,47569026,3425,2744,50
47573827,47572704,47574960,2256,2745,50
47579544,47578638,47580893,2255,2746,50
47585477,47584571,47587448,2877,2747,50
47592033,47591127,47593382,2255,2748,50
47597966,47597060,47600592,3532,2749,50
47605177,47604271,47606747,2476,2750,50
47611331,47610425,47613218,2793,2751,50
47617803,47616897,47620323,3426,2752,50
47624907,47624001,47626256,2255,2753,50
47631056,47629934,47632189,2255,2754,50
47636773,47635867,47638427,2560,2755,50
47643011,47642105,47644360,2255,2756,50
47648943,47648038,47650914,2876,2757,50
47655499,47654593,47656751,2158,2758,50
47661335,47660429,47663538,3109,2759,50
47668123,47667217,47669692,2475,2760,50
47674276,47673370,47675625,2255,2761,50
47680208,47679303,47682495,3192,2762,50
47687297,47686174,47688430,2256,2763,50
47693013,47692108,47694668,2560,2764,50
47699253,47698347,47701773,3426,2765,50
47706358,47705452,47707611,2159,2766,50
47712412,47711289,47713545,2256,2767,50
47718129,47717223,47720417,3194,2768,50
47725219,47724096,47726351,2255,2769,50
47730935,47730029,47732906,2877,2770,50
47737491,47736585,47738745,2160,2771,50
47743328,47742423,47745215,2792,2772,50
47749799,47748894,47751053,2159,2773,50
47755853,47754731,47756986,2255,2774,50
47761570,47760664,47763224,2560,2775,50
47767809,47766903,47770329,3426,2776,50
47774914,47774008,47777434,3426,2777,50
47782019,47781113,47783272,2159,2778,50
47787856,47786950,47789205,2255,2779,50
47793788,47792883,47796076,3193,2780,50
47800660,47799755,47802010,2255,2781,50
47806593,47805688,47809219,3531,2782,50
47813804,47812898,47816008,3110,2783,50
47820593,47819687,47822796,3109,2784,50
47827380,47826475,47828729,2254,2785,50
47833314,47832408,47834663,2255,2786,50
47839247,47838342,47840585,2243,2787,50
47845170,47844264,47846740,2476,2788,50
47851324,47850418,47853526,3108,2789,50
47858111,47857205,47860631,3426,2790,50
47865216,47864310,47866786,2476,2791,50
47871369,47870464,47872719,2255,2792,50
47877303,47876397,47879928,3531,2793,50
47884729,47883607,47885862,2255,2794,50
47890446,47889540,47891795,2255,2795,50
47896378,47895473,47898666,3193,2796,50
47903251,47902345,47904820,2475,2797,50
47909403,47908498,47910753,2255,2798,50
47915337,47914431,47917963,3532,2799,50
47922765,47921642,47923898,2256,2800,50
47928481,47927576,47931107,3531,2801,50
47935692,47934786,47937041,2255,2802,50
47941624,47940719,47943912,3193,2803,50
47948497,47947591,47949751,2160,2804,50
47954336,47953430,47955685,2255,2805,50
47960268,47959363,47962556,3193,2806,50
47967141,47966235,47968491,2256,2807,50
47973076,47972170,47974426,2256,2808,50
47979226,47978104,47980359,2255,2809,50
47984943,47984037,47986292,2255,2810,50
47990875,47989970,47992225,2255,2811,50
47996809,47995903,47998158,2255,2812,50
48002960,48001837,48004093,2256,2813,50
48008677,48007771,48011302,3531,2814,50
48015886,48014980,48018405,3425,2815,50
48022990,48022084,48024339,2255,2816,50
48028923,48028017,48030894,2877,2817,50
48035479,48034573,48036733,2160,2818,50
48041317,48040411,48043203,2792,2819,50
48047788,48046882,48049042,2160,2820,50
48053626,48052720,48055196,2476,2821,50
48059779,48058874,48061128,2254,2822,50
48065712,48064806,48068336,3530,2823,50
48072921,48072015,48075441,3426,2824,50
48080025,48079120,48082228,3108,2825,50
48086813,48085907,48088162,2255,2826,50
48092746,48091840,48094095,2255,2827,50
48098678,48097773,48100027,2254,2828,50
48104611,48103705,48105960,2255,2829,50
48110544,48109638,48111893,2255,2830,50
48116694,48115571,48117827,2256,2831,50
48122410,48121505,48124698,3193,2832,50
48129283,48128377,48131170,2793,2833,50
48135754,48134848,48137103,2255,2834,50
48141687,48140781,48144312,3531,2835,50
48148897,48147991,48151100,3109,2836,50
48155685,48154779,48157888,3109,2837,50
48162689,48161567,48163822,2255,2838,50
48168406,48167500,48170694,3194,2839,50
48175278,48174373,48176531,2158,2840,50
48181115,48180209,48182464,2255,2841,50
48187048,48186142,48189673,3531,2842,50
48194258,48193352,48195510,2158,2843,50
48200094,48199188,48201348,2160,2844,50
48205932,48205026,48207501,2475,2845,50
48212085,48211179,48213338,2159,2846,50
48217922,48217016,48219808,2792,2847,50
48224393,48223487,48225646,2159,2848,50
48230447,48229324,48231579,2255,2849,50
48236163,48235257,48237818,2561,2850,50
48242402,48241496,48244604,3108,2851,50
48249189,48248283,48250538,2255,2852,50
48255121,48254216,48256776,2560,2853,50
48261361,48260455,48263564,3109,2854,50
48268149,48267243,48269719,2476,2855,50
48274519,48273397,48275652,2255,2856,50
48280236,48279330,48282523,3193,2857,50
48287108,48286202,48288457,2255,2858,50
48293041,48292135,48295328,3193,2859,50
48299913,48299007,48302117,3110,2860,50
48306702,48305796,48308588,2792,2861,50
48313173,48312267,48314743,2476,2862,50
48319327,48318421,48321214,2793,2863,50
48325799,48324893,48327053,2160,2864,50
48331636,48330731,48333523,2792,2865,50
48338108,48337202,48339995,2793,2866,50
48344580,48343674,48345929,2255,2867,50
48350513,48349607,48353139,3532,2868,50
48357724,48356818,48359611,2793,2869,50
48364196,48363290,48366399,3109,2870,50
48370984,48370078,48372554,2476,2871,50
48377138,48376232,48378487,2255,2872,50
48383070,48382165,48385041,2876,2873,50
48389626,48388720,48391513,2793,2874,50
48396315,48395192,48397448,2256,2875,50
48402032,48401126,48403369,2243,2876,50
48407953,48407047,48409523,2476,2877,50
48414108,48413202,48415362,2160,2878,50
48419946,48419040,48421200,2160,2879,50
48426001,48424878,48427134,2256,2880,50
48431718,48430812,48433056,2244,2881,50
48437640,48436734,48440159,3425,2882,50
48444744,48443838,48447264,3426,2883,50
48451849,48450943,48453419,2476,2884,50
48458003,48457097,48460206,3109,2885,50
48464790,48463885,48466139,2254,2886,50
48470723,48469817,48473011,3194,2887,50
48477596,48476690,48480115,3425,2888,50
48484700,48483794,48486270,2476,2889,50
48490854,48489949,48492424,2475,2890,50
48497008,48496102,48498261,2159,2891,50
48502845,48501939,48504732,2793,2892,50
48509317,48508411,48511837,3426,2893,50
48516422,48515516,48518942,3426,2894,50
48523744,48522621,48524877,2256,2895,50
48529461,48528555,48530810,2255,2896,50
48535394,48534488,48538020,3532,2897,50
48542604,48541698,48544808,3110,2898,50
48549392,48548487,48551595,3108,2899,50
48556180,48555274,48558067,2793,2900,50
48562652,48561746,48564854,3108,2901,50
48569656,48568533,48570789,2256,2902,50
48575372,48574467,48576710,2243,2903,50
48581294,48580388,48582548,2160,2904,50
48587132,48586226,48588482,2256,2905,50
48593066,48592160,48594404,2244,2906,50
48598988,48598082,48600875,2793,2907,50
48605677,48604554,48606810,2256,2908,50
48611393,48610488,48614019,3531,2909,50
48618604,48617698,48619954,2256,2910,50
48624538,48623632,48626825,3193,2911,50
48631410,48630504,48633613,3109,2912,50
48638198,48637292,48639768,2476,2913,50
48644352,48643447,48645605,2158,2914,50
48650188,48649283,48651758,2475,2915,50
48656342,48655436,48658228,2792,2916,50
48662813,48661907,48664162,2255,2917,50
48668746,48667840,48670400,2560,2918,50
48674984,48674078,48676333,2255,2919,50
48680916,48680011,48682265,2254,2920,50
48686849,48685943,48688198,2255,2921,50
48692782,48691876,48694753,2877,2922,50
48699338,48698432,48700687,2255,2923,50
48705271,48704365,48706608,2243,2924,50
48711192,48710286,48712445,2159,2925,50
48717029,48716123,48719549,3426,2926,50
48724351,48723228,48725484,2256,2927,50
48730068,48729162,48731417,2255,2928,50
48736001,48735095,48737338,2243,2929,50
48741922,48741016,48743492,2476,2930,50
48748076,48747170,48749962,2792,2931,50
48754546,48753641,48755895,2254,2932,50
48760479,48759573,48761828,2255,2933,50
48766412,48765506,48767761,2255,2934,50
48772561,48771439,48773694,2255,2935,50
48778278,48777372,48780249,2877,2936,50
48784834,48783928,48787037,3109,2937,50
48791622,48790716,48792972,2256,2938,50
48797555,48796650,48799526,2876,2939,50
48804110,48803205,48805364,2159,2940,50
48809948,48809042,48811297,2255,2941,50
48815880,48814975,48817229,2254,2942,50
48822029,48820907,48823162,2255,2943,50
48827746,48826840,48829095,2255,2944,50
48833679,48832773,48836303,3530,2945,50
48840888,48839982,48843408,3426,2946,50
48847993,48847087,48849247,2160,2947,50
48853831,48852925,48855401,2476,2948,50
48859984,48859079,48861871,2792,2949,50
48866456,48865550,48867709,2159,2950,50
48872293,48871387,48874496,3109,2951,50
48879081,48878175,48880967,2792,2952,50
48885551,48884645,48887121,2476,2953,50
48891705,48890799,48893054,2255,2954,50
48897638,48896732,48898987,2255,2955,50
48903571,48902665,48905858,3193,2956,50
48910443,48909537,48911792,2255,2957,50
48916376,48915470,48918664,3194,2958,50
48923249,48922343,48925135,2792,2959,50
48929936,48928814,48931069,2255,2960,50
48935653,48934747,48937002,2255,2961,50
48941586,48940680,48942936,2256,2962,50
48947520,48946614,48949491,2877,2963,50
48954076,48953170,48955646,2476,2964,50
48960230,48959324,48962750,3426,2965,50
48967334,48966429,48968904,2475,2966,50
48973487,48972582,48976007,3425,2967,50
48980592,48979686,48981941,2255,2968,50
48986525,48985619,48988496,2877,2969,50
48993081,48992175,48994430,2255,2970,50
48999013,48998108,49000351,2243,2971,50
49004935,49004029,49006504,2475,2972,50
49011088,49010182,49012437,2255,2973,50
49017238,49016116,49018371,2255,2974,50
49023172,49022050,49024305,2255,2975,50
49028890,49027984,49030861,2877,2976,50
49035446,49034540,49036795,2255,2977,50
49041379,49040473,49042728,2255,2978,50
49047312,49046406,49048662,2256,2979,50
49053245,49052340,49055871,3531,2980,50
49060456,49059550,49061806,2256,2981,50
49066391,49065484,49068046,2562,2982,50
49072631,49071725,49074835,3110,2983,50
49079420,49078514,49081307,2793,2984,50
49086109,49084986,49087242,2256,2985,50
49091826,49090920,49094451,3531,2986,50
49099036,49098130,49101556,3426,2987,50
49106141,49105235,49108344,3109,2988,50
49112928,49112023,49115132,3109,2989,50
49119717,49118811,49121067,2256,2990,50
49125652,49124746,49127001,2255,2991,50
49131585,49130680,49133557,2877,2992,50
49138142,49137236,49139395,2159,2993,50
49143980,49143074,49146499,3425,2994,50
49151301,49150178,49152434,2256,2995,50
49157017,49156112,49158355,2243,2996,50
49163156,49162033,49164288,2255,2997,50
49168872,49167966,49171159,3193,2998,50
49175959,49174837,49177092,2255,2999,50
49181892,49180770,49183025,2255,3000,50
49187608,49186703,49190233,3530,3001,50
49194817,49193912,49196166,2254,3002,50
49200750,49199844,49202404,2560,3003,50
49206988,49206082,49208242,2160,3004,50
49212825,49211920,49215345,3425,3005,50
49219930,49219024,49221817,2793,3006,50
49226619,49225496,49227752,2256,3007,50
49232336,49231430,49233685,2255,3008,50
49238269,49237363,49239618,2255,3009,50
49244419,49243296,49245551,2255,3010,50
49250135,49249229,49252423,3194,3011,50
49257008,49256102,49258893,2791,3012,50
49263478,49262572,49265996,3424,3013,50
49270581,49269675,49272150,2475,3014,50
49276734,49275828,49278303,2475,3015,50
49283104,49281981,49284237,2256,3016,50
49288821,49287915,49291109,3194,3017,50
49295693,49294788,49298212,3424,3018,50
49302797,49301891,49311078,9187,3019,50
49315662,49314756,49317548,2792,3020,50
49322133,49321227,49324018,2791,3021,50
49328820,49327697,49329952,2255,3022,50
49334536,49333630,49337161,3531,3023,50
49341961,49340839,49343094,2255,3024,50
49347678,49346772,49349965,3193,3025,50
49354766,49353644,49355899,2255,3026,50
49360483,49359577,49362137,2560,3027,50
49366721,49365815,49368070,2255,3028,50
49372654,49371748,49374003,2255,3029,50
49378804,49377681,49379936,2255,3030,50
49384520,49383614,49385858,2244,3031,50
49390442,49389536,49392012,2476,3032,50
49396596,49395690,49397945,2255,3033,50
49402529,49401623,49404816,3193,3034,50
49409401,49408495,49410750,2255,3035,50
49415334,49414428,49416672,2244,3036,50
49421256,49420350,49422826,2476,3037,50
49427410,49426504,49428759,2255,3038,50
49433344,49432437,49434998,2561,3039,50
49439583,49438677,49440932,2255,3040,50
49445516,49444610,49446865,2255,3041,50
49451449,49450543,49454053,3510,3042,50
49458855,49457732,49459988,2256,3043,50
49464571,49463666,49465908,2242,3044,50
49470491,49469586,49471841,2255,3045,50
49476425,49475519,49479049,3530,3046,50
49483634,49482728,49484888,2160,3047,50
49489472,49488566,49490725,2159,3048,50
49495309,49494403,49497829,3426,3049,50
49502413,49501508,49504616,3108,3050,50
49509201,49508295,49510455,2160,3051,50
49515038,49514133,49516925,2792,3052,50
49521510,49520604,49523395,2791,3053,50
49528197,49527074,49529330,2256,3054,50
49533914,49533008,49535263,2255,3055,50
49539847,49538941,49542135,3194,3056,50
49546720,49545814,49548606,2792,3057,50
49553408,49552285,49554541,2256,3058,50
49559125,49558219,49560780,2561,3059,50
49565365,49564459,49566619,2160,3060,50
49571202,49570297,49572551,2254,3061,50
49577134,49576229,49579759,3530,3062,50
49584561,49583438,49585694,2256,3063,50
49590494,49589372,49591627,2255,3064,50
49596211,49595305,49597560,2255,3065,50
49602144,49601238,49603493,2255,3066,50
49608077,49607171,49609426,2255,3067,50
49614010,49613104,49615359,2255,3068,50
49619943,49619037,49621598,2561,3069,50
49626183,49625277,49627436,2159,3070,50
49632020,49631114,49633369,2255,3071,50
49637953,49637047,49639291,2244,3072,50
49643874,49642969,49646077,3108,3073,50
49650879,49649756,49652012,2256,3074,50
49656813,49655690,49657946,2256,3075,50
49662529,49661624,49663879,2255,3076,50
49668463,49667557,49670434,2877,3077,50
49675019,49674113,49676368,2255,3078,50
49680952,49680046,49682289,2243,3079,50
49686873,49685967,49689076,3109,3080,50
49693661,49692755,49695547,2792,3081,50
49700131,49699225,49701701,2476,3082,50
49706286,49705379,49707540,2161,3083,50
49712124,49711218,49713473,2255,3084,50
49718057,49717151,49720683,3532,3085,50
49725268,49724362,49726618,2256,3086,50
49731202,49730297,49732857,2560,3087,50
49737441,49736535,49739011,2476,3088,50
49743595,49742689,49745165,2476,3089,50
49749749,49748843,49752269,3426,3090,50
49756854,49755948,49758203,2255,3091,50
49762787,49761882,49764136,2254,3092,50
49768936,49767814,49770069,2255,3093,50
49774653,49773747,49775991,2244,3094,50
49780575,49779669,49782462,2793,3095,50
49787046,49786141,49789249,3108,3096,50
49793834,49792928,49796037,3109,3097,50
49800622,49799716,49801971,2255,3098,50
49806772,49805649,49807905,2256,3099,50
49812489,49811583,49813838,2255,3100,50
49818638,49817516,49819770,2254,3101,50
49824571,49823448,49825704,2256,3102,50
49830288,49829382,49831943,2561,3103,50
49836528,49835622,49838730,3108,3104,50
49843315,49842409,49844664,2255,3105,50
49849247,49848342,49851534,3192,3106,50
49856119,49855213,49857468,2255,3107,50
49862052,49861146,49863705,2559,3108,50
49868288,49867383,49870492,3109,3109,50
49875077,49874171,49877597,3426,3110,50
49882182,49881276,49884386,3110,3111,50
49888970,49888065,49890319,2254,3112,50
49894903,49893997,49896241,2244,3113,50
49900825,49899919,49902174,2255,3114,50
49906758,49905852,49908107,2255,3115,50
49912691,49911785,49914346,2561,3116,50
49918931,49918025,49920817,2792,3117,50
49925401,49924496,49927288,2792,3118,50
49931873,49930967,49933222,2255,3119,50
49937806,49936900,49939461,2561,3120,50
49944047,49943140,49945300,2160,3121,50
49949883,49948978,49951452,2474,3122,50
49956036,49955130,49957290,2160,3123,50
49961873,49960968,49963222,2254,3124,50
49967806,49966900,49969460,2560,3125,50
49974045,49973139,49975931,2792,3126,50
49980515,49979609,49982402,2793,3127,50
49986987,49986081,49989506,3425,3128,50
49994091,49993185,49996611,3426,3129,50
50001413,50000290,50002546,2256,3130,50
50007130,50006224,50009754,3530,3131,50
50014339,50013433,50015688,2255,3132,50
50020271,50019366,50022897,3531,3133,50
50027482,50026576,50029684,3108,3134,50
50034268,50033363,50035617,2254,3135,50
50040201,50039295,50042826,3531,3136,50
50047627,50046505,50048760,2255,3137,50
50053344,50052438,50055314,2876,3138,50
50059899,50058993,50062102,3109,3139,50
50066687,50065781,50068036,2255,3140,50
50072619,50071714,50073968,2254,3141,50
50078552,50077646,50080522,2876,3142,50
50085107,50084201,50086994,2793,3143,50
50091578,50090673,50094096,3423,3144,50
50098681,50097775,50100884,3109,3145,50
50105469,50104563,50106818,2255,3146,50
50111402,50110496,50113690,3194,3147,50
50118275,50117369,50119624,2255,3148,50
50124424,50123302,50125557,2255,3149,50
50130141,50129235,50131490,2255,3150,50
50136074,50135169,50137412,2243,3151,50
50141995,50141090,50143344,2254,3152,50
50147928,50147022,50149899,2877,3153,50
50154483,50153578,50155832,2254,3154,50
50160416,50159510,50162071,2561,3155,50
50166656,50165750,50167910,2160,3156,50
50172495,50171589,50173844,2255,3157,50
50178427,50177522,50179765,2243,3158,50
50184565,50183443,50185698,2255,3159,50
50190282,50189376,50192569,3193,3160,50
50197154,50196248,50198724,2476,3161,50
50203308,50202402,50204657,2255,3162,50
50209241,50208335,50211529,3194,3163,50
50216114,50215208,50218634,3426,3164,50
50223219,50222313,50224568,2255,3165,50
50229152,50228246,50231439,3193,3166,50
50236024,50235118,50238228,3110,3167,50
50242812,50241907,50244382,2475,3168,50
50249182,50248060,50250315,2255,3169,50
50254899,50253993,50256248,2255,3170,50
50260832,50259926,50262169,2243,3171,50
50266753,50265847,50269273,3426,3172,50
50273858,50272952,50275208,2256,3173,50
50279792,50278886,50282080,3194,3174,50
50286665,50285759,50288868,3109,3175,50
50293452,50292547,50295656,3109,3176,50
50300241,50299335,50301811,2476,3177,50
50306394,50305489,50307964,2475,3178,50
50312547,50311642,50313800,2158,3179,50
50318600,50317478,50319733,2255,3180,50
50324533,50323411,50325666,2255,3181,50
50330250,50329344,50332221,2877,3182,50
50336806,50335900,50338376,2476,3183,50
50342960,50342054,50344846,2792,3184,50
50349647,50348525,50350780,2255,3185,50
50355365,50354459,50356703,2244,3186,50
50361288,50360382,50363175,2793,3187,50
50367759,50366854,50369013,2159,3188,50
50373597,50372691,50374851,2160,3189,50
50379436,50378530,50381638,3108,3190,50
50386223,50385317,50388427,3110,3191,50
50393012,50392106,50394362,2256,3192,50
50398946,50398040,50400295,2255,3193,50
50404879,50403973,50406216,2243,3194,50
50410801,50409894,50413321,3427,3195,50
50417906,50417000,50419255,2255,3196,50
50423839,50422933,50425189,2256,3197,50
50429773,50428867,50432398,3531,3198,50
50436982,50436077,50438331,2254,3199,50
50442915,50442009,50444264,2255,3200,50
50448848,50447942,50451136,3194,3201,50
50455721,50454815,50457291,2476,3202,50
50461875,50460969,50463445,2476,3203,50
50468028,50467123,50469597,2474,3204,50
50474181,50473275,50476701,3426,3205,50
50481502,50480380,50482635,2255,3206,50
50487219,50486313,50489507,3194,3207,50
50494092,50493186,50495662,2476,3208,50
50500463,50499340,50501596,2256,3209,50
50506180,50505274,50508806,3532,3210,50
50513390,50512484,50514739,2255,3211,50
50519323,50518417,50520978,2561,3212,50
50525563,50524657,50526912,2255,3213,50
50531496,50530590,50532846,2256,3214,50
50537430,50536524,50539717,3193,3215,50
50544302,50543396,50545652,2256,3216,50
50550236,50549330,50551573,2243,3217,50
50556156,50555251,50557409,2158,3218,50
50561994,50561088,50563564,2476,3219,50
50568148,50567242,50569718,2476,3220,50
50574301,50573396,50575554,2158,3221,50
50580138,50579232,50581488,2256,3222,50
50586289,50585166,50587422,2256,3223,50
50592006,50591100,50594293,3193,3224,50
50598877,50597972,50601081,3109,3225,50
50605666,50604760,50607553,2793,3226,50
50612138,50611232,50614340,3108,3227,50
50618925,50618019,50620812,2793,3228,50
50625397,50624491,50627917,3426,3229,50
50632502,50631596,50634072,2476,3230,50
50638656,50637751,50640860,3109,3231,50
50645661,50644539,50646794,2255,3232,50
50651378,50650472,50653666,3194,3233,50
50658251,50657345,50659600,2255,3234,50
50664401,50663278,50665534,2256,3235,50
50670334,50669212,50671467,2255,3236,50
50676051,50675145,50678022,2877,3237,50
50682824,50681701,50683957,2256,3238,50
50688757,50687635,50689890,2255,3239,50
50694474,50693568,50695823,2255,3240,50
50700406,50699501,50702377,2876,3241,50
50706962,50706056,50709482,3426,3242,50
50714067,50713161,50716586,3425,3243,50
50721170,50720265,50723056,2791,3244,50
50727641,50726735,50730161,3426,3245,50
50734746,50733840,50736096,2256,3246,50
50740680,50739774,50742030,2256,3247,50
50746614,50745708,50749240,3532,3248,50
50753825,50752919,50755077,2158,3249,50
50759661,50758755,50762181,3426,3250,50
50766766,50765860,50768336,2476,3251,50
50773136,50772014,50774269,2255,3252,50
50778854,50777948,50780204,2256,3253,50
50784788,50783882,50786138,2256,3254,50
50790723,50789817,50793348,3531,3255,50
50797933,50797027,50799282,2255,3256,50
50804082,50802960,50805215,2255,3257,50
50809799,50808893,50811136,2243,3258,50
50815720,50814814,50817607,2793,3259,50
50822409,50821286,50823542,2256,3260,50
50828126,50827220,50829475,2255,3261,50
50834059,50833153,50836684,3531,3262,50
50841268,50840363,50842618,2255,3263,50
50847202,50846296,50849173,2877,3264,50
50853758,50852852,50856278,3426,3265,50
50860863,50859957,50863066,3109,3266,50
50867651,50866745,50868904,2159,3267,50
50873488,50872582,50876008,3426,3268,50
50880593,50879687,50881847,2160,3269,50
50886431,50885525,50887780,2255,3270,50
50892580,50891458,50893713,2255,3271,50
50898514,50897391,50899647,2256,3272,50
50904231,50903325,50906857,3532,3273,50
50911441,50910536,50913010,2474,3274,50
50917594,50916688,50920114,3426,3275,50
50924699,50923793,50925953,2160,3276,50
50930754,50929632,50931887,2255,3277,50
50936472,50935566,50937822,2256,3278,50
50942406,50941501,50944693,3192,3279,50
50949495,50948372,50950628,2256,3280,50
50955212,50954306,50956549,2243,3281,50
50961132,50960227,50962702,2475,3282,50
50967286,50966380,50969805,3425,3283,50
50974389,50973484,50976275,2791,3284,50
50980859,50979954,50982209,2255,3285,50
50986792,50985887,50988447,2560,3286,50
50993249,50992126,50994382,2256,3287,50
50998965,50998060,51000620,2560,3288,50
51005205,51004299,51007409,3110,3289,50
51011994,51011088,51013247,2159,3290,50
51017832,51016926,51019719,2793,3291,50
51024304,51023398,51026507,3109,3292,50
51031308,51030186,51032441,2255,3293,50
51037025,51036119,51038996,2877,3294,50
51043581,51042675,51044931,2256,3295,50
51049514,51048609,51050852,2243,3296,50
51055436,51054530,51057955,3425,3297,50
51062540,51061634,51063793,2159,3298,50
51068378,51067472,51069632,2160,3299,50
51074216,51073310,51076420,3110,3300,50
51081221,51080099,51082354,2255,3301,50
51087154,51086032,51088287,2255,3302,50
51092871,51091965,51094842,2877,3303,50
51099427,51098521,51100777,2256,3304,50
51105361,51104456,51107332,2876,3305,50
51111917,51111011,51113267,2256,3306,50
51118068,51116945,51119201,2256,3307,50
51123785,51122879,51125123,2244,3308,50
51129707,51128801,51131910,3109,3309,50
51136495,51135589,51137844,2255,3310,50
51142644,51141522,51143777,2255,3311,50
51148361,51147455,51149711,2256,3312,50
51154295,51153389,51155645,2256,3313,50
51160229,51159323,51161579,2256,3314,50
51166163,51165258,51167512,2254,3315,50
51172097,51171191,51173751,2560,3316,50
51178552,51177430,51179685,2255,3317,50
51184269,51183363,51186894,3531,3318,50
51191479,51190573,51192829,2256,3319,50
51197414,51196508,51198764,2256,3320,50
51203349,51202443,51205974,3531,3321,50
51210775,51209652,51211907,2255,3322,50
51216491,51215585,51218778,3193,3323,50
51223363,51222457,51225565,3108,3324,50
51230150,51229244,51231720,2476,3325,50
51236304,51235398,51237653,2255,3326,50
51242236,51241331,51243574,2243,3327,50
51248157,51247252,51249726,2474,3328,50
51254310,51253404,51255659,2255,3329,50
51260243,51259337,51261592,2255,3330,50
51266176,51265270,51267525,2255,3331,50
51272108,51271203,51273762,2559,3332,50
51278346,51277440,51280548,3108,3333,50
51285350,51284227,51286482,2255,3334,50
51291066,51290160,51292403,2243,3335,50
51296986,51296081,51298335,2254,3336,50
51302919,51302013,51304268,2255,3337,50
51308852,51307946,51310190,2244,3338,50
51314774,51313868,51316028,2160,3339,50
51320612,51319706,51322499,2793,3340,50
51327084,51326178,51328433,2255,3341,50
51333016,51332110,51335641,3531,3342,50
51340226,51339320,51341575,2255,3343,50
51346158,51345253,51348782,3529,3344,50
51353366,51352460,51355906,3446,3345,50
51360490,51359584,51363009,3425,3346,50
51367594,51366688,51369164,2476,3347,50
51373965,51372842,51375098,2256,3348,50
51379682,51378776,51382307,3531,3349,50
51386892,51385986,51388241,2255,3350,50
51392825,51391919,51394163,2244,3351,50
51398747,51397841,51400096,2255,3352,50
51404680,51403774,51406029,2255,3353,50
51410613,51409707,51411962,2255,3354,50
51416763,51415640,51417896,2256,3355,50
51422479,51421574,51423828,2254,3356,50
51428411,51427506,51429760,2254,3357,50
51434344,51433438,51435693,2255,3358,50
51440277,51439371,51441626,2255,3359,50
51446210,51445304,51448496,3192,3360,50
51453080,51452175,51455600,3425,3361,50
51460185,51459279,51462070,2791,3362,50
51466654,51465748,51468224,2476,3363,50
51472808,51471902,51474695,2793,3364,50
51479496,51478373,51480629,2256,3365,50
51485213,51484307,51486868,2561,3366,50
51491452,51490546,51492704,2158,3367,50
51497288,51496382,51499491,3109,3368,50
51504075,51503169,51505329,2160,3369,50
51509913,51509007,51512431,3424,3370,50
51517015,51516110,51518364,2254,3371,50
51522948,51522042,51525573,3531,3372,50
51530157,51529251,51531726,2475,3373,50
51536526,51535404,51537658,2254,3374,50
51542459,51541336,51543591,2255,3375,50
51548175,51547269,51550146,2877,3376,50
51554730,51553824,51556933,3109,3377,50
51561518,51560612,51562867,2255,3378,50
51567451,51566545,51569738,3193,3379,50
51574322,51573416,51575576,2160,3380,50
51580377,51579254,51581510,2256,3381,50
51586093,51585188,51588718,3530,3382,50
51593302,51592396,51595821,3425,3383,50
51600406,51599500,51610755,11255,3384,50
51615428,51614522,51616597,2075,3385,50
51621181,51620275,51623067,2792,3386,50
51627652,51626746,51629222,2476,3387,50
51633806,51632900,51636009,3109,3388,50
51640810,51639687,51641942,2255,3389,50
51646526,51645620,51648497,2877,3390,50
51653081,51652175,51654968,2793,3391,50
51659552,51658647,51661438,2791,3392,50
51666023,51665117,51667372,2255,3393,50
51672173,51671050,51673306,2256,3394,50
51677889,51676984,51679238,2254,3395,50
51683822,51682916,51685171,2255,3396,50
51689755,51688849,51691092,2243,3397,50
51695675,51694770,51698216,3446,3398,50
51702801,51701895,51705320,3425,3399,50
51709905,51708999,51711157,2158,3400,50
51715741,51714835,51716995,2160,3401,50
51721579,51720673,51723148,2475,3402,50
51727732,51726826,51730251,3425,3403,50
51734835,51733930,51736089,2159,3404,50
51740673,51739767,51743193,3426,3405,50
51747778,51746872,51749664,2792,3406,50
51754249,51753343,51755598,2255,3407,50
51760182,51759276,51762468,3192,3408,50
51767269,51766147,51768402,2255,3409,50
51772985,51772080,51774334,2254,3410,50
51778917,51778012,51780888,2876,3411,50
51785472,51784566,51786821,2255,3412,50
51791404,51790499,51793692,3193,3413,50
51798277,51797371,51800797,3426,3414,50
51805382,51804476,51806731,2255,3415,50
51811315,51810409,51812664,2255,3416,50
51817248,51816342,51819536,3194,3417,50
51824121,51823215,51825690,2475,3418,50
51830274,51829368,51831844,2476,3419,50
51836645,51835522,51837778,2256,3420,50
51842362,51841456,51843711,2255,3421,50
51848295,51847389,51850266,2877,3422,50
51854851,51853945,51856421,2476,3423,50
51861221,51860099,51862353,2254,3424,50
51866937,51866031,51868274,2243,3425,50
51873075,51871952,51874208,2256,3426,50
51878792,51877886,51880141,2255,3427,50
51884725,51883819,51887013,3194,3428,50
51891815,51890692,51892948,2256,3429,50
51897532,51896626,51899503,2877,3430,50
51904088,51903182,51905437,2255,3431,50
51910021,51909115,51911358,2243,3432,50
51915941,51915036,51917828,2792,3433,50
51922413,51921507,51923762,2255,3434,50
51928346,51927440,51929695,2255,3435,50
51934279,51933373,51935629,2256,3436,50
51940213,51939307,51941867,2560,3437,50
51946452,51945546,51948338,2792,3438,50
51952923,51952017,51954177,2160,3439,50
51958761,51957855,51960963,3108,3440,50
51965548,51964642,51967750,3108,3441,50
51972335,51971429,51973905,2476,3442,50
51978489,51977583,51979743,2160,3443,50
51984327,51983421,51985896,2475,3444,50
51990480,51989574,51991829,2255,3445,50
51996413,51995508,51998384,2876,3446,50
52002968,52002063,52004318,2255,3447,50
52008902,52007996,52010872,2876,3448,50
52015673,52014551,52016806,2255,3449,50
52021389,52020484,52022727,2243,3450,50
52027311,52026405,52028565,2160,3451,50
52033366,52032243,52034499,2256,3452,50
52039083,52038177,52040432,2255,3453,50
52045015,52044110,52047640,3530,3454,50
52052225,52051319,52054111,2792,3455,50
52058912,52057789,52060045,2256,3456,50
52064629,52063723,52065978,2255,3457,50
52070562,52069656,52071899,2243,3458,50
52076483,52075577,52077832,2255,3459,50
52082416,52081510,52085041,3531,3460,50
52089626,52088720,52090975,2255,3461,50
52095558,52094653,52097528,2875,3462,50
52102113,52101207,52104000,2793,3463,50
52108585,52107679,52109934,2255,3464,50
52114517,52113612,52115855,2243,3465,50
52120439,52119533,52121789,2256,3466,50
52126373,52125467,52127722,2255,3467,50
52132306,52131400,52134277,2877,3468,50
52138862,52137956,52141382,3426,3469,50
52145967,52145061,52147854,2793,3470,50
52152440,52151533,52153694,2161,3471,50
52158278,52157372,52159627,2255,3472,50
52164212,52163306,52166500,3194,3473,50
52171084,52170179,52172971,2792,3474,50
52177772,52176650,52178905,2255,3475,50
52183488,52182583,52185459,2876,3476,50
52190260,52189138,52191393,2255,3477,50
52195977,52195071,52197632,2561,3478,50
52202217,52201311,52203566,2255,3479,50
52208150,52207244,52209500,2256,3480,50
52214084,52213178,52215433,2255,3481,50
52220234,52219111,52221367,2256,3482,50
52225951,52225045,52227300,2255,3483,50
52231883,52230978,52233538,2560,3484,50
52238122,52237216,52240642,3426,3485,50
52245443,52244320,52246576,2256,3486,50
52251160,52250254,52252509,2255,3487,50
52257093,52256187,52259717,3530,3488,50
52264302,52263396,52265872,2476,3489,50
52270455,52269550,52271804,2254,3490,50
52276387,52275482,52278357,2875,3491,50
52283159,52282036,52284292,2256,3492,50
52288876,52287970,52290225,2255,3493,50
52294809,52293904,52297434,3530,3494,50
52302019,52301113,52303588,2475,3495,50
52308172,52307266,52309742,2476,3496,50
52314326,52313420,52316846,3426,3497,50
52321647,52320525,52322780,2255,3498,50
52327364,52326458,52328713,2255,3499,50
52333297,52332391,52334646,2255,3500,50
52339230,52338324,52340579,2255,3501,50
52345163,52344257,52346512,2255,3502,50
52351313,52350190,52352446,2256,3503,50
52357247,52356124,52358380,2256,3504,50
52362964,52362058,52364313,2255,3505,50
52368898,52367992,52370247,2255,3506,50
52374831,52373925,52376169,2244,3507,50
52380753,52379847,52382324,2477,3508,50
52386909,52386003,52393924,7921,3509,50
52398509,52397603,52407127,9524,3510,50
52411712,52410806,52413062,2256,3511,50
52417647,52416741,52419935,3194,3512,50
52424520,52423614,52425869,2255,3513,50
52430454,52429548,52432108,2560,3514,50
52436692,52435786,52438041,2255,3515,50
52442623,52441718,52444593,2875,3516,50
52449178,52448272,52450527,2255,3517,50
52455111,52454205,52457735,3530,3518,50
52462319,52461413,52464839,3426,3519,50
52469423,52468517,52470772,2255,3520,50
52475355,52474450,52477643,3193,3521,50
52482228,52481322,52483798,2476,3522,50
52488380,52487475,52489633,2158,3523,50
52494217,52493311,52495566,2255,3524,50
52500150,52499244,52501499,2255,3525,50
52506083,52505177,52508054,2877,3526,50
52512638,52511732,52515157,3425,3527,50
52519741,52518836,52521310,2474,3528,50
52525894,52524988,52527243,2255,3529,50
52531827,52530921,52533164,2243,3530,50
52537748,52536842,52540268,3426,3531,50
52544851,52543946,52546738,2792,3532,50
52551321,52550416,52553524,3108,3533,50
52558108,52557202,52560627,3425,3534,50
52565211,52564305,52566465,2160,3535,50
52571049,52570143,52573569,3426,3536,50
52578153,52577247,52579723,2476,3537,50
52584307,52583401,52586827,3426,3538,50
52591412,52590506,52592761,2255,3539,50
52597344,52596438,52599314,2876,3540,50
52603899,52602993,52606101,3108,3541,50
52610901,52609779,52612033,2254,3542,50
52616616,52615710,52619241,3531,3543,50
52623825,52622920,52626028,3108,3544,50
52630613,52629707,52633133,3426,3545,50
52637718,52636812,52639605,2793,3546,50
52644189,52643283,52645759,2476,3547,50
52650560,52649437,52651692,2255,3548,50
52656493,52655370,52657625,2255,3549,50
52662209,52661303,52664834,3531,3550,50
52669418,52668512,52670767,2255,3551,50
52675351,52674445,52676700,2255,3552,50
52681284,52680378,52682633,2255,3553,50
52687217,52686311,52689842,3531,3554,50
52694426,52693520,52695680,2160,3555,50
52700264,52699358,52701833,2475,3556,50
52706417,52705511,52708620,3109,3557,50
52713205,52712299,52714554,2255,3558,50
52719138,52718232,52721424,3192,3559,50
52726009,52725103,52728528,3425,3560,50
52733113,52732207,52734682,2475,3561,50
52739482,52738360,52740614,2254,3562,50
52745197,52744292,52747485,3193,3563,50
52752286,52751163,52753418,2255,3564,50
52758002,52757096,52759973,2877,3565,50
52764557,52763652,52765810,2158,3566,50
52770394,52769488,52771648,2160,3567,50
52776232,52775326,52778119,2793,3568,50
52782703,52781797,52784273,2476,3569,50
52788857,52787951,52790427,2476,3570,50
52795011,52794105,52796581,2476,3571,50
52801166,52800259,52802515,2256,3572,50
52807098,52806192,52808447,2255,3573,50
52813031,52812125,52814380,2255,3574,50
52818964,52818058,52820934,2876,3575,50
52825518,52824612,52826867,2255,3576,50
52831450,52830545,52833104,2559,3577,50
52837688,52836782,52839891,3109,3578,50
52844476,52843570,52845825,2255,3579,50
52850408,52849502,52852062,2560,3580,50
52856646,52855740,52858215,2475,3581,50
52862798,52861893,52864147,2254,3582,50
52868731,52867825,52871019,3194,3583,50
52875603,52874698,52878122,3424,3584,50
52882706,52881800,52884055,2255,3585,50
52888638,52887733,52889987,2254,3586,50
52894570,52893664,52895919,2255,3587,50
52900503,52899597,52902158,2561,3588,50
52906742,52905836,52908628,2792,3589,50
52913213,52912307,52914562,2255,3590,50
52919145,52918240,52920799,2559,3591,50
52925600,52924477,52926732,2255,3592,50
52931316,52930410,52932665,2255,3593,50
52937248,52936343,52939219,2876,3594,50
52947661,52946755,52949040,2285,3595,50
52953624,52952718,52955827,3109,3596,50
52960412,52959506,52962615,3109,3597,50
52967198,52966293,52968768,2475,3598,50
52973351,52972446,52975554,3108,3599,50
52980138,52979233,52982341,3108,3600,50
52986926,52986020,52989129,3109,3601,50
52993930,52992807,52995062,2255,3602,50
52999645,52998740,53001616,2876,3603,50
53006200,53005294,53008087,2793,3604,50
53012671,53011765,53014241,2476,3605,50
53019042,53017919,53020174,2255,3606,50
53024758,53023852,53026096,2244,3607,50
53030897,53029774,53032030,2256,3608,50
53036614,53035708,53039240,3532,3609,50
53044041,53042919,53045173,2254,3610,50
53049756,53048851,53051410,2559,3611,50
53055993,53055088,53057879,2791,3612,50
53062462,53061557,53063811,2254,3613,50
53068395,53067489,53070683,3194,3614,50
53075268,53074362,53076838,2476,3615,50
53081421,53080516,53082770,2254,3616,50
53087354,53086448,53088703,2255,3617,50
53093287,53092381,53094636,2255,3618,50
53099220,53098314,53101845,3531,3619,50
53106429,53105523,53108316,2793,3620,50
53112901,53111995,53115421,3426,3621,50
53120223,53119100,53121355,2255,3622,50
53125939,53125033,53127276,2243,3623,50
53131860,53130954,53134063,3109,3624,50
53138647,53137742,53139996,2254,3625,50
53144580,53143674,53146551,2877,3626,50
53151136,53150230,53153656,3426,3627,50
53158240,53157334,53159494,2160,3628,50
53164077,53163172,53165426,2254,3629,50
53170010,53169104,53172298,3194,3630,50
53176883,53175977,53178769,2792,3631,50
53183571,53182448,53184704,2256,3632,50
53189288,53188382,53190637,2255,3633,50
53195220,53194315,53196875,2560,3634,50
53201459,53200553,53202808,2255,3635,50
53207392,53206486,53209363,2877,3636,50
53214164,53213042,53215297,2255,3637,50
53219881,53218975,53221218,2243,3638,50
53225802,53224896,53228004,3108,3639,50
53232588,53231682,53233840,2158,3640,50
53238424,53237518,53240311,2793,3641,50
53244895,53243990,53246149,2159,3642,50
53250733,53249827,53252082,2255,3643,50
53256666,53255760,53258015,2255,3644,50
53262598,53261692,53264253,2561,3645,50
53268837,53267931,53270406,2475,3646,50
53274990,53274084,53277510,3426,3647,50
53282095,53281189,53284614,3425,3648,50
53289416,53288293,53290548,2255,3649,50
53295132,53294226,53297420,3194,3650,50
53302221,53301099,53303353,2254,3651,50
53307937,53307031,53309907,2876,3652,50
53314492,53313586,53315841,2255,3653,50
53320641,53319519,53321773,2254,3654,50
53326573,53325451,53327705,2254,3655,50
53332289,53331383,53333638,2255,3656,50
53338221,53337316,53340192,2876,3657,50
53344777,53343871,53346664,2793,3658,50
53351249,53350343,53352501,2158,3659,50
53357086,53356179,53358435,2256,3660,50
53363019,53362113,53364673,2560,3661,50
53369473,53368351,53370606,2255,3662,50
53375190,53374284,53377476,3192,3663,50
53382061,53381155,53383947,2792,3664,50
53388748,53387625,53389881,2256,3665,50
53394465,53393559,53396436,2877,3666,50
53401021,53400115,53402275,2160,3667,50
53406859,53405953,53408208,2255,3668,50
53412792,53411886,53414141,2255,3669,50
53418725,53417819,53420696,2877,3670,50
53425280,53424375,53427167,2792,3671,50
53431752,53430846,53434272,3426,3672,50
53438856,53437951,53440743,2792,3673,50
53445327,53444421,53446580,2159,3674,50
53451164,53450258,53452513,2255,3675,50
53457313,53456191,53458445,2254,3676,50
53463029,53462123,53464366,2243,3677,50
53468950,53468044,53470519,2475,3678,50
53475103,53474197,53476990,2793,3679,50
53481574,53480669,53482828,2159,3680,50
53487412,53486506,53488761,2255,3681,50
53493344,53492439,53494681,2242,3682,50
53499265,53498359,53500614,2255,3683,50
53505198,53504292,53506547,2255,3684,50
53511348,53510225,53512481,2256,3685,50
53517065,53516159,53518414,2255,3686,50
53522997,53522092,53524652,2560,3687,50
53529236,53528331,53530489,2158,3688,50
53535073,53534167,53537275,3108,3689,50
53541859,53540954,53544399,3445,3690,50
53548983,53548078,53550869,2791,3691,50
53555454,53554548,53557657,3109,3692,50
53562458,53561336,53563591,2255,3693,50
53568175,53567269,53569513,2244,3694,50
53574097,53573191,53576301,3110,3695,50
53580885,53579980,53582234,2254,3696,50
53586818,53585912,53588472,2560,3697,50
53593057,53592151,53594406,2255,3698,50
53598989,53598084,53601614,3530,3699,50
53606198,53605293,53608085,2792,3700,50
53612669,53611763,53614239,2476,3701,50
53618823,53617917,53620173,2256,3702,50
53624757,53623851,53626095,2244,3703,50
53630679,53629773,53632249,2476,3704,50
53636833,53635927,53638182,2255,3705,50
53642766,53641860,53645391,3531,3706,50
53650192,53649070,53651325,2255,3707,50
53655909,53655003,53657880,2877,3708,50
53662465,53661559,53664352,2793,3709,50
53668937,53668031,53670190,2159,3710,50
53674773,53673868,53676027,2159,3711,50
53680611,53679705,53682497,2792,3712,50
53687082,53686176,53689602,3426,3713,50
53694186,53693280,53695536,2256,3714,50
53700120,53699214,53701458,2244,3715,50
53706041,53705136,53707294,2158,3716,50
53711878,53710972,53713764,2792,3717,50
53718349,53717443,53720236,2793,3718,50
53724821,53723915,53726391,2476,3719,50
53730975,53730069,53732228,2159,3720,50
53736812,53735906,53738382,2476,3721,50
53742966,53742060,53744536,2476,3722,50
53749120,53748214,53750374,2160,3723,50
53754957,53754052,53756306,2254,3724,50
53760889,53759984,53762238,2254,3725,50
53766822,53765916,53768792,2876,3726,50
53773375,53772470,53774724,2254,3727,50
53779307,53778402,53781277,2875,3728,50
53786078,53784955,53787210,2255,3729,50
53791794,53790888,53794080,3192,3730,50
53798881,53797758,53800013,2255,3731,50
53804596,53803691,53806883,3192,3732,50
53811468,53810562,53813353,2791,3733,50
53817937,53817031,53819823,2792,3734,50
53824407,53823501,53825756,2255,3735,50
53830341,53829434,53831996,2562,3736,50
53836579,53835674,53839099,3425,3737,50
53843684,53842778,53846204,3426,3738,50
53850788,53849883,53852137,2254,3739,50
53856720,53855815,53858058,2243,3740,50
53862642,53861736,53864212,2476,3741,50
53868795,53867890,53870364,2474,3742,50
53875165,53874042,53876298,2256,3743,50
53880882,53879976,53883170,3194,3744,50
53887755,53886849,53889642,2793,3745,50
53894227,53893321,53895797,2476,3746,50
53900381,53899475,53901635,2160,3747,50
53906218,53905313,53908758,3445,3748,50
53913343,53912437,53914913,2476,3749,50
53919496,53918591,53922037,3446,3750,50
53926622,53925716,53928508,2792,3751,50
53933092,53932186,53934661,2475,3752,50
53939245,53938339,53940594,2255,3753,50
53945177,53944272,53947486,3214,3754,50
53952070,53951165,53953957,2792,3755,50
53958541,53957636,53961060,3424,3756,50
53965645,53964739,53966994,2255,3757,50
53971794,53970672,53972926,2254,3758,50
53977510,53976604,53978848,2244,3759,50
53983432,53982526,53985318,2792,3760,50
53989903,53988997,53991252,2255,3761,50
53995835,53994930,53997184,2254,3762,50
54001768,54000862,54004055,3193,3763,50
54008857,54007734,54009990,2256,3764,50
54014574,54013668,54015923,2255,3765,50
54020507,54019601,54021856,2255,3766,50
54026656,54025534,54027789,2255,3767,50
54032589,54031467,54033722,2255,3768,50
54038306,54037400,54040594,3194,3769,50
54045179,54044273,54046528,2255,3770,50
54051112,54050206,54053082,2876,3771,50
54057667,54056761,54059237,2476,3772,50
54063821,54062915,54066024,3109,3773,50
54070608,54069703,54073126,3423,3774,50
54077926,54076804,54079058,2254,3775,50
54083858,54082736,54084990,2254,3776,50
54089574,54088668,54091228,2560,3777,50
54095811,54094906,54098014,3108,3778,50
54102598,54101692,54103852,2160,3779,50
54108436,54107530,54109689,2159,3780,50
54114273,54113367,54115525,2158,3781,50
54120326,54119203,54121458,2255,3782,50
54126259,54125136,54127392,2256,3783,50
54131976,54131070,54133325,2255,3784,50
54137909,54137003,54140197,3194,3785,50
54144782,54143876,54146034,2158,3786,50
54150617,54149712,54152503,2791,3787,50
54157088,54156182,54159290,3108,3788,50
54163875,54162969,54165445,2476,3789,50
54170028,54169123,54171281,2158,3790,50
54175866,54174959,54177752,2793,3791,50
54182336,54181430,54184539,3109,3792,50
54189124,54188218,54190473,2255,3793,50
54195057,54194151,54196394,2243,3794,50
54200978,54200072,54202327,2255,3795,50
54206911,54206005,54208249,2244,3796,50
54212833,54211927,54214087,2160,3797,50
54218671,54217765,54220875,3110,3798,50
54225460,54224554,54226714,2160,3799,50
54231514,54230392,54232647,2255,3800,50
54237230,54236325,54239517,3192,3801,50
54244102,54243196,54246305,3109,3802,50
54251107,54249984,54252240,2256,3803,50
54256824,54255918,54258173,2255,3804,50
54262756,54261851,54265065,3214,3805,50
54269650,54268744,54271220,2476,3806,50
54275803,54274898,54277152,2254,3807,50
54281735,54280830,54283084,2254,3808,50
54287668,54286762,54289006,2244,3809,50
54293590,54292684,54294843,2159,3810,50
54299427,54298521,54301312,2791,3811,50
54305897,54304991,54307246,2255,3812,50
54311830,54310924,54314455,3531,3813,50
54319040,54318134,54320927,2793,3814,50
54325728,54324606,54326861,2255,3815,50
54331445,54330539,54332794,2255,3816,50
54337594,54336472,54338727,2255,3817,50
54343311,54342405,54344649,2244,3818,50
54349450,54348327,54350582,2255,3819,50
54355382,54354260,54356514,2254,3820,50
54361097,54360192,54363405,3213,3821,50
54367990,54367084,54369244,2160,3822,50
54373829,54372923,54376349,3426,3823,50
54380933,54380028,54382282,2254,3824,50
54386867,54385961,54388838,2877,3825,50
54393423,54392517,54394677,2160,3826,50
54399477,54398355,54400610,2255,3827,50
54405193,54404288,54407501,3213,3828,50
54412085,54411179,54413655,2476,3829,50
54418240,54417333,54419589,2256,3830,50
54424173,54423267,54426144,2877,3831,50
54430728,54429823,54431981,2158,3832,50
54436565,54435659,54439085,3426,3833,50
54443669,54442763,54445555,2792,3834,50
54450140,54449234,54452343,3109,3835,50
54456928,54456022,54458277,2255,3836,50
54462861,54461955,54465149,3194,3837,50
54469734,54468828,54472254,3426,3838,50
54476837,54475932,54478186,2254,3839,50
54482770,54481864,54485394,3530,3840,50
54489978,54489072,54491548,2476,3841,50
54496132,54495226,54497481,2255,3842,50
54502281,54501159,54503414,2255,3843,50
54507998,54507092,54509968,2876,3844,50
54514552,54513646,54516439,2793,3845,50
54521022,54520117,54522909,2792,3846,50
54527493,54526587,54528842,2255,3847,50
54533425,54532520,54535733,3213,3848,50
54540318,54539412,54541887,2475,3849,50
54546471,54545565,54548674,3109,3850,50
54553257,54552352,54554511,2159,3851,50
54559095,54558189,54560665,2476,3852,50
54565249,54564343,54566598,2255,3853,50
54571182,54570276,54572531,2255,3854,50
54577114,54576209,54578451,2242,3855,50
54583034,54582129,54585554,3425,3856,50
54590138,54589232,54592657,3425,3857,50
54597459,54596336,54598592,2256,3858,50
54603176,54602270,54605802,3532,3859,50
54610386,54609480,54611735,2255,3860,50
54616319,54615413,54617974,2561,3861,50
54622559,54621653,54623813,2160,3862,50
54628397,54627491,54629746,2255,3863,50
54634330,54633424,54635668,2244,3864,50
54640252,54639346,54641822,2476,3865,50
54646406,54645500,54647976,2476,3866,50
54652777,54651654,54653910,2256,3867,50
54658493,54657588,54660146,2558,3868,50
54664730,54663824,54666079,2255,3869,50
54670663,54669757,54672317,2560,3870,50
54676901,54675995,54678787,2792,3871,50
54683372,54682466,54685574,3108,3872,50
54690375,54689253,54691508,2255,3873,50
54696308,54695186,54697441,2255,3874,50
54702241,54701119,54703374,2255,3875,50
54708174,54707052,54709307,2255,3876,50
54713891,54712985,54716516,3531,3877,50
54721100,54720195,54723620,3425,3878,50
54728204,54727298,54729458,2160,3879,50
54734041,54733136,54736561,3425,3880,50
54741144,54740239,54743030,2791,3881,50
54747615,54746709,54749817,3108,3882,50
54754401,54753496,54756921,3425,3883,50
54761506,54760600,54763076,2476,3884,50
54767660,54766754,54770180,3426,3885,50
54774765,54773859,54777284,3425,3886,50
54781869,54780963,54783122,2159,3887,50
54787922,54786800,54789054,2254,3888,50
54793638,54792732,54794987,2255,3889,50
54799571,54798665,54801859,3194,3890,50
54806444,54805538,54808013,2475,3891,50
54812597,54811691,54814167,2476,3892,50
54818751,54817845,54820100,2255,3893,50
54824901,54823778,54826034,2256,3894,50
54830618,54829712,54831967,2255,3895,50
54836551,54835645,54837900,2255,3896,50
54842484,54841578,54843822,2244,3897,50
54848406,54847501,54850925,3424,3898,50
54855510,54854604,54857080,2476,3899,50
54861664,54860758,54862917,2159,3900,50
54867502,54866596,54868756,2160,3901,50
54873340,54872434,54874689,2255,3902,50
54879272,54878367,54881244,2877,3903,50
54885829,54884923,54887178,2255,3904,50
54891761,54890856,54893110,2254,3905,50
54897694,54896788,54899349,2561,3906,50
54903933,54903027,54905187,2160,3907,50
54909771,54908865,54911340,2475,3908,50
54915923,54915018,54918463,3445,3909,50
54923047,54922142,54924397,2255,3910,50
54928981,54928075,54931606,3531,3911,50
54936191,54935285,54937444,2159,3912,50
54942028,54941122,54943377,2255,3913,50
54947960,54947055,54950585,3530,3914,50
54955170,54954264,54957056,2792,3915,50
54961640,54960735,54962989,2254,3916,50
54967573,54966667,54969544,2877,3917,50
54974129,54973223,54975382,2159,3918,50
54980183,54979060,54981316,2256,3919,50
54985899,54984994,54987248,2254,3920,50
54992049,54990926,54993181,2255,3921,50
54997765,54996859,54999736,2877,3922,50
55004320,55003415,55006839,3424,3923,50
55011424,55010518,55013311,2793,3924,50
55017896,55016990,55019246,2256,3925,50
55023829,55022924,55026454,3530,3926,50
55031038,55030133,55032609,2476,3927,50
55037410,55036287,55038543,2256,3928,50
55043128,55042222,55044466,2244,3929,50
55049050,55048144,55050620,2476,3930,50
55055203,55054298,55056773,2475,3931,50
55061357,55060451,55062706,2255,3932,50
55067290,55066384,55068944,2560,3933,50
55073528,55072622,55075730,3108,3934,50
55080314,55079409,55082201,2792,3935,50
55086786,55085880,55088989,3109,3936,50
55093574,55092668,55095144,2476,3937,50
55099728,55098822,55101077,2255,3938,50
55105661,55104755,55108286,3531,3939,50
55112871,55111965,55115074,3109,3940,50
55119659,55118753,55121229,2476,3941,50
55125813,55124907,55127066,2159,3942,50
55131650,55130744,55132999,2255,3943,50
55137582,55136677,55139891,3214,3944,50
55144476,55143570,55146679,3109,3945,50
55151264,55150358,55152517,2159,3946,50
55157101,55156195,55158988,2793,3947,50
55163573,55162667,55164827,2160,3948,50
55169410,55168505,55170759,2254,3949,50
55175559,55174437,55176692,2255,3950,50
55181276,55180370,55183563,3193,3951,50
55188148,55187242,55190352,3110,3952,50
55195153,55194031,55196286,2255,3953,50
55200870,55199964,55202841,2877,3954,50
55207426,55206520,55209945,3425,3955,50
55214529,55213623,55215878,2255,3956,50
55220462,55219556,55221811,2255,3957,50
55226395,55225489,55229021,3532,3958,50
55233605,55232700,55235808,3108,3959,50
55240393,55239487,55241742,2255,3960,50
55246542,55245420,55247675,2255,3961,50
55252259,55251353,55254546,3193,3962,50
55259131,55258225,55260384,2159,3963,50
55264968,55264062,55267171,3109,3964,50
55271756,55270850,55273010,2160,3965,50
55277594,55276688,55278848,2160,3966,50
55283431,55282526,55284780,2254,3967,50
55289364,55288458,55290713,2255,3968,50
55295296,55294391,55296645,2254,3969,50
55301446,55300323,55302578,2255,3970,50
55307162,55306256,55308815,2559,3971,50
55313616,55312493,55314748,2255,3972,50
55319549,55318426,55320681,2255,3973,50
55325265,55324359,55327889,3530,3974,50
55332474,55331568,55333823,2255,3975,50
55338407,55337501,55340061,2560,3976,50
55344645,55343739,55346848,3109,3977,50
55351433,55350527,55353636,3109,3978,50
55358220,55357315,55359790,2475,3979,50
55364374,55363468,55365627,2159,3980,50
55370211,55369305,55372731,3426,3981,50
55377316,55376410,55378569,2159,3982,50
55383153,55382247,55385356,3109,3983,50
55389941,55389035,55391827,2792,3984,50
55396412,55395506,55398298,2792,3985,50
55402883,55401977,55405086,3109,3986,50
55409888,55408765,55411021,2256,3987,50
55415604,55414699,55417258,2559,3988,50
55421843,55420936,55423192,2256,3989,50
55427775,55426870,55429124,2254,3990,50
55433708,55432802,55435057,2255,3991,50
55439640,55438735,55440989,2254,3992,50
55445572,55444667,55447860,3193,3993,50
55452445,55451539,55454648,3109,3994,50
55459233,55458327,55460803,2476,3995,50
55465386,55464481,55467589,3108,3996,50
55472174,55471268,55473744,2476,3997,50
55478328,55477422,55480532,3110,3998,50
55485334,55484211,55486467,2256,3999,50
55491268,55490145,55492401,2256,4000,50
55497201,55496079,55498334,2255,4001,50
55502918,55502012,55504267,2255,4002,50
55509068,55507945,55510201,2256,4003,50
55514785,55513879,55517073,3194,4004,50
55521874,55520752,55523007,2255,4005,50
55527591,55526685,55528940,2255,4006,50
55533524,55532618,55535495,2877,4007,50
55540080,55539174,55541966,2792,4008,50
55546551,55545645,55547900,2255,4009,50
55552701,55551578,55553833,2255,4010,50
55558417,55557511,55559754,2243,4011,50
55564338,55563432,55566857,3425,4012,50
55571659,55570536,55572792,2256,4013,50
55577376,55576470,55579664,3194,4014,50
55584248,55583343,55586451,3108,4015,50
55591036,55590130,55592385,2255,4016,50
55596969,55596063,55599595,3532,4017,50
55604179,55603274,55606382,3108,4018,50
55610967,55610061,55612316,2255,4019,50
55616899,55615994,55618870,2876,4020,50
55623455,55622549,55624709,2160,4021,50
55629293,55628387,55631812,3425,4022,50
55636396,55635491,55637966,2475,4023,50
55642550,55641644,55644436,2792,4024,50
55649021,55648115,55650371,2256,4025,50
55654954,55654049,55656303,2254,4026,50
55660888,55659982,55663513,3531,4027,50
55668098,55667192,55669352,2160,4028,50
55673936,55673030,55675823,2793,4029,50
55680408,55679502,55682927,3425,4030,50
55687728,55686606,55688861,2255,4031,50
55693445,55692539,55694783,2244,4032,50
55699583,55698461,55700716,2255,4033,50
55705300,55704394,55706954,2560,4034,50
55711538,55710632,55713423,2791,4035,50
55718008,55717102,55719357,2255,4036,50
55723941,55723035,55725278,2243,4037,50
55729862,55728956,55731432,2476,4038,50
55736016,55735110,55737365,2255,4039,50
55741949,55741043,55743286,2243,4040,50
55747870,55746964,55749757,2793,4041,50
55754341,55753435,55755594,2159,4042,50
55760178,55759272,55762698,3426,4043,50
55767283,55766377,55769803,3426,4044,50
55774387,55773481,55776591,3110,4045,50
55781392,55780270,55782525,2255,4046,50
55787109,55786203,55789079,2876,4047,50
55793664,55792758,55795550,2792,4048,50
55800351,55799229,55801484,2255,4049,50
55806068,55805162,55808039,2877,4050,50
55812624,55811718,55813878,2160,4051,50
55818679,55817556,55819811,2255,4052,50
55824395,55823489,55825744,2255,4053,50
55830544,55829422,55831677,2255,4054,50
55836478,55835355,55837611,2256,4055,50
55842194,55841289,55844482,3193,4056,50
55849066,55848160,55850635,2475,4057,50
55855219,55854313,55856568,2255,4058,50
55861151,55860246,55862500,2254,4059,50
55867084,55866178,55869393,3215,4060,50
55873978,55873072,55876180,3108,4061,50
55880981,55879859,55882114,2255,4062,50
55886698,55885792,55888352,2560,4063,50
55892937,55892031,55894823,2792,4064,50
55899407,55898502,55901610,3108,4065,50
55906195,55905289,55907765,2476,4066,50
55912349,55911443,55913919,2476,4067,50
55918503,55917597,55919852,2255,4068,50
55924436,55923530,55925774,2244,4069,50
55930575,55929452,55931708,2256,4070,50
55936291,55935386,55937640,2254,4071,50
55942224,55941318,55943878,2560,4072,50
55948463,55947557,55950983,3426,4073,50
55955568,55954662,55956917,2255,4074,50
55961717,55960595,55962849,2254,4075,50
55967433,55966527,55969087,2560,4076,50
55973888,55972766,55975021,2255,4077,50
55979605,55978699,55981893,3194,4078,50
55986478,55985572,55988997,3425,4079,50
55993581,55992676,55995784,3108,4080,50
56000369,55999463,56001718,2255,4081,50
56006302,56005396,56007956,2560,4082,50
56012540,56011634,56013793,2159,4083,50
56018377,56017471,56019631,2160,4084,50
56024215,56023309,56025564,2255,4085,50
56030148,56029242,56031486,2244,4086,50
56036069,56035164,56038272,3108,4087,50
56042857,56041951,56044426,2475,4088,50
56049010,56048104,56051213,3109,4089,50
56055797,56054891,56058317,3426,4090,50
56062902,56061996,56064155,2159,4091,50
56068738,56067833,56070087,2254,4092,50
56074670,56073765,56076979,3214,4093,50
56081563,56080657,56083766,3109,4094,50
56088350,56087444,56089699,2255,4095,50
56094283,56093377,56096571,3194,4096,50
56101155,56100249,56103358,3109,4097,50
56107943,56107037,56109292,2255,4098,50
56113876,56112970,56115214,2244,4099,50
56119798,56118892,56122001,3109,4100,50
56126586,56125680,56127935,2255,4101,50
56132520,56131613,56133869,2256,4102,50
56138453,56137547,56139802,2255,4103,50
56144603,56143480,56145736,2256,4104,50
56150320,56149414,56151669,2255,4105,50
56156253,56155347,56157591,2244,4106,50
56162175,56161269,56163429,2160,4107,50
56168230,56167107,56169362,2255,4108,50
56173945,56173040,56175294,2254,4109,50
56179878,56178972,56181848,2876,4110,50
56186433,56185527,56187782,2255,4111,50
56192366,56191460,56193704,2244,4112,50
56198288,56197382,56200808,3426,4113,50
56205393,56204487,56206742,2255,4114,50
56211543,56210420,56212676,2256,4115,50
56217260,56216354,56218610,2256,4116,50
56223194,56222288,56225482,3194,4117,50
56230067,56229161,56231638,2477,4118,50
56236222,56235316,56237572,2256,4119,50
56242156,56241250,56243505,2255,4120,50
56248089,56247183,56250715,3532,4121,50
56255299,56254394,56257502,3108,4122,50
56262087,56261181,56264290,3109,4123,50
56268875,56267969,56270224,2255,4124,50
56274808,56273902,56276158,2256,4125,50
56280742,56279836,56282080,2244,4126,50
56286664,56285758,56288867,3109,4127,50
56293452,56292546,56294705,2159,4128,50
56299507,56298384,56300640,2256,4129,50
56305224,56304318,56307512,3194,4130,50
56312096,56311191,56314616,3425,4131,50
56319201,56318295,56321404,3109,4132,50
56325989,56325083,56327875,2792,4133,50
56332460,56331554,56333809,2255,4134,50
56338393,56337487,56340680,3193,4135,50
56345264,56344358,56346518,2160,4136,50
56351101,56350196,56352355,2159,4137,50
56356939,56356033,56359458,3425,4138,50
56364041,56363136,56365294,2158,4139,50
56369878,56368972,56371227,2255,4140,50
56375811,56374905,56377781,2876,4141,50
56382582,56381459,56383714,2255,4142,50
56388298,56387392,56389952,2560,4143,50
56394536,56393630,56396421,2791,4144,50
56401006,56400100,56402259,2159,4145,50
56406843,56405937,56408192,2255,4146,50
56412993,56411870,56414125,2255,4147,50
56418925,56417803,56420058,2255,4148,50
56424642,56423736,56426612,2876,4149,50
56431197,56430291,56432546,2255,4150,50
56437130,56436224,56438479,2255,4151,50
56443063,56442157,56444412,2255,4152,50
56448996,56448090,56450967,2877,4153,50
56455550,56454645,56458091,3446,4154,50
56462676,56461770,56463929,2159,4155,50
56468513,56467607,56470083,2476,4156,50
56474667,56473761,56477144,3383,4157,50
56481729,56480823,56484248,3425,4158,50
56488833,56487927,56499815,11888,4159,50
56504489,56503583,56505838,2255,4160,50
56510422,56509516,56512709,3193,4161,50
56517294,56516388,56519181,2793,4162,50
56523766,56522860,56525019,2159,4163,50
56529602,56528697,56531805,3108,4164,50
56536389,56535483,56537958,2475,4165,50
56542542,56541636,56545061,3425,4166,50
56549646,56548740,56550899,2159,4167,50
56555699,56554577,56556832,2255,4168,50
56561416,56560510,56562765,2255,4169,50
56567349,56566443,56569953,3510,4170,50
56574537,56573631,56576740,3109,4171,50
56581325,56580419,56582895,2476,4172,50
56587695,56586573,56588828,2255,4173,50
56593412,56592506,56595382,2876,4174,50
56599966,56599060,56602486,3426,4175,50
56607286,56606164,56608419,2255,4176,50
56613220,56612097,56614352,2255,4177,50
56619153,56618030,56620286,2256,4178,50
56625087,56623964,56626220,2256,4179,50
56630804,56629899,56632153,2254,4180,50
56636736,56635831,56638391,2560,4181,50
56642976,56642070,56644545,2475,4182,50
56649130,56648223,56650383,2160,4183,50
56654967,56654061,56656316,2255,4184,50
56660899,56659994,56662553,2559,4185,50
56667136,56666231,56668486,2255,4186,50
56673069,56672164,56674407,2243,4187,50
56678991,56678085,56680340,2255,4188,50
56684924,56684018,56687550,3532,4189,50
56692135,56691229,56693484,2255,4190,50
56698068,56697162,56699406,2244,4191,50
56703990,56703084,56706510,3426,4192,50
56711094,56710189,56712443,2254,4193,50
56717027,56716121,56718998,2877,4194,50
56723583,56722677,56725470,2793,4195,50
56730272,56729149,56731404,2255,4196,50
56735988,56735082,56737643,2561,4197,50
56742444,56741322,56743577,2255,4198,50
56748160,56747255,56749509,2254,4199,50
56754093,56753187,56755431,2244,4200,50
56760015,56759109,56762535,3426,4201,50
56767120,56766214,56769324,3110,4202,50
56773909,56773003,56776112,3109,4203,50
56780697,56779791,56782584,2793,4204,50
56787169,56786263,56788518,2255,4205,50
56793102,56792196,56795073,2877,4206,50
56799658,56798752,56800911,2159,4207,50
56805495,56804589,56806748,2159,4208,50
56811332,56810426,56812901,2475,4209,50
56817485,56816579,56818738,2159,4210,50
56823322,56822416,56824671,2255,4211,50
56829255,56828349,56830592,2243,4212,50
56835176,56834271,56836525,2254,4213,50
56841109,56840203,56843080,2877,4214,50
56847882,56846759,56849015,2256,4215,50
56853598,56852693,56854947,2254,4216,50
56859748,56858625,56860881,2256,4217,50
56865465,56864559,56866814,2255,4218,50
56871398,56870492,56874023,3531,4219,50
56878607,56877701,56880494,2793,4220,50
56885296,56884173,56886429,2256,4221,50
56891229,56890107,56892362,2255,4222,50
56896946,56896040,56898917,2877,4223,50
56903501,56902595,56905388,2793,4224,50
56909972,56909067,56911226,2159,4225,50
56916026,56914904,56917159,2255,4226,50
56921743,56920837,56924368,3531,4227,50
56928953,56928047,56930523,2476,4228,50
56935107,56934201,56936994,2793,4229,50
56941579,56940673,56942831,2158,4230,50
56947415,56946509,56949302,2793,4231,50
56953886,56952981,56956090,3109,4232,50
56960675,56959769,56962024,2255,4233,50
56966607,56965702,56968894,3192,4234,50
56973695,56972573,56974828,2255,4235,50
56979412,56978506,56980761,2255,4236,50
56985562,56984439,56986695,2256,4237,50
56991279,56990373,56993250,2877,4238,50
56997835,56996929,56999722,2793,4239,50
57004307,57003401,57006192,2791,4240,50
57010777,57009871,57012127,2256,4241,50
57016711,57015805,57018060,2255,4242,50
57022644,57021738,57023993,2255,4243,50
57028577,57027671,57030548,2877,4244,50
57035133,57034227,57036387,2160,4245,50
57040971,57040065,57042320,2255,4246,50
57046904,57045998,57048558,2560,4247,50
57053143,57052237,57054712,2475,4248,50
57059297,57058391,57060646,2255,4249,50
57065230,57064324,57067856,3532,4250,50
57072441,57071535,57073790,2255,4251,50
57078374,57077468,57080998,3530,4252,50
57085583,57084677,57086932,2255,4253,50
57091517,57090611,57092866,2255,4254,50
57097449,57096544,57099419,2875,4255,50
57104004,57103098,57105353,2255,4256,50
57109937,57109031,57111274,2243,4257,50
57115858,57114952,57117744,2792,4258,50
57122546,57121423,57123679,2256,4259,50
57128263,57127357,57130888,3531,4260,50
57135473,57134567,57137992,3425,4261,50
57142576,57141671,57144463,2792,4262,50
57149265,57148142,57150398,2256,4263,50
57154982,57154076,57156953,2877,4264,50
57161538,57160632,57162792,2160,4265,50
57167376,57166470,57168725,2255,4266,50
57173309,57172403,57174964,2561,4267,50
57179549,57178643,57181752,3109,4268,50
57186336,57185431,57187686,2255,4269,50
57192269,57191364,57193607,2243,4270,50
57198191,57197285,57199541,2256,4271,50
57204124,57203219,57206750,3531,4272,50
57211335,57210429,57213538,3109,4273,50
57218123,57217217,57220326,3109,4274,50
57224911,57224005,57226165,2160,4275,50
57230749,57229843,57232635,2792,4276,50
57237220,57236314,57239423,3109,4277,50
57244008,57243102,57245357,2255,4278,50
57249940,57249035,57251277,2242,4279,50
57255861,57254955,57258380,3425,4280,50
57262965,57262059,57264315,2256,4281,50
57268898,57267993,57270247,2254,4282,50
57274831,57273926,57276802,2876,4283,50
57281387,57280481,57283590,3109,4284,50
57288175,57287269,57289524,2255,4285,50
57294325,57293203,57295458,2255,4286,50
57300042,57299136,57302013,2877,4287,50
57306814,57305692,57307947,2255,4288,50
57312531,57311625,57313869,2244,4289,50
57318454,57317548,57319804,2256,4290,50
57324388,57323482,57326041,2559,4291,50
57330625,57329719,57331879,2160,4292,50
57336463,57335558,57338350,2792,4293,50
57342935,57342029,57345137,3108,4294,50
57349722,57348816,57352242,3426,4295,50
57356827,57355921,57359030,3109,4296,50
57363615,57362709,57364964,2255,4297,50
57369547,57368642,57371835,3193,4298,50
57376420,57375514,57377674,2160,4299,50
57382258,57381352,57383512,2160,4300,50
57388095,57387190,57390614,3424,4301,50
57395199,57394293,57397403,3110,4302,50
57401988,57401082,57403242,2160,4303,50
57407826,57406920,57409397,2477,4304,50
57413981,57413075,57415234,2159,4305,50
57419819,57418913,57422339,3426,4306,50
57426924,57426018,57428811,2793,4307,50
57433395,57432489,57434965,2476,4308,50
57439549,57438643,57442069,3426,4309,50
57446654,57445748,57448003,2255,4310,50
57452804,57451681,57453937,2256,4311,50
57458521,57457615,57459859,2244,4312,50
57464443,57463537,57466329,2792,4313,50
57470914,57470008,57472168,2160,4314,50
57476752,57475846,57479271,3425,4315,50
57483856,57482950,57485205,2255,4316,50
57489789,57488883,57491443,2560,4317,50
57496244,57495122,57497377,2255,4318,50
57501961,57501055,57503298,2243,4319,50
57507883,57506976,57509232,2256,4320,50
57513816,57512910,57515471,2561,4321,50
57520056,57519150,57522259,3109,4322,50
57526844,57525938,57528731,2793,4323,50
57533315,57532410,57534664,2254,4324,50
57539248,57538342,57540586,2244,4325,50
57545169,57544264,57547689,3425,4326,50
57552273,57551368,57553622,2254,4327,50
57558206,57557300,57559555,2255,4328,50
57564139,57563233,57565488,2255,4329,50
57570072,57569166,57572698,3532,4330,50
57577283,57576377,57579486,3109,4331,50
57584071,57583165,57586273,3108,4332,50
57590858,57589952,57593378,3426,4333,50
57597963,57597057,57599312,2255,4334,50
57603897,57602990,57605867,2877,4335,50
57610452,57609546,57612970,3424,4336,50
57617554,57616648,57618808,2160,4337,50
57623392,57622486,57625595,3109,4338,50
57630180,57629274,57632699,3425,4339,50
57637501,57636378,57638633,2255,4340,50
57643217,57642311,57644555,2244,4341,50
57649139,57648233,57650709,2476,4342,50
57655293,57654387,57656642,2255,4343,50
57661442,57660320,57662575,2255,4344,50
57667376,57666253,57668509,2256,4345,50
57673093,57672187,57675718,3531,4346,50
57680302,57679396,57682822,3426,4347,50
57687405,57686500,57689292,2792,4348,50
57694093,57692970,57695225,2255,4349,50
57699809,57698903,57702434,3531,4350,50
57707018,57706112,57708367,2255,4351,50
57713167,57712045,57714299,2254,4352,50
57718883,57717977,57720221,2244,4353,50
57724805,57723899,57726375,2476,4354,50
57730959,57730053,57733162,3109,4355,50
57737747,57736841,57739317,2476,4356,50
57744118,57742995,57745250,2255,4357,50
57749834,57748928,57751804,2876,4358,50
57756389,57755483,57757738,2255,4359,50
57762322,57761416,57764947,3531,4360,50
57769531,57768625,57770784,2159,4361,50
57775368,57774462,57776717,2255,4362,50
57781517,57780395,57782650,2255,4363,50
57787234,57786328,57788583,2255,4364,50
57793166,57792261,57794504,2243,4365,50
57799088,57798182,57800975,2793,4366,50
57805559,57804653,57807128,2475,4367,50
57811711,57810806,57812965,2159,4368,50
57817549,57816643,57818898,2255,4369,50
57823482,57822576,57824819,2243,4370,50
57829403,57828497,57831607,3110,4371,50
57836191,57835286,57838078,2792,4372,50
57842663,57841757,57844866,3109,4373,50
57849451,57848545,57851654,3109,4374,50
57856239,57855333,57857491,2158,4375,50
57862075,57861169,57863329,2160,4376,50
57867913,57867007,57870433,3426,4377,50
57875017,57874111,57876366,2255,4378,50
57880950,57880044,57882605,2561,4379,50
57887190,57886284,57889393,3109,4380,50
57893978,57893072,57895327,2255,4381,50
57899911,57899005,57901882,2877,4382,50
57906467,57905561,57908987,3426,4383,50
57913571,57912666,57916091,3425,4384,50
57920676,57919770,57921929,2159,4385,50
57926513,57925607,57928716,3109,4386,50
57933301,57932395,57935504,3109,4387,50
57940089,57939183,57941438,2255,4388,50
57946239,57945116,57947372,2256,4389,50
57951955,57951050,57954579,3529,4390,50
57959164,57958258,57960513,2255,4391,50
57965097,57964191,57966751,2560,4392,50
57971335,57970429,57973855,3426,4393,50
57978440,57977534,57979789,2255,4394,50
57984373,57983467,57986343,2876,4395,50
57991144,57990022,57992277,2255,4396,50
57996861,57995955,57998210,2255,4397,50
58002794,58001888,58004131,2243,4398,50
58008716,58007809,58010603,2794,4399,50
58015404,58014282,58016536,2254,4400,50
58021120,58020214,58022469,2255,4401,50
58027053,58026147,58028402,2255,4402,50
58033202,58032080,58034335,2255,4403,50
58038919,58038013,58041544,3531,4404,50
58046129,58045223,58047699,2476,4405,50
58052283,58051377,58054170,2793,4406,50
58058755,58057849,58060641,2792,4407,50
58065226,58064320,58066575,2255,4408,50
58071159,58070253,58072813,2560,4409,50
58077398,58076492,58079284,2792,4410,50
58083869,58082963,58085218,2255,4411,50
58089802,58088896,58092427,3531,4412,50
58097012,58096106,58098361,2255,4413,50
58102945,58102039,58104294,2255,4414,50
58108877,58107972,58110226,2254,4415,50
58114810,58113904,58116781,2877,4416,50
58121366,58120460,58122715,2255,4417,50
58127299,58126393,58129269,2876,4418,50
58133854,58132948,58135203,2255,4419,50
58139787,58138881,58142074,3193,4420,50
58146659,58145753,58148545,2792,4421,50
58153130,58152224,58154384,2160,4422,50
58158968,58158062,58160317,2255,4423,50
58164902,58163996,58167189,3193,4424,50
58171774,58170868,58173123,2255,4425,50
58177706,58176801,58179055,2254,4426,50
58183855,58182733,58184988,2255,4427,50
58189572,58188666,58190910,2244,4428,50
58195494,58194588,58198014,3426,4429,50
58202599,58201693,58204485,2792,4430,50
58209070,58208164,58210419,2255,4431,50
58215003,58214097,58216352,2255,4432,50
58220935,58220030,58223223,3193,4433,50
58227808,58226902,58229378,2476,4434,50
58233963,58233057,58235849,2792,4435,50
58240434,58239528,58241688,2160,4436,50
58246272,58245366,58247621,2255,4437,50
58252204,58251299,58253553,2254,4438,50
58258137,58257231,58259791,2560,4439,50
58264376,58263470,58265726,2256,4440,50
58270310,58269404,58271659,2255,4441,50
58276243,58275337,58277581,2244,4442,50
58282382,58281259,58283515,2256,4443,50
58288099,58287193,58290070,2877,4444,50
58294655,58293749,58296542,2793,4445,50
58301126,58300221,58302695,2474,4446,50
58307279,58306374,58308628,2254,4447,50
58313213,58312307,58314551,2244,4448,50
58319352,58318229,58320485,2256,4449,50
58325069,58324163,58326418,2255,4450,50
58331002,58330096,58332972,2876,4451,50
58337557,58336651,58338906,2255,4452,50
58343490,58342584,58345461,2877,4453,50
58350046,58349140,58351616,2476,4454,50
58356200,58355294,58358404,3110,4455,50
58362989,58362083,58364338,2255,4456,50
58368924,58368017,58371528,3511,4457,50
58376112,58375207,58377366,2159,4458,50
58381950,58381044,58384153,3109,4459,50
58388738,58387832,58390941,3109,4460,50
58395742,58394620,58396875,2255,4461,50
58401458,58400553,58403112,2559,4462,50
58407696,58406790,58409045,2255,4463,50
58413629,58412723,58416253,3530,4464,50
58420837,58419931,58422186,2255,4465,50
58426769,58425864,58429394,3530,4466,50
58433979,58433073,58436499,3426,4467,50
58441084,58440178,58443287,3109,4468,50
58447871,58446965,58449220,2255,4469,50
58453804,58452898,58456430,3532,4470,50
58461014,58460109,58462267,2158,4471,50
58466851,58465946,58468105,2159,4472,50
58472689,58471783,58474038,2255,4473,50
58478622,58477716,58479959,2243,4474,50
58484543,58483637,58486746,3109,4475,50
58491330,58490425,58492679,2254,4476,50
58497263,58496357,58498918,2561,4477,50
58503502,58502596,58505705,3109,4478,50
58510289,58509384,58512491,3107,4479,50
58517293,58516170,58518426,2256,4480,50
58523010,58522104,58525635,3531,4481,50
58530220,58529314,58531790,2476,4482,50
58536374,58535468,58538576,3108,4483,50
58543161,58542255,58545364,3109,4484,50
58549948,58549043,58551518,2475,4485,50
58556319,58555196,58557452,2256,4486,50
58562035,58561130,58563690,2560,4487,50
58568275,58567369,58570479,3110,4488,50
58575064,58574158,58577267,3109,4489,50
58581851,58580946,58583200,2254,4490,50
58587784,58586878,58589133,2255,4491,50
58593717,58592811,58596343,3532,4492,50
58600928,58600022,58603131,3109,4493,50
58607716,58606810,58609065,2255,4494,50
58613648,58612743,58614997,2254,4495,50
58619797,58618675,58620930,2255,4496,50
58625514,58624608,58626863,2255,4497,50
58631664,58630541,58632797,2256,4498,50
58637597,58636475,58638730,2255,4499,50
58643314,58642408,58644968,2560,4500,50
58649553,58648647,58650902,2255,4501,50
58655486,58654580,58657141,2561,4502,50
58661726,58660820,58662979,2159,4503,50
58667563,58666657,58668816,2159,4504,50
58673616,58672494,58674749,2255,4505,50
58679332,58678427,58681303,2876,4506,50
58686105,58684982,58687238,2256,4507,50
58691823,58690917,58693794,2877,4508,50
58698379,58697473,58699633,2160,4509,50
58704216,58703311,58705565,2254,4510,50
58710149,58709243,58712437,3194,4511,50
58717022,58716116,58718909,2793,4512,50
58723494,58722588,58725697,3109,4513,50
58730282,58729376,58731534,2158,4514,50
58736118,58735212,58737688,2476,4515,50
58742272,58741366,58743842,2476,4516,50
58748426,58747520,58749775,2255,4517,50
58754360,58753454,58756015,2561,4518,50
58760817,58759694,58761950,2256,4519,50
58766750,58765628,58767883,2255,4520,50
58772467,58771561,58773817,2256,4521,50
58778401,58777495,58780056,2561,4522,50
58784641,58783735,58786211,2476,4523,50
58791012,58789889,58792145,2256,4524,50
58796729,58795823,58799016,3193,4525,50
58803601,58802695,58804950,2255,4526,50
58809534,58808628,58810883,2255,4527,50
58815466,58814561,58816804,2243,4528,50
58821388,58820483,58823908,3425,4529,50
58828493,58827587,58829843,2256,4530,50
58834428,58833522,58837031,3509,4531,50
58841616,58840710,58842965,2255,4532,50
58847549,58846643,58850175,3532,4533,50
58854760,58853854,58857279,3425,4534,50
58861863,58860958,58863212,2254,4535,50
58867796,58866890,58869134,2244,4536,50
58873718,58872812,58874971,2159,4537,50
58879555,58878649,58881441,2792,4538,50
58886026,58885120,58887375,2255,4539,50
58892176,58891053,58893309,2256,4540,50
58897893,58896987,58899864,2877,4541,50
58904449,58903543,58905703,2160,4542,50
58910287,58909381,58912173,2792,4543,50
58916758,58915852,58918108,2256,4544,50
58922692,58921786,58924346,2560,4545,50
58929148,58928025,58930281,2256,4546,50
58934865,58933959,58936520,2561,4547,50
58941105,58940199,58942991,2792,4548,50
58947576,58946670,58950096,3426,4549,50
58954898,58953775,58956031,2256,4550,50
58960615,58959709,58962585,2876,4551,50
58967387,58966264,58968520,2256,4552,50
58973321,58972199,58974454,2255,4553,50
58979038,58978132,58981664,3532,4554,50
58986249,58985343,58988134,2791,4555,50
58992718,58991812,58994604,2792,4556,50
58999189,58998283,59000443,2160,4557,50
59005027,59004121,59007229,3108,4558,50
59011814,59010908,59013163,2255,4559,50
59017747,59016841,59020056,3215,4560,50
59024639,59023734,59025893,2159,4561,50
59030477,59029571,59032047,2476,4562,50
59036848,59035725,59037981,2256,4563,50
59042565,59041659,59044220,2561,4564,50
59048803,59047898,59051343,3445,4565,50
59055928,59055022,59057498,2476,4566,50
59062299,59061176,59063432,2256,4567,50
59068016,59067110,59069365,2255,4568,50
59074166,59073043,59075299,2256,4569,50
59079882,59078977,59081231,2254,4570,50
59085815,59084909,59087152,2243,4571,50
59091736,59090830,59093306,2476,4572,50
59097889,59096984,59099776,2792,4573,50
59104361,59103455,59106247,2792,4574,50
59110832,59109926,59112181,2255,4575,50
59116765,59115859,59118114,2255,4576,50
59122698,59121792,59124353,2561,4577,50
59128938,59128032,59130507,2475,4578,50
59135091,59134185,59136441,2256,4579,50
59141025,59140119,59142374,2255,4580,50
59146959,59146052,59148308,2256,4581,50
59153108,59151986,59154241,2255,4582,50
59158824,59157919,59160795,2876,4583,50
59165379,59164474,59167266,2792,4584,50
59171850,59170945,59174391,3446,4585,50
59178976,59178070,59181495,3425,4586,50
59186080,59185174,59187650,2476,4587,50
59192451,59191328,59193584,2256,4588,50
59198384,59197262,59199517,2255,4589,50
59204102,59203196,59206073,2877,4590,50
59210658,59209752,59212228,2476,4591,50
59217028,59215906,59218161,2255,4592,50
59222745,59221839,59224400,2561,4593,50
59228984,59228079,59230554,2475,4594,50
59235139,59234233,59236488,2255,4595,50
59241288,59240166,59242421,2255,4596,50
59247222,59246099,59248355,2256,4597,50
59252938,59252033,59254593,2560,4598,50
59259177,59258272,59260526,2254,4599,50
59265110,59264204,59266448,2244,4600,50
59271032,59270126,59272381,2255,4601,50
59276964,59276059,59278935,2876,4602,50
59283519,59282614,59284773,2159,4603,50
59289573,59288451,59290706,2255,4604,50
59295290,59294384,59296628,2244,4605,50
59301212,59300306,59303098,2792,4606,50
59307682,59306777,59310223,3446,4607,50
59314808,59313902,59316062,2160,4608,50
59320646,59319740,59321900,2160,4609,50
59326483,59325578,59329023,3445,4610,50
59333608,59332702,59336127,3425,4611,50
59340711,59339806,59342914,3108,4612,50
59347499,59346593,59349702,3109,4613,50
59354287,59353381,59355857,2476,4614,50
59360441,59359535,59361790,2255,4615,50
59366373,59365468,59367710,2242,4616,50
59372293,59371388,59373642,2254,4617,50
59378226,59377320,59380851,3531,4618,50
59385436,59384530,59387638,3108,4619,50
59392223,59391317,59393572,2255,4620,50
59398157,59397250,59400782,3532,4621,50
59405365,59404460,59406619,2159,4622,50
59411203,59410297,59412552,2255,4623,50
59417135,59416230,59418473,2243,4624,50
59423057,59422151,59424406,2255,4625,50
59428989,59428084,59430338,2254,4626,50
59435139,59434017,59436272,2255,4627,50
59440856,59439950,59442194,2244,4628,50
59446778,59445873,59448127,2254,4629,50
59452711,59451805,59454366,2561,4630,50
59458950,59458045,59460299,2254,4631,50
59464883,59463977,59466221,2244,4632,50
59470805,59469899,59472691,2792,4633,50
59477276,59476370,59479478,3108,4634,50
59484063,59483157,59485412,2255,4635,50
59489996,59489090,59491345,2255,4636,50
59495928,59495023,59497266,2243,4637,50
59501850,59500944,59503420,2476,4638,50
59508003,59507098,59509573,2475,4639,50
59514374,59513252,59515507,2255,4640,50
59520307,59519185,59521439,2254,4641,50
59526023,59525117,59528332,3215,4642,50
59532916,59532011,59534265,2254,4643,50
59538849,59537943,59540198,2255,4644,50
59544782,59543876,59547408,3532,4645,50
59551993,59551087,59553343,2256,4646,50
59557926,59557021,59560214,3193,4647,50
59564798,59563893,59566147,2254,4648,50
59570731,59569825,59572080,2255,4649,50
59576664,59575758,59578002,2244,4650,50
59582585,59581680,59584472,2792,4651,50
59589057,59588151,59590310,2159,4652,50
59594894,59593988,59596463,2475,4653,50
59601047,59600141,59602932,2791,4654,50
59607733,59606611,59608866,2255,4655,50
59613450,59612544,59615421,2877,4656,50
59620006,59619100,59621575,2475,4657,50
59626377,59625254,59627510,2256,4658,50
59632311,59631189,59633444,2255,4659,50
59638029,59637123,59639378,2255,4660,50
59643962,59643056,59646249,3193,4661,50
59650834,59649928,59652721,2793,4662,50
59657305,59656399,59659508,3109,4663,50
59664093,59663187,59665663,2476,4664,50
59670463,59669341,59671596,2255,4665,50
59676180,59675274,59678467,3193,4666,50
59683052,59682146,59684401,2255,4667,50
59688985,59688079,59690323,2244,4668,50
59694907,59694001,59696794,2793,4669,50
59701379,59700473,59702728,2255,4670,50
59707528,59706406,59708661,2255,4671,50
59713244,59712339,59714593,2254,4672,50
59719177,59718271,59721803,3532,4673,50
59726388,59725482,59727737,2255,4674,50
59732321,59731415,59733659,2244,4675,50
59738242,59737337,59739591,2254,4676,50
59744175,59743269,59746483,3214,4677,50
59751068,59750162,59753270,3108,4678,50
59757855,59756949,59760375,3426,4679,50
59764959,59764054,59767163,3109,4680,50
59771748,59770842,59773635,2793,4681,50
59778220,59777314,59780424,3110,4682,50
59785009,59784103,59786896,2793,4683,50
59791481,59790575,59793368,2793,4684,50
59797952,59797047,59800492,3445,4685,50
59805077,59804171,59806426,2255,4686,50
59811227,59810104,59812360,2256,4687,50
59817161,59816038,59818294,2256,4688,50
59822878,59821972,59825502,3530,4689,50
59830087,59829181,59831973,2792,4690,50
59836557,59835652,59837811,2159,4691,50
59842395,59841489,59843648,2159,4692,50
59848232,59847326,59849802,2476,4693,50
59854385,59853480,59856271,2791,4694,50
59860855,59859950,59862742,2792,4695,50
59867327,59866421,59869214,2793,4696,50
59874015,59872893,59875148,2255,4697,50
59879732,59878826,59881081,2255,4698,50
59885665,59884759,59888290,3531,4699,50
59892875,59891969,59894445,2476,4700,50
59899030,59898124,59901550,3426,4701,50
59906135,59905229,59907388,2159,4702,50
59911972,59911066,59913858,2792,4703,50
59918443,59917537,59919792,2255,4704,50
59924376,59923470,59925725,2255,4705,50
59930309,59929403,59931963,2560,4706,50
59936548,59935642,59938118,2476,4707,50
59942703,59941797,59944907,3110,4708,50
59949492,59948586,59950841,2255,4709,50
59955424,59954519,59956773,2254,4710,50
59961359,59960452,59963013,2561,4711,50
59967598,59966692,59969169,2477,4712,50
59973753,59972847,59975102,2255,4713,50
59979687,59978781,59982311,3530,4714,50
59986896,59985990,59988149,2159,4715,50
59992733,59991827,59995274,3447,4716,50
59999859,59998953,60001428,2475,4717,50
60006012,60005106,60008532,3426,4718,50
60013117,60012211,60014466,2255,4719,50
60019050,60018145,60020400,2255,4720,50
60024984,60024078,60026322,2244,4721,50
60030906,60030000,60032159,2159,4722,50
60036743,60035837,60039283,3446,4723,50
60043867,60042962,60045121,2159,4724,50
60049706,60048800,60051056,2256,4725,50
60055640,60054734,60056977,2243,4726,50
60061561,60060656,60063765,3109,4727,50
60068567,60067444,60069700,2256,4728,50
60074284,60073378,60076254,2876,4729,50
60081056,60079933,60082189,2256,4730,50
60086774,60085867,60088428,2561,4731,50
60093013,60092107,60094363,2256,4732,50
60099164,60098041,60100297,2256,4733,50
60104880,60103975,60107189,3214,4734,50
60111774,60110868,60113123,2255,4735,50
60117707,60116801,60119056,2255,4736,50
60123639,60122734,60124989,2255,4737,50
60129572,60128667,60130921,2254,4738,50
60135506,60134600,60136855,2255,4739,50
60141439,60140533,60143747,3214,4740,50
60148331,60147426,60150535,3109,4741,50
60155120,60154214,60156470,2256,4742,50
60161271,60160149,60162404,2255,4743,50
60166988,60166082,60168643,2561,4744,50
60173228,60172322,60174577,2255,4745,50
60179161,60178255,60181131,2876,4746,50
60185716,60184810,60187065,2255,4747,50
60191648,60190743,60193956,3213,4748,50
60198541,60197635,60199891,2256,4749,50
60204474,60203569,60206128,2559,4750,50
60210713,60209807,60212063,2256,4751,50
60216647,60215741,60217985,2244,4752,50
60222569,60221663,60224138,2475,4753,50
60228721,60227816,60230071,2255,4754,50
60234655,60233749,60236309,2560,4755,50
60240894,60239988,60242464,2476,4756,50
60247265,60246143,60248398,2255,4757,50
60252981,60252076,60255289,3213,4758,50
60259874,60258968,60261127,2159,4759,50
60265711,60264805,60267913,3108,4760,50
60272498,60271592,60273752,2160,4761,50
60278337,60277431,60279687,2256,4762,50
60284488,60283366,60285621,2255,4763,50
60290206,60289300,60291544,2244,4764,50
60296129,60295223,60298331,3108,4765,50
60302916,60302010,60304266,2256,4766,50
60308850,60307944,60310187,2243,4767,50
60314771,60313865,60317311,3446,4768,50
60321896,60320990,60323245,2255,4769,50
60327828,60326923,60329799,2876,4770,50
60334384,60333478,60336270,2792,4771,50
60340855,60339949,60342742,2793,4772,50
60347327,60346421,60349531,3110,4773,50
60354115,60353210,60355464,2254,4774,50
60360048,60359142,60361397,2255,4775,50
60366197,60365075,60367330,2255,4776,50
60371913,60371008,60374538,3530,4777,50
60379123,60378217,60380472,2255,4778,50
60385273,60384150,60386406,2256,4779,50
60390990,60390084,60392643,2559,4780,50
60397227,60396321,60398577,2256,4781,50
60403161,60402255,60404498,2243,4782,50
60409082,60408176,60410652,2476,4783,50
60415237,60414331,60416587,2256,4784,50
60421170,60420265,60422519,2254,4785,50
60427102,60426197,60429727,3530,4786,50
60434312,60433406,60435661,2255,4787,50
60440463,60439340,60441596,2256,4788,50
60446181,60445275,60448152,2877,4789,50
60452737,60451831,60455257,3426,4790,50
60459842,60458936,60461728,2792,4791,50
60466313,60465407,60468517,3110,4792,50
60473102,60472196,60474452,2256,4793,50
60479037,60478131,60481008,2877,4794,50
60485593,60484687,60487479,2792,4795,50
60492064,60491158,60493414,2256,4796,50
60498214,60497092,60499347,2255,4797,50
60503931,60503025,60505586,2561,4798,50
60510171,60509265,60511520,2255,4799,50
60516104,60515198,60517453,2255,4800,50
60522036,60521131,60523374,2243,4801,50
60527958,60527052,60529308,2256,4802,50
60533891,60532986,60536516,3530,4803,50
60541101,60540195,60543303,3108,4804,50
60548105,60546982,60549238,2256,4805,50
60553822,60552916,60555793,2877,4806,50
60560378,60559472,60561727,2255,4807,50
60566312,60565406,60568600,3194,4808,50
60573185,60572279,60574534,2255,4809,50
60579117,60578212,60581426,3214,4810,50
60586011,60585105,60588213,3108,4811,50
60592798,60591892,60594147,2255,4812,50
60598731,60597825,60600081,2256,4813,50
60604665,60603759,60606637,2878,4814,50
60611221,60610316,60613107,2791,4815,50
60617691,60616786,60619040,2254,4816,50
60623625,60622719,60625279,2560,4817,50
60629864,60628958,60631116,2158,4818,50
60635700,60634794,60637587,2793,4819,50
60642172,60641266,60643521,2255,4820,50
60648321,60647199,60649454,2255,4821,50
60654038,60653132,60656009,2877,4822,50
60660594,60659688,60662480,2792,4823,50
60667064,60666159,60668317,2158,4824,50
60672901,60671995,60674787,2792,4825,50
60679372,60678466,60680942,2476,4826,50
60685526,60684620,60686780,2160,4827,50
60691364,60690458,60692713,2255,4828,50
60697297,60696391,60698952,2561,4829,50
60703537,60702631,60706057,3426,4830,50
60710641,60709736,60711894,2158,4831,50
60716478,60715572,60718365,2793,4832,50
60722950,60722044,60724204,2160,4833,50
60729004,60727882,60730137,2255,4834,50
60734722,60733816,60736060,2244,4835,50
60740644,60739738,60741898,2160,4836,50
60746699,60745576,60747832,2256,4837,50
60752416,60751510,60753766,2256,4838,50
60758350,60757444,60760005,2561,4839,50
60764806,60763684,60765939,2255,4840,50
60770740,60769618,60771873,2255,4841,50
60776457,60775552,60778428,2876,4842,50
60783013,60782107,60785533,3426,4843,50
60790118,60789212,60791370,2158,4844,50
60795954,60795048,60797304,2256,4845,50
60801888,60800982,60803542,2560,4846,50
60808127,60807221,60810330,3109,4847,50
60814915,60814009,60816485,2476,4848,50
60821069,60820163,60822418,2255,4849,50
60827002,60826096,60828351,2255,4850,50
60832935,60832029,60835559,3530,4851,50
60840361,60839238,60841494,2256,4852,50
60846079,60845172,60847417,2245,4853,50
60852001,60851095,60853888,2793,4854,50
60858473,60857567,60859823,2256,4855,50
60864407,60863501,60866695,3194,4856,50
60871280,60870374,60872630,2256,4857,50
60877215,60876309,60878552,2243,4858,50
60883137,60882231,60885023,2792,4859,50
60889607,60888702,60891177,2475,4860,50
60895761,60894855,60897965,3110,4861,50
60902550,60901644,60905070,3426,4862,50
60909655,60908749,60911004,2255,4863,50
60915588,60914682,60917897,3215,4864,50
60922481,60921576,60923831,2255,4865,50
60928416,60927510,60931042,3532,4866,50
60935627,60934721,60937831,3110,4867,50
60942416,60941510,60944302,2792,4868,50
60948886,60947981,60951089,3108,4869,50
60955674,60954768,60957244,2476,4870,50
60962044,60960922,60963177,2255,4871,50
60967761,60966855,60969416,2561,4872,50
60974001,60973095,60975255,2160,4873,50
60979839,60978933,60981188,2255,4874,50
60985772,60984866,60987121,2255,4875,50
60991705,60990799,60993042,2243,4876,50
60997626,60996720,61000146,3426,4877,50
61004731,61003825,61006618,2793,4878,50
61011203,61010297,61013090,2793,4879,50
61017892,61016769,61019025,2256,4880,50
61023609,61022703,61026235,3532,4881,50
61030820,61029914,61032073,2159,4882,50
61036657,61035751,61038860,3109,4883,50
61043445,61042539,61044794,2255,4884,50
61049378,61048472,61050727,2255,4885,50
61055311,61054405,61057281,2876,4886,50
61061866,61060960,61063752,2792,4887,50
61068337,61067431,61069906,2475,4888,50
61074491,61073585,61075744,2159,4889,50
61080327,61079422,61081897,2475,4890,50
61086699,61085576,61087832,2256,4891,50
61092416,61091511,61095041,3530,4892,50
61099626,61098720,61101195,2475,4893,50
61105779,61104873,61107666,2793,4894,50
61112250,61111345,61113821,2476,4895,50
61118406,61117500,61119660,2160,4896,50
61124244,61123338,61125498,2160,4897,50
61130082,61129176,61131431,2255,4898,50
61136015,61135109,61138640,3531,4899,50
61143225,61142319,61144794,2475,4900,50
61149379,61148473,61150949,2476,4901,50
61155534,61154628,61157421,2793,4902,50
61162006,61161100,61164209,3109,4903,50
61168794,61167888,61170144,2256,4904,50
61174729,61173823,61176078,2255,4905,50
61180662,61179756,61182633,2877,4906,50
61187219,61186313,61189739,3426,4907,50
61194324,61193418,61196526,3108,4908,50
61201111,61200205,61202681,2476,4909,50
61207267,61206360,61209153,2793,4910,50
61213737,61212832,61215086,2254,4911,50
61219670,61218764,61222294,3530,4912,50
61226879,61225973,61229083,3110,4913,50
61233668,61232762,61235555,2793,4914,50
61240357,61239234,61241490,2256,4915,50
61246073,61245168,61248698,3530,4916,50
61253283,61252377,61255486,3109,4917,50
61260071,61259165,61261958,2793,4918,50
61266543,61265637,61267796,2159,4919,50
61272380,61271474,61274900,3426,4920,50
61279486,61278580,61280740,2160,4921,50
61285325,61284419,61286895,2476,4922,50
61291479,61290574,61292829,2255,4923,50
61297413,61296507,61299068,2561,4924,50
61303653,61302747,61305856,3109,4925,50
61310441,61309535,61312645,3110,4926,50
61317229,61316324,61318798,2474,4927,50
61323382,61322476,61325902,3426,4928,50
61330487,61329581,61332691,3110,4929,50
61337276,61336370,61339795,3425,4930,50
61344596,61343474,61345729,2255,4931,50
61350313,61349407,61352939,3532,4932,50
61357524,61356618,61359095,2477,4933,50
61363895,61362773,61365028,2255,4934,50
61369612,61368706,61371583,2877,4935,50
61376168,61375262,61377422,2160,4936,50
61382007,61381101,61384527,3426,4937,50
61389112,61388206,61390366,2160,4938,50
61394949,61394044,61396520,2476,4939,50
61401104,61400198,61402991,2793,4940,50
61407577,61406670,61409148,2478,4941,50
61413733,61412827,61415620,2793,4942,50
61420205,61419299,61421555,2256,4943,50
61426140,61425234,61428112,2878,4944,50
61432914,61431792,61434047,2255,4945,50
61438632,61437726,61440920,3194,4946,50
61445505,61444599,61446757,2158,4947,50
61451341,61450435,61452594,2159,4948,50
61457178,61456272,61458432,2160,4949,50
61463016,61462110,61464269,2159,4950,50
61468853,61467947,61471373,3426,4951,50
61476175,61475052,61477307,2255,4952,50
61482108,61480985,61483240,2255,4953,50
61488040,61486918,61489173,2255,4954,50
61493974,61492851,61495106,2255,4955,50
61499690,61498784,61501661,2877,4956,50
61506247,61505340,61507817,2477,4957,50
61512401,61511495,61514921,3426,4958,50
61519506,61518600,61522026,3426,4959,50
61526610,61525705,61527862,2157,4960,50
61532446,61531540,61533699,2159,4961,50
61538283,61537377,61539633,2256,4962,50
61544217,61543311,61546843,3532,4963,50
61551428,61550522,61552777,2255,4964,50
61557361,61556455,61558699,2244,4965,50
61563283,61562377,61565486,3109,4966,50
61570071,61569165,61571640,2475,4967,50
61576224,61575318,61577573,2255,4968,50
61582157,61581251,61583507,2256,4969,50
61588090,61587185,61589439,2254,4970,50
61594023,61593117,61596311,3194,4971,50
61600896,61599990,61602245,2255,4972,50
61606828,61605923,61608799,2876,4973,50
61613383,61612477,61614636,2159,4974,50
61619220,61618314,61620473,2159,4975,50
61625057,61624151,61631101,6950,4976,50
61635686,61634780,61637255,2475,4977,50
61641838,61640933,61644358,3425,4978,50
61648943,61648037,61651463,3426,4979,50
61656047,61655141,61657396,2255,4980,50
61662196,61661074,61663329,2255,4981,50
61667912,61667007,61669567,2560,4982,50
61674152,61673246,61676355,3109,4983,50
61680940,61680034,61682827,2793,4984,50
61687412,61686506,61688762,2256,4985,50
61693346,61692440,61695971,3531,4986,50
61700556,61699650,61701905,2255,4987,50
61706488,61705583,61707837,2254,4988,50
61712421,61711515,61713770,2255,4989,50
61718354,61717448,61720007,2559,4990,50
61724591,61723685,61727111,3426,4991,50
61731696,61730790,61733046,2256,4992,50
61737630,61736724,61739601,2877,4993,50
61744186,61743280,61745535,2255,4994,50
61750119,61749213,61752089,2876,4995,50
61756674,61755768,61757928,2160,4996,50
61762511,61761606,61763764,2158,4997,50
61768348,61767442,61770868,3426,4998,50
61775453,61774547,61777973,3426,4999,50
61782558,61781652,61784128,2476,5000,50
61789088,61787807,61796151,8344,1,75
61800625,61799562,61809857,10295,2,75
61814505,61813442,61821567,8125,3,75
61826117,61825054,61833180,8126,4,75
61837869,61836590,61845249,8659,5,75
61849940,61848659,61857635,8976,6,75
61862190,61861127,61870540,9413,7,75
61875073,61874010,61883740,9730,8,75
61888275,61887213,61895339,8126,9,75
61900029,61898749,61908695,9946,10,75
61913437,61912374,61920500,8126,11,75
61925260,61924197,61933928,9731,12,75
61938591,61937528,61946942,9414,13,75
61951504,61950441,61960312,9871,14,75
61964924,61963861,61973590,9729,15,75
61978368,61977089,61985431,8342,16,75
61990210,61988930,61996641,7711,17,75
62001404,62000341,62007834,7493,18,75
62012613,62011333,62020626,9293,19,75
62025404,62024125,62034072,9947,20,75
62038850,62037571,62045914,8343,21,75
62050550,62049488,62057612,8124,22,75
62062392,62061112,62071058,9946,23,75
62075676,62074613,62084027,9414,24,75
62088590,62087527,62096133,8606,25,75
62100881,62099819,62109232,9413,26,75
62114012,62112732,62120759,8027,27,75
62125539,62124259,62132286,8027,28,75
62137065,62135786,62144127,8341,29,75
62148769,62147706,62155833,8127,30,75
62160613,62159333,62168963,9630,31,75
62173716,62172653,62180463,7810,32,75
62185242,62183963,62193909,9946,33,75
62198689,62197409,62205120,7711,34,75
62209763,62208700,62216827,8127,35,75
62221502,62220439,62229515,9076,36,75
62234294,62233015,62242644,9629,37,75
62247255,62246192,62254950,8758,38,75
62259575,62258513,62267926,9413,39,75
62272560,62271497,62279940,8443,40,75
62284599,62283536,62291663,8127,41,75
62296442,62295163,62305109,9946,42,75
62309764,62308701,62317461,8760,43,75
62322241,62320961,62328988,8027,44,75
62333634,62332571,62340064,7493,45,75
62344691,62343628,62353359,9731,46,75
62358125,62357062,62366792,9730,47,75
62371457,62370394,62379807,9413,48,75
62384419,62383356,62391799,8443,49,75
62396421,62395359,62403484,8125,50,75
62408047,62406984,62415644,8660,51,75
62420424,62419144,62426853,7709,52,75
62431631,62430352,62438378,8026,53,75
62442999,62441936,62450378,8442,54,75
62455000,62453937,62461429,7492,55,75
62466190,62465127,62473570,8443,56,75
62478350,62477070,62484781,7711,57,75
62489524,62488461,62498191,9730,58,75
62502970,62501690,62509400,7710,59,75
62514142,62513080,62520888,7808,60,75
62525496,62524433,62531926,7493,61,75
62536603,62535540,62545271,9731,62,75
62549958,62548895,62556704,7809,63,75
62561379,62560317,62569392,9075,64,75
62573954,62572891,62580601,7710,65,75
62585380,62584101,62593394,9293,66,75
62598068,62597005,62606419,9414,67,75
62611186,62610124,62619536,9412,68,75
62624169,62623106,62631548,8442,69,75
62636328,62635048,62643708,8660,70,75
62648451,62647388,62656148,8760,71,75
62660927,62659648,62668940,9292,72,75
62673684,62672621,62681063,8442,73,75
62685842,62684563,62692273,7710,74,75
62696898,62695835,62703328,7493,75,75
62707994,62706931,62715058,8127,76,75
62719837,62718558,62727533,8975,77,75
62732301,62731238,62739363,8125,78,75
62744012,62742949,62751709,8760,79,75
62756489,62755209,62765156,9947,80,75
62769936,62768656,62778287,9631,81,75
62782927,62781864,62791593,9729,82,75
62796242,62795180,62802989,7809,83,75
62807769,62806489,62815781,9292,84,75
62820560,62819280,62828910,9630,85,75
62833688,62832409,62842038,9629,86,75
62846665,62845602,62855331,9729,87,75
62860111,62858831,62868124,9293,88,75
62872904,62871624,62879333,7709,89,75
62884113,62882833,62892780,9947,90,75
62897474,62896411,62905171,8760,91,75
62909923,62908860,62917936,9076,92,75
62922716,62921436,62930729,9293,93,75
62935292,62934229,62943785,9556,94,75
62948348,62947285,62956523,9238,95,75
62961086,62960023,62968311,8288,96,75
62973090,62971811,62980787,8976,97,75
62985567,62984287,62992631,8344,98,75
62997410,62996130,63004472,8342,99,75
63009127,63008064,63015558,7494,100,75
63020426,63019146,63027490,8344,101,75
63032238,63031175,63039301,8126,102,75
63044047,63042984,63050793,7809,103,75
63055562,63054499,63061992,7493,104,75
63066744,63065682,63074123,8441,105,75
63078902,63077840,63086281,8441,106,75
63091149,63089869,63099162,9293,107,75
63104029,63102750,63112042,9292,108,75
63116909,63115630,63123339,7709,109,75
63128099,63127036,63136766,9730,110,75
63141634,63140354,63150301,9947,111,75
63155169,63153889,63162866,8977,112,75
63167568,63166505,63174631,8126,113,75
63179376,63178313,63187726,9413,114,75
63192378,63191315,63199658,8343,115,75
63204526,63203246,63210956,7710,116,75
63215676,63214613,63223689,9076,117,75
63228446,63227383,63235510,8127,118,75
63240160,63239098,63247619,8521,119,75
63252270,63251207,63259729,8522,120,75
63264493,63263430,63272505,9075,121,75
63277259,63276196,63285927,9731,122,75
63290795,63289515,63297541,8026,123,75
63302251,63301188,63309631,8443,124,75
63314395,63313333,63322407,9074,125,75
63327108,63326045,63335121,9076,126,75
63339863,63338801,63347876,9075,127,75
63352743,63351464,63360756,9292,128,75
63365624,63364345,63372371,8026,129,75
63377022,63375959,63386380,10421,130,75
63391220,63390158,63398600,8442,131,75
63403469,63402189,63411820,9631,132,75
63416687,63415408,63423750,8342,133,75
63428618,63427339,63436631,9292,134,75
63441380,63440317,63450048,9731,135,75
63454917,63453637,63462929,9292,136,75
63467677,63466614,63475057,8443,137,75
63479766,63478703,63487463,8760,138,75
63492193,63491130,63500544,9414,139,75
63505263,63504200,63512960,8760,140,75
63517612,63516549,63527285,10736,141,75
63532102,63531040,63539799,8759,142,75
63544667,63543388,63551731,8343,143,75
63556599,63555319,63564949,9630,144,75
63569718,63568656,63576465,7809,145,75
63581333,63580053,63589684,9631,146,75
63594552,63593272,63600982,7710,147,75
63605850,63604570,63612597,8027,148,75
63617248,63616185,63626627,10442,149,75
63631486,63630423,63639837,9414,150,75
63644705,63643426,63653055,9629,151,75
63657707,63656644,63666748,10104,152,75
63671539,63670476,63678602,8126,153,75
63683305,63682242,63690684,8442,154,75
63695459,63694396,63703472,9076,155,75
63708340,63707060,63715720,8660,156,75
63720453,63719390,63727200,7810,157,75
63732067,63730788,63740417,9629,158,75
63745286,63744006,63751716,7710,159,75
63756367,63755304,63764457,9153,160,75
63769163,63768100,63777176,9076,161,75
63781908,63780845,63789605,8760,162,75
63794474,63793194,63802171,8977,163,75
63806892,63805829,63815243,9414,164,75
63820004,63818940,63826434,7494,165,75
63831183,63830120,63839850,9730,166,75
63844549,63843486,63851612,8126,167,75
63856264,63855201,63865306,10105,168,75
63870263,63868984,63877642,8658,169,75
63882511,63881231,63890208,8977,170,75
63894952,63893889,63902015,8126,171,75
63906741,63905678,63913488,7810,172,75
63918356,63917077,63925735,8658,173,75
63930483,63929420,63937229,7809,174,75
63942097,63940818,63948528,7710,175,75
63953288,63952225,63960035,7810,176,75
63964904,63963624,63973255,9631,177,75
63978000,63976937,63985696,8759,178,75
63990424,63989361,63998437,9076,179,75
64003158,64002096,64010221,8125,180,75
64014953,64013890,64022333,8443,181,75
64027201,64025921,64034580,8659,182,75
64039298,64038235,64046044,7809,183,75
64050913,64049633,64057343,7710,184,75
64062084,64061021,64070435,9414,185,75
64075198,64074135,64083548,9413,186,75
64088417,64087137,64095480,8343,187,75
64100201,64099139,64108868,9729,188,75
64113737,64112457,64121434,8977,189,75
64126161,64125098,64132907,7809,190,75
64137641,64136579,64145338,8759,191,75
64150205,64148926,64158218,9292,192,75
64163086,64161807,64170150,8343,193,75
64175019,64173739,64183370,9631,194,75
64188107,64187045,64195487,8442,195,75
64200220,64199157,64207599,8442,196,75
64212468,64211188,64220165,8977,197,75
64224904,64223841,64232284,8443,198,75
64237153,64235873,64245503,9630,199,75
64250372,64249092,64258069,8977,200,75
64262937,64261658,64270632,8974,201,75
64275500,64274221,64283513,9292,202,75
64288269,64287206,64296619,9413,203,75
64301379,64300316,64308442,8126,204,75
64313196,64312133,64320260,8127,205,75
64324983,64323920,64332679,8759,206,75
64337447,64336385,64344192,7807,207,75
64349061,64347781,64356124,8343,208,75
64360848,64359785,64368227,8442,209,75
64372934,64371871,64381284,9413,210,75
64386031,64384968,64393410,8442,211,75
64398143,64397080,64406493,9413,212,75
64411361,64410082,64420028,9946,213,75
64424738,64423676,64433405,9729,214,75
64438273,64436994,64446624,9630,215,75
64451493,64450213,64460159,9946,216,75
64465029,64463749,64473380,9631,217,75
64478124,64477061,64486791,9730,218,75
64491563,64490500,64499260,8760,219,75
64504021,64502958,64510768,7810,220,75
64515534,64514471,64523885,9414,221,75
64528754,64527474,64537421,9947,222,75
64542197,64541135,64549259,8124,223,75
64553911,64552848,64562636,9788,224,75
64567504,64566225,64575855,9630,225,75
64580593,64579531,64587022,7491,226,75
64591674,64590611,64598815,8204,227,75
64603467,64602404,64612508,10104,228,75
64617466,64616186,64624213,8027,229,75
64629082,64627802,64637749,9947,230,75
64642618,64641338,64651285,9947,231,75
64656046,64654984,64663108,8124,232,75
64667834,64666770,64675214,8444,233,75
64680083,64678803,64687779,8976,234,75
64692544,64691481,64699608,8127,235,75
64704325,64703262,64712022,8760,236,75
64716891,64715612,64724587,8975,237,75
64729455,64728176,64737805,9629,238,75
64742554,64741491,64750567,9076,239,75
64755274,64754211,64762971,8760,240,75
64767839,64766560,64775535,8975,241,75
64780404,64779124,64787151,8027,242,75
64792019,64790740,64799715,8975,243,75
64804421,64803358,64810851,7493,244,75
64815719,64814440,64822466,8026,245,75
64827334,64826055,64834714,8659,246,75
64839425,64838362,64846804,8442,247,75
64851524,64850461,64859874,9413,248,75
64864632,64863569,64872982,9413,249,75
64877634,64876572,64887963,11391,250,75
64892785,64891722,64901452,9730,251,75
64906162,64905099,64914513,9414,252,75
64919382,64918102,64926128,8026,253,75
64930856,64929793,64938890,9097,254,75
64943670,64942607,64951050,8443,255,75
64955918,64954639,64964269,9630,256,75
64968981,64967918,64976044,8126,257,75
64980817,64979754,64989484,9730,258,75
64994250,64993186,65000679,7493,259,75
65005548,65004268,65013245,8977,260,75
65018026,65016962,65026693,9731,261,75
65031563,65030283,65038943,8660,262,75
65043713,65042650,65051726,9076,263,75
65056462,65055400,65063208,7808,264,75
65067971,65066909,65075668,8759,265,75
65080438,65079375,65087184,7809,266,75
65091882,65090819,65100231,9412,267,75
65104928,65103865,65112625,8760,268,75
65117382,65116320,65123812,7492,269,75
65128682,65127402,65137032,9630,270,75
65141738,65140675,65150088,9413,271,75
65154957,65153678,65162337,8659,272,75
65167206,65165926,65173636,7710,273,75
65178380,65177317,65187047,9730,274,75
65191799,65190737,65199179,8442,275,75
65203961,65202899,65212312,9413,276,75
65217055,65215993,65224118,8125,277,75
65228846,65227783,65235908,8125,278,75
65240777,65239497,65248473,8976,279,75
65253186,65252124,65261854,9730,280,75
65266722,65265443,65273785,8342,281,75
65278547,65277484,65286560,9076,282,75
65291429,65290149,65298491,8342,283,75
65303255,65302192,65309685,7493,284,75
65314555,65313275,65321301,8026,285,75
65326170,65324890,65334837,9947,286,75
65339605,65338543,65347955,9412,287,75
65352713,65351651,65360725,9074,288,75
65365463,65364401,65373814,9413,289,75
65378563,65377500,65386576,9076,290,75
65391300,65390237,65398363,8126,291,75
65403140,65402077,65410837,8760,292,75
65415490,65414427,65424374,9947,293,75
65429242,65427963,65437255,9292,294,75
65441985,65440922,65448415,7493,295,75
65453285,65452005,65460348,8343,296,75
65465091,65464029,65473442,9413,297,75
65478201,65477138,65484631,7493,298,75
65489500,65488221,65495931,7710,299,75
65500677,65499614,65509027,9413,300,75
65513791,65512728,65522459,9731,301,75
65527203,65526140,65535217,9077,302,75
65540086,65538807,65548100,9293,303,75
65552970,65551691,65560984,9293,304,75
65565854,65564574,65572602,8028,305,75
65577472,65576193,65583903,7710,306,75
65588640,65587577,65596337,8760,307,75
65600991,65599928,65609874,9946,308,75
65614745,65613465,65621493,8028,309,75
65626363,65625083,65634715,9632,310,75
65639476,65638413,65646855,8442,311,75
65651558,65650495,65657989,7494,312,75
65662763,65661700,65669510,7810,313,75
65674225,65673161,65681289,8128,314,75
65686059,65684996,65694073,9077,315,75
65698809,65697746,65705557,7811,316,75
65710332,65709269,65718345,9076,317,75
65723100,65722037,65730164,8127,318,75
65735035,65733755,65742416,8661,319,75
65747165,65746103,65753911,7808,320,75
65758781,65757502,65766479,8977,321,75
65771350,65770070,65779385,9315,322,75
65784132,65783070,65791829,8759,323,75
65796699,65795420,65803763,8343,324,75
65808633,65807354,65815696,8342,325,75
65820567,65819287,65826998,7711,326,75
65831749,65830686,65840417,9731,327,75
65845190,65844127,65851621,7494,328,75
65856371,65855308,65863434,8126,329,75
65868147,65867084,65874577,7493,330,75
65879448,65878168,65887462,9294,331,75
65892201,65891138,65899898,8760,332,75
65904551,65903489,65912327,8838,333,75
65917198,65915918,65923629,7711,334,75
65928378,65927315,65936075,8760,335,75
65940946,65939666,65949298,9632,336,75
65953952,65952889,65961728,8839,337,75
65966474,65965411,65973537,8126,338,75
65978262,65977199,65986613,9414,339,75
65991368,65990305,65999065,8760,340,75
66003719,66002656,66012762,10106,341,75
66017505,66016442,66025513,9071,342,75
66030261,66029198,66038928,9730,343,75
66043708,66042645,66052375,9730,344,75
66057029,66055966,66065260,9294,345,75
66070005,66068942,66076435,7493,346,75
66081147,66080084,66089815,9731,347,75
66094686,66093406,66101433,8027,348,75
66106211,66105148,66114224,9076,349,75
66119094,66117815,66127762,9947,350,75
66132510,66131447,66139891,8444,351,75
66144762,66143482,66152775,9293,352,75
66157560,66156497,66163991,7494,353,75
66168645,66167582,66177370,9788,354,75
66182138,66181075,66190489,9414,355,75
66195240,66194177,66201987,7810,356,75
66206734,66205671,66213482,7811,357,75
66218352,66217073,66225415,8342,358,75
66230125,66229062,66238138,9076,359,75
66243009,66241729,66249439,7710,360,75
66254212,66253150,66262879,9729,361,75
66267749,66266470,66274180,7710,362,75
66278926,66277863,66287278,9415,363,75
66292031,66290968,66298461,7493,364,75
66303331,66302052,66310396,8344,365,75
66315266,66313987,66322962,8975,366,75
66327731,66326669,66335428,8759,367,75
66340156,66339093,66348824,9731,368,75
66353572,66352509,66360003,7494,369,75
66364874,66363594,66371305,7711,370,75
66376175,66374896,66384843,9947,371,75
66389586,66388523,66398254,9731,372,75
66402907,66401845,66410683,8838,373,75
66415388,66414325,66423085,8760,374,75
66427956,66426676,66434704,8028,375,75
66439470,66438408,66447822,9414,376,75
66452587,66451524,66459651,8127,377,75
66464522,66463242,66471269,8027,378,75
66476140,66474860,66484492,9632,379,75
66489211,66488148,66496275,8127,380,75
66501035,66499972,66508415,8443,381,75
66513119,66512056,66520184,8128,382,75
66524837,66523775,66531642,7867,383,75
66536512,66535233,66545180,9947,384,75
66550050,66548771,66558719,9948,385,75
66563372,66562310,66570831,8521,386,75
66575613,66574550,66582361,7811,387,75
66587231,66585952,66593662,7710,388,75
66598533,66597253,66605913,8660,389,75
66610620,66609557,66618317,8760,390,75
66623072,66622009,66629820,7811,391,75
66634589,66633526,66641652,8126,392,75
66646377,66645314,66652808,7494,393,75
66657512,66656450,66665864,9414,394,75
66670734,66669455,66677482,8027,395,75
66682251,66681188,66689632,8444,396,75
66694502,66693223,66702853,9630,397,75
66707605,66706542,66714036,7494,398,75
66718906,66717627,66726603,8976,399,75
66731473,66730194,66737903,7709,400,75
66742774,66741494,66749838,8344,401,75
66754554,66753491,66762250,8759,402,75
66767021,66765958,66773452,7494,403,75
66778106,66777043,66785249,8206,404,75
66790120,66788840,66797501,8661,405,75
66802371,66801092,66810068,8976,406,75
66814939,66813659,66823291,9632,407,75
66828162,66826882,66836175,9293,408,75
66840911,66839848,66849579,9731,409,75
66854233,66853170,66862642,9472,410,75
66867512,66866233,66874576,8343,411,75
66879329,66878266,66885759,7493,412,75
66890630,66889350,66898644,9294,413,75
66903514,66902235,66911865,9630,414,75
66916736,66915456,66923166,7710,415,75
66927923,66926860,66935303,8443,416,75
66940074,66939011,66946505,7494,417,75
66951159,66950096,66958280,8184,418,75
66963151,66961871,66969582,7711,419,75
66974236,66973173,66983277,10104,420,75
66988020,66986957,66994668,7711,421,75
66999538,66998259,67007890,9631,422,75
67012761,67011481,67020141,8660,423,75
67025012,67023732,67033364,9632,424,75
67038235,67036955,67046249,9294,425,75
67050903,67049840,67058817,8977,426,75
67063565,67062502,67069996,7494,427,75
67074780,67073717,67083447,9730,428,75
67088173,67087111,67095870,8759,429,75
67100623,67099560,67108320,8760,430,75
67113076,67112013,67120140,8127,431,75
67125011,67123731,67133679,9948,432,75
67138550,67137270,67146564,9294,433,75
67151318,67150255,67159331,9076,434,75
67163985,67162922,67172554,9632,435,75
67177424,67176145,67184804,8659,436,75
67189532,67188469,67196597,8128,437,75
67201372,67200309,67210040,9731,438,75
67214911,67213631,67222608,8977,439,75
67227313,67226250,67234377,8127,440,75
67239248,67237968,67247915,9947,441,75
67252568,67251506,67261136,9630,442,75
67265840,67264777,67272587,7810,443,75
67277457,67276178,67285471,9293,444,75
67290342,67289062,67296772,7710,445,75
67301546,67300483,67307977,7494,446,75
67312747,67311684,67319177,7493,447,75
67323933,67322870,67331630,8760,448,75
67336284,67335221,67344060,8839,449,75
67348713,67347651,67356489,8838,450,75
67361360,67360080,67369057,8977,451,75
67373765,67372702,67380196,7494,452,75
67384962,67383899,67391710,7811,453,75
67396472,67395409,67403219,7810,454,75
67407985,67406923,67414416,7493,455,75
67419070,67418007,67427637,9630,456,75
67432508,67431228,67441176,9948,457,75
67445925,67444862,67454275,9413,458,75
67459145,67457866,67465893,8027,459,75
67470764,67469484,67478777,9293,460,75
67483647,67482368,67490394,8026,461,75
67495048,67493985,67502013,8028,462,75
67506724,67505662,67513472,7810,463,75
67518184,67517122,67524615,7493,464,75
67529485,67528206,67535915,7709,465,75
67540786,67539506,67547217,7711,466,75
67551956,67550893,67559021,8128,467,75
67563675,67562612,67573033,10421,468,75
67577993,67576713,67584741,8028,469,75
67589612,67588332,67597963,9631,470,75
67602664,67601601,67609728,8127,471,75
67614499,67613437,67622513,9076,472,75
67627384,67626104,67636052,9948,473,75
67640923,67639643,67648937,9294,474,75
67653591,67652528,67662316,9788,475,75
67667187,67665907,67674251,8344,476,75
67679122,67677842,67685869,8027,477,75
67690523,67689460,67697804,8344,478,75
67702458,67701395,67710845,9450,479,75
67715594,67714531,67723608,9077,480,75
67728479,67727199,67734910,7711,481,75
67739781,67738501,67747795,9294,482,75
67752565,67751502,67760579,9077,483,75
67765290,67764227,67773304,9077,484,75
67778175,67776895,67785872,8977,485,75
67790644,67789581,67798995,9414,486,75
67803747,67802685,67811127,8442,487,75
67815829,67814766,67823210,8444,488,75
67827864,67826801,67836095,9294,489,75
67840816,67839753,67848830,9077,490,75
67853551,67852488,67862218,9730,491,75
67867089,67865809,67875103,9294,492,75
67879973,67878694,67888641,9947,493,75
67893512,67892232,67900259,8027,494,75
67904998,67903934,67911428,7494,495,75
67916137,67915075,67922567,7492,496,75
67927311,67926247,67933742,7495,497,75
67938490,67937427,67945238,7811,498,75
67949976,67948913,67957673,8760,499,75
67962439,67961376,67970137,8761,500,75
67974902,67973839,67983253,9414,501,75
67988124,67986844,67995189,8345,502,75
67999945,67998883,68007958,9075,503,75
68012829,68011549,68019892,8343,504,75
68024764,68023483,68032777,9294,505,75
68037530,68036468,68044593,8125,506,75
68049464,68048184,68057162,8978,507,75
68061872,68060809,68068302,7493,508,75
68073025,68071962,68080406,8444,509,75
68085158,68084096,68093825,9729,510,75
68098538,68097475,68105602,8127,511,75
68110473,68109193,68118487,9294,512,75
68123140,68122078,68133154,11076,513,75
68138114,68136834,68146128,9294,514,75
68150871,68149808,68158252,8444,515,75
68163123,68161843,68170504,8661,516,75
68175213,68174151,68182910,8759,517,75
68187661,68186598,68194091,7493,518,75
68198803,68197740,68206816,9076,519,75
68211575,68210512,68219272,8760,520,75
68224143,68222863,68231840,8977,521,75
68236595,68235532,68243026,7494,522,75
68247680,68246617,68257058,10441,523,75
68261801,68260738,68269788,9050,524,75
68274442,68273379,68281880,8501,525,75
68286751,68285471,68293814,8343,526,75
68298684,68297405,68306065,8660,527,75
68310936,68309656,68318317,8661,528,75
68323188,68321909,68330569,8660,529,75
68335331,68334268,68343998,9730,530,75
68348733,68347668,68355798,8130,531,75
68360528,68359465,68367908,8443,532,75
68372779,68371499,68379526,8027,533,75
68384286,68383223,68391667,8444,534,75
68396379,68395316,68403760,8444,535,75
68408631,68407351,68416329,8978,536,75
68421028,68419966,68428408,8442,537,75
68433279,68431999,68441947,9948,538,75
68446720,68445657,68453468,7811,539,75
68458339,68457059,68465720,8661,540,75
68470490,68469428,68477237,7809,541,75
68481892,68480829,68491567,10738,542,75
68496526,68495247,68504540,9293,543,75
68509194,68508131,68518869,10738,544,75
68523612,68522549,68532570,10021,545,75
68537530,68536250,68544276,8026,546,75
68549146,68547867,68556211,8344,547,75
68560981,68559918,68568361,8443,548,75
68573129,68572066,68580827,8761,549,75
68585698,68584418,68592128,7710,550,75
68596871,68595808,68603301,7493,551,75
68608054,68606991,68615751,8760,552,75
68620405,68619342,68627052,7710,553,75
68631795,68630732,68639492,8760,554,75
68644363,68643083,68651426,8343,555,75
68656080,68655017,68664806,9789,556,75
68669676,68668397,68677372,8975,557,75
68682025,68680963,68690433,9470,558,75
68695176,68694113,68703190,9077,559,75
68707909,68706847,68714656,7809,560,75
68719390,68718328,68726771,8443,561,75
68731491,68730429,68738872,8443,562,75
68743630,68742567,68751010,8443,563,75
68755780,68754717,68764132,9415,564,75
68768891,68767828,68776272,8444,565,75
68781053,68779990,68787484,7494,566,75
68792355,68791075,68800369,9294,567,75
68805240,68803960,68813254,9294,568,75
68818124,68816845,68826792,9947,569,75
68831663,68830383,68839043,8660,570,75
68843759,68842697,68850507,7810,571,75
68855291,68854228,68862355,8127,572,75
68867226,68865946,68874607,8661,573,75
68879477,68878198,68886857,8659,574,75
68891728,68890448,68899108,8660,575,75
68903845,68902782,68911542,8760,576,75
68916413,68915133,68923794,8661,577,75
68928664,68927385,68935728,8343,578,75
68940512,68939449,68948864,9415,579,75
68953735,68952455,68960482,8027,580,75
68965135,68964073,68973543,9470,581,75
68978414,68977134,68984845,7711,582,75
68989549,68988486,68996613,8127,583,75
69001483,69000204,69008863,8659,584,75
69013611,69012548,69020358,7810,585,75
69025097,69024034,69031845,7811,586,75
69036716,69035436,69045067,9631,587,75
69049834,69048771,69057531,8760,588,75
69062401,69061122,69069781,8659,589,75
69074553,69073490,69081934,8444,590,75
69086588,69085525,69094681,9156,591,75
69099417,69098355,69108086,9731,592,75
69112822,69111759,69120519,8760,593,75
69125264,69124201,69132960,8759,594,75
69137614,69136551,69146339,9788,595,75
69150993,69149930,69161321,11391,596,75
69166122,69165059,69174790,9731,597,75
69179550,69178487,69187247,8760,598,75
69192007,69190944,69200359,9415,599,75
69205013,69203950,69212768,8818,600,75
69217526,69216463,69226194,9731,601,75
69230932,69229869,69238312,8443,602,75
69243023,69241961,69250720,8759,603,75
69255465,69254402,69264133,9731,604,75
69268787,69267724,69276563,8839,605,75
69281299,69280236,69287729,7493,606,75
69292440,69291377,69301107,9730,607,75
69305868,69304805,69314218,9413,608,75
69319089,69317809,69325837,8028,609,75
69330707,69329428,69339375,9947,610,75
69344246,69342966,69350677,7711,611,75
69355451,69354388,69361882,7494,612,75
69366535,69365473,69373182,7709,613,75
69377837,69376774,69386900,10126,614,75
69391749,69390686,69399763,9077,615,75
69404522,69403460,69411269,7809,616,75
69416040,69414977,69423104,8127,617,75
69427871,69426808,69435885,9077,618,75
69440539,69439476,69447978,8502,619,75
69452849,69451570,69461516,9946,620,75
69466265,69465202,69473012,7810,621,75
69477883,69476603,69484314,7711,622,75
69489095,69488032,69497445,9413,623,75
69502316,69501036,69509697,8661,624,75
69514480,69513418,69522493,9075,625,75
69527363,69526084,69535715,9631,626,75
69540431,69539368,69549099,9731,627,75
69553884,69552821,69562552,9731,628,75
69567422,69566143,69575436,9293,629,75
69580183,69579120,69587564,8444,630,75
69592434,69591155,69598864,7709,631,75
69603608,69602545,69610356,7811,632,75
69615137,69614074,69623489,9415,633,75
69628359,69627080,69636373,9293,634,75
69641121,69640058,69649472,9414,635,75
69654343,69653063,69662695,9632,636,75
69667459,69666396,69675811,9415,637,75
69680465,69679402,69687429,8027,638,75
69692163,69691100,69698910,7810,639,75
69703655,69702593,69712007,9414,640,75
69716768,69715705,69723515,7810,641,75
69728168,69727106,69735764,8658,642,75
69740635,69739355,69749302,9947,643,75
69754040,69752977,69761738,8761,644,75
69766608,69765329,69773356,8027,645,75
69778226,69776947,69785290,8343,646,75
69789999,69788936,69797696,8760,647,75
69802566,69801287,69811234,9947,648,75
69816105,69814825,69822536,7711,649,75
69827272,69826209,69834653,8444,650,75
69839524,69838244,69847538,9294,651,75
69852253,69851191,69859951,8760,652,75
69864821,69863542,69872856,9314,653,75
69877628,69876565,69884375,7810,654,75
69889085,69888022,69897435,9413,655,75
69902306,69901026,69909053,8027,656,75
69913924,69912644,69922276,9632,657,75
69927147,69925867,69935499,9632,658,75
69940241,69939178,69946672,7494,659,75
69951377,69950314,69960045,9731,660,75
69964767,69963704,69972463,8759,661,75
69977242,69976179,69985593,9414,662,75
69990463,69989184,69998477,9293,663,75
70003347,70002068,70009778,7710,664,75
70014515,70013452,70023182,9730,665,75
70028054,70026774,70034802,8028,666,75
70039560,70038497,70045991,7494,667,75
70050736,70049673,70057167,7494,668,75
70061821,70060758,70068309,7551,669,75
70073180,70071900,70081532,9632,670,75
70086256,70085193,70093004,7811,671,75
70097875,70096595,70106543,9948,672,75
70111414,70110134,70118161,8027,673,75
70122816,70121753,70131068,9315,674,75
70135785,70134722,70142216,7494,675,75
70147088,70145808,70154468,8660,676,75
70159338,70158059,70167352,9293,677,75
70172074,70171012,70178505,7493,678,75
70183267,70182204,70190015,7811,679,75
70194885,70193606,70203553,9947,680,75
70208331,70207268,70216998,9730,681,75
70221726,70220663,70228790,8127,682,75
70233527,70232464,70239958,7494,683,75
70244830,70243550,70252844,9294,684,75
70257544,70256481,70263974,7493,685,75
70268708,70267645,70277377,9732,686,75
70282248,70280969,70290282,9313,687,75
70295056,70293993,70303724,9731,688,75
70308489,70307426,70315237,7811,689,75
70319972,70318910,70328641,9731,690,75
70333340,70332277,70341692,9415,691,75
70346563,70345283,70354915,9632,692,75
70359626,70358563,70367978,9415,693,75
70372850,70371570,70379915,8345,694,75
70384639,70383576,70392991,9415,695,75
70397862,70396582,70404609,8027,696,75
70409481,70408201,70415912,7711,697,75
70420621,70419559,70428656,9097,698,75
70433527,70432247,70440908,8661,699,75
70445562,70444499,70455574,11075,700,75
70460317,70459254,70469275,10021,701,75
70474234,70472955,70481614,8659,702,75
70486485,70485205,70494836,9631,703,75
70499587,70498525,70507284,8759,704,75
70512056,70510993,70519437,8444,705,75
70524155,70523092,70532507,9415,706,75
70537378,70536098,70544125,8027,707,75
70548996,70547716,70555744,8028,708,75
70560614,70559335,70567995,8660,709,75
70572866,70571586,70580564,8978,710,75
70585277,70584214,70591708,7494,711,75
70596579,70595299,70604276,8977,712,75
70608978,70607915,70615725,7810,713,75
70620480,70619417,70628832,9415,714,75
70633596,70632534,70641948,9414,715,75
70646706,70645643,70654720,9077,716,75
70659374,70658311,70666655,8344,717,75
70671427,70670364,70678175,7811,718,75
70682829,70681766,70691555,9789,719,75
70696317,70695254,70703064,7810,720,75
70707935,70706655,70715948,9293,721,75
70720819,70719539,70729171,9632,722,75
70733896,70732834,70740644,7810,723,75
70745416,70744353,70751847,7494,724,75
70756604,70755541,70764618,9077,725,75
70769334,70768271,70778001,9730,726,75
70782872,70781592,70789937,8345,727,75
70794708,70793646,70802089,8443,728,75
70806959,70805680,70815627,9947,729,75
70820360,70819297,70826791,7494,730,75
70831445,70830382,70840171,9789,731,75
70844888,70843825,70853239,9414,732,75
70858013,70856951,70864760,7809,733,75
70869503,70868440,70877537,9097,734,75
70882190,70881128,70890759,9631,735,75
70895506,70894443,70902254,7811,736,75
70906965,70905902,70914663,8761,737,75
70919534,70918254,70926598,8344,738,75
70931322,70930260,70939990,9730,739,75
70944703,70943639,70952400,8761,740,75
70957271,70955991,70964019,8028,741,75
70968890,70967610,70976587,8977,742,75
70981458,70980178,70988839,8661,743,75
70993493,70992430,71000635,8205,744,75
71005505,71004226,71013857,9631,745,75
71018511,71017448,71026286,8838,746,75
71031043,71029980,71039711,9731,747,75
71044455,71043392,71052806,9414,748,75
71057505,71056443,71064252,7809,749,75
71068959,71067896,71076023,8127,750,75
71080894,71079614,71088592,8978,751,75
71093463,71092183,71101814,9631,752,75
71106684,71105405,71115036,9631,753,75
71119907,71118627,71128259,9632,754,75
71132997,71131935,71140694,8759,755,75
71145444,71144381,71152191,7810,756,75
71156845,71155782,71165253,9471,757,75
71169954,71168891,71176701,7810,758,75
71181572,71180292,71188320,8028,759,75
71193191,71191911,71201859,9948,760,75
71206730,71205450,71215081,9631,761,75
71219735,71218672,71227510,8838,762,75
71232255,71231193,71238686,7493,763,75
71243471,71242408,71251484,9076,764,75
71256355,71255075,71264053,8978,765,75
71268924,71267644,71275356,7712,766,75
71280228,71278948,71286659,7711,767,75
71291313,71290250,71300039,9789,768,75
71304754,71303691,71313422,9731,769,75
71318169,71317106,71325550,8444,770,75
71330421,71329141,71339090,9949,771,75
71343831,71342769,71351529,8760,772,75
71356184,71355121,71364415,9294,773,75
71369285,71368006,71376666,8660,774,75
71381405,71380342,71388153,7811,775,75
71392927,71391863,71399675,7812,776,75
71404438,71403376,71413107,9731,777,75
71417979,71416699,71426331,9632,778,75
71431203,71429923,71438899,8976,779,75
71443769,71442490,71452437,9947,780,75
71457190,71456127,71463621,7494,781,75
71468492,71467212,71474923,7711,782,75
71479673,71478610,71486420,7810,783,75
71491074,71490011,71500116,10105,784,75
71504958,71503895,71512339,8444,785,75
71517120,71516057,71525788,9731,786,75
71530660,71529380,71537724,8344,787,75
71542466,71541403,71549529,8126,788,75
71554400,71553120,71563068,9948,789,75
71567939,71566659,71575319,8660,790,75
71580067,71579004,71586498,7494,791,75
71591250,71590187,71597998,7811,792,75
71602653,71601590,71612664,11074,793,75
71617407,71616344,71631260,14916,794,75
71636003,71634940,71643379,8439,795,75
71648250,71646971,71656919,9948,796,75
71661574,71660511,71669487,8976,797,75
71674142,71673079,71681896,8817,798,75
71686656,71685593,71693404,7811,799,75
71698058,71696995,71706151,9156,800,75
71710805,71709742,71719529,9787,801,75
71724400,71723120,71732414,9294,802,75
71737125,71736062,71745139,9077,803,75
71749873,71748810,71758541,9731,804,75
71763257,71762194,71770954,8760,805,75
71775690,71774627,71784358,9731,806,75
71789012,71787949,71798055,10106,807,75
71803014,71801735,71811028,9293,808,75
71815786,71814724,71823166,8442,809,75
71827901,71826838,71834649,7811,810,75
71839418,71838355,71846799,8444,811,75
71851669,71850390,71858099,7709,812,75
71862852,71861789,71869916,8127,813,75
71874787,71873508,71881534,8026,814,75
71886405,71885125,71894102,8977,815,75
71898973,71897693,71906669,8976,816,75
71911323,71910260,71920682,10422,817,75
71925515,71924452,71932262,7810,818,75
71936916,71935853,71944353,8500,819,75
71949224,71947944,71955654,7710,820,75
71960525,71959245,71967906,8661,821,75
71972561,71971498,71980338,8840,822,75
71985119,71984057,71992816,8759,823,75
71997687,71996407,72005384,8977,824,75
72010254,72008975,72017634,8659,825,75
72022404,72021341,72030755,9414,826,75
72035510,72034447,72042575,8128,827,75
72047313,72046250,72055665,9415,828,75
72060414,72059351,72067162,7811,829,75
72072032,72070753,72079096,8343,830,75
72083835,72082772,72090583,7811,831,75
72095293,72094230,72103307,9077,832,75
72107961,72106898,72115737,8839,833,75
72120509,72119446,72126939,7493,834,75
72131809,72130530,72138873,8343,835,75
72143581,72142518,72150644,8126,836,75
72155389,72154326,72163403,9077,837,75
72168124,72167061,72174555,7494,838,75
72179308,72178245,72187975,9730,839,75
72192713,72191650,72200410,8760,840,75
72205064,72204001,72213135,9134,841,75
72217789,72216726,72226199,9473,842,75
72230966,72229903,72238664,8761,843,75
72243535,72242255,72250283,8028,844,75
72255154,72253874,72263822,9948,845,75
72268573,72267510,72275953,8443,846,75
72280824,72279544,72288838,9294,847,75
72293594,72292531,72300342,7811,848,75
72304996,72303933,72311643,7710,849,75
72316297,72315235,72326310,11075,850,75
72331127,72330064,72339795,9731,851,75
72344666,72343386,72353334,9948,852,75
72358034,72356971,72364781,7810,853,75
72369652,72368372,72376083,7711,854,75
72380953,72379674,72388651,8977,855,75
72393351,72392289,72402019,9730,856,75
72406673,72405610,72414270,8660,857,75
72418996,72417933,72427347,9414,858,75
72432122,72431059,72440790,9731,859,75
72445529,72444466,72451960,7494,860,75
72456705,72455642,72463136,7494,861,75
72467885,72466823,72475583,8760,862,75
72480454,72479174,72486885,7711,863,75
72491661,72490598,72499695,9097,864,75
72504565,72503286,72511312,8026,865,75
72516023,72514960,72523720,8760,866,75
72528374,72527311,72535177,7866,867,75
72539959,72538896,72547993,9097,868,75
72552758,72551696,72559506,7810,869,75
72564376,72563097,72572074,8977,870,75
72576782,72575719,72583846,8127,871,75
72588500,72587437,72596254,8817,872,75
72600997,72599934,72607429,7495,873,75
72612176,72611113,72619874,8761,874,75
72624585,72623523,72632937,9414,875,75
72637807,72636528,72644871,8343,876,75
72649612,72648549,72656360,7811,877,75
72661130,72660067,72669144,9077,878,75
72673870,72672807,72680617,7810,879,75
72685356,72684293,72693371,9078,880,75
72698124,72697061,72706791,9730,881,75
72711539,72710476,72717970,7494,882,75
72722722,72721660,72731391,9731,883,75
72736139,72735077,72742570,7493,884,75
72747277,72746214,72754658,8444,885,75
72759529,72758249,72766277,8028,886,75
72770982,72769919,72777413,7494,887,75
72782284,72781004,72790298,9294,888,75
72795168,72793889,72803181,9292,889,75
72807930,72806867,72814994,8127,890,75
72819648,72818585,72829640,11055,891,75
72834484,72833422,72841865,8443,892,75
72846565,72845502,72854263,8761,893,75
72859134,72857854,72865882,8028,894,75
72870666,72869603,72879333,9730,895,75
72884088,72883025,72890836,7811,896,75
72895570,72894507,72903268,8761,897,75
72908139,72906860,72915520,8660,898,75
72920392,72919112,72928744,9632,899,75
72933615,72932335,72940046,7711,900,75
72944791,72943728,72951222,7494,901,75
72955934,72954871,72963315,8444,902,75
72968073,72967010,72976741,9731,903,75
72981484,72980421,72988232,7811,904,75
72992971,72991908,73000669,8761,905,75
73005453,73004390,73014121,9731,906,75
73018897,73017834,73025645,7811,907,75
73030516,73029236,73037580,8344,908,75
73042450,73041171,73049515,8344,909,75
73054223,73053160,73062890,9730,910,75
73067661,73066598,73076328,9730,911,75
73081199,73079919,73087946,8027,912,75
73092703,73091640,73101055,9415,913,75
73105769,73104706,73112199,7493,914,75
73116967,73115904,73123398,7494,915,75
73128051,73126989,73137746,10757,916,75
73142563,73141500,73151231,9731,917,75
73155937,73154874,73163001,8127,918,75
73167873,73166593,73175254,8661,919,75
73180035,73178972,73187416,8444,920,75
73192070,73191007,73200480,9473,921,75
73205351,73204072,73214019,9947,922,75
73218764,73217702,73225512,7810,923,75
73230283,73229220,73238951,9731,924,75
73243821,73242542,73250886,8344,925,75
73255756,73254477,73263454,8977,926,75
73268325,73267045,73274756,7711,927,75
73279509,73278447,73287543,9096,928,75
73292276,73291214,73299024,7810,929,75
73303894,73302615,73311592,8977,930,75
73316351,73315289,73324049,8760,931,75
73328815,73327752,73336850,9098,932,75
73341623,73340560,73348686,8126,933,75
73353558,73352278,73361255,8977,934,75
73365908,73364846,73374159,9313,935,75
73378863,73377801,73385610,7809,936,75
73390373,73389310,73399042,9732,937,75
73403914,73402634,73411949,9315,938,75
73416673,73415610,73423421,7811,939,75
73428292,73427012,73436960,9948,940,75
73441711,73440647,73450062,9415,941,75
73454820,73453757,73461885,8128,942,75
73466643,73465580,73474341,8761,943,75
73479211,73477932,73485959,8027,944,75
73490613,73489550,73497894,8344,945,75
73502626,73501563,73509374,7811,946,75
73514085,73513022,73520832,7810,947,75
73525618,73524555,73532998,8443,948,75
73537868,73536589,73546220,9631,949,75
73551003,73549940,73559672,9732,950,75
73564326,73563263,73573685,10422,951,75
73578508,73577445,73585572,8127,952,75
73590442,73589163,73598477,9314,953,75
73603236,73602173,73610300,8127,954,75
73615053,73613990,73622117,8127,955,75
73626988,73625708,73633419,7711,956,75
73638181,73637118,73646533,9415,957,75
73651404,73650124,73660072,9948,958,75
73664819,73663756,73671884,8128,959,75
73676632,73675570,73684646,9076,960,75
73689402,73688339,73695834,7495,961,75
73700552,73699489,73709220,9731,962,75
73714090,73712811,73722125,9314,963,75
73726995,73725716,73733743,8027,964,75
73738397,73737334,73745362,8028,965,75
73750089,73749026,73757153,8127,966,75
73762023,73760744,73770058,9314,967,75
73774929,73773649,73781677,8028,968,75
73786547,73785268,73793927,8659,969,75
73798680,73797617,73807347,9730,970,75
73812093,73811030,73819790,8760,971,75
73824444,73823381,73833012,9631,972,75
73837666,73836603,73845441,8838,973,75
73850094,73849032,73857237,8205,974,75
73862108,73860828,73869171,8343,975,75
73873871,73872808,73882539,9731,976,75
73887192,73886130,73894652,8522,977,75
73899390,73898327,73907088,8761,978,75
73911869,73910805,73919904,9099,979,75
73924774,73923495,73933126,9631,980,75
73937780,73936717,73945873,9156,981,75
73950632,73949569,73957380,7811,982,75
73962250,73960971,73969314,8343,983,75
73974098,73973035,73980529,7494,984,75
73985400,73984120,73991831,7711,985,75
73996598,73995536,74003346,7810,986,75
74008218,74006937,74014649,7712,987,75
74019434,74018371,74026815,8444,988,75
74031469,74030406,74041144,10738,989,75
74045998,74044935,74053379,8444,990,75
74058100,74057037,74065481,8444,991,75
74070351,74069072,74077099,8027,992,75
74081797,74080735,74089832,9097,993,75
74094539,74093476,74102891,9415,994,75
74107634,74106571,74115330,8759,995,75
74120201,74118921,74128551,9630,996,75
74133315,74132252,74140378,8126,997,75
74145115,74144052,74152813,8761,998,75
74157540,74156477,74166208,9731,999,75
74171079,74169799,74179747,9948,1000,75
74184580,74183517,74192277,8760,1001,75
74197236,74195957,74205271,9314,1002,75
74210231,74208951,74216661,7710,1003,75
74221522,74220460,74229219,8759,1004,75
74234179,74232899,74242193,9294,1005,75
74247047,74245985,74254427,8442,1006,75
74259267,74258204,74266331,8127,1007,75
74271290,74270011,74279641,9630,1008,75
74284466,74283403,74292818,9415,1009,75
74297667,74296604,74305364,8760,1010,75
74310107,74309044,74317480,8436,1011,75
74322440,74321160,74330475,9315,1012,75
74335307,74334245,74343005,8760,1013,75
74347837,74346774,74355872,9098,1014,75
74360833,74359552,74367263,7711,1015,75
74372223,74370943,74379287,8344,1016,75
74384246,74382967,74391626,8659,1017,75
74396498,74395435,74404850,9415,1018,75
74409810,74408530,74418478,9948,1019,75
74423438,74422158,74431790,9632,1020,75
74436614,74435552,74444965,9413,1021,75
74449826,74448763,74456889,8126,1022,75
74461735,74460672,74468483,7811,1023,75
74473442,74472163,74481794,9631,1024,75
74486636,74485573,74494986,9413,1025,75
74499834,74498771,74507532,8761,1026,75
74512389,74511326,74520423,9097,1027,75
74525383,74524103,74532448,8345,1028,75
74537191,74536128,74545758,9630,1029,75
74550568,74549504,74558265,8761,1030,75
74563224,74561945,74571892,9947,1031,75
74576680,74575618,74583427,7809,1032,75
74588253,74587191,74596921,9730,1033,75
74601757,74600694,74610425,9731,1034,75
74615223,74614160,74623890,9730,1035,75
74628699,74627636,74636080,8444,1036,75
74640887,74639824,74647317,7493,1037,75
74652060,74650997,74660679,9682,1038,75
74665639,74664359,74673019,8660,1039,75
74677860,74676797,74685895,9098,1040,75
74690752,74689689,74697817,8128,1041,75
74702679,74701616,74709111,7495,1042,75
74713981,74712917,74721362,8445,1043,75
74726322,74725042,74733070,8028,1044,75
74738030,74736750,74745727,8977,1045,75
74750596,74749534,74757977,8443,1046,75
74762844,74761781,74769908,8127,1047,75
74774714,74773651,74783382,9731,1048,75
74788342,74787062,74797009,9947,1049,75
74801968,74800689,74808398,7709,1050,75
74813238,74812175,74821905,9730,1051,75
74826691,74825629,74835043,9414,1052,75
74840003,74838723,74848354,9631,1053,75
74853194,74852131,74860575,8444,1054,75
74865370,74864307,74872435,8128,1055,75
74877395,74876115,74884142,8027,1056,75
74889102,74887822,74896800,8978,1057,75
74901760,74900480,74908508,8028,1058,75
74913313,74912250,74920377,8127,1059,75
74925206,74924144,74933873,9729,1060,75
74938733,74937670,74946114,8444,1061,75
74951074,74949794,74959088,9294,1062,75
74963952,74962888,74970699,7811,1063,75
74975559,74974496,74983257,8761,1064,75
74988080,74987017,74996748,9731,1065,75
75001707,75000428,75009087,8659,1066,75
75013920,75012857,75021301,8444,1067,75
75026044,75024981,75034612,9631,1068,75
75039418,75038355,75045849,7494,1069,75
75050707,75049644,75059059,9415,1070,75
75064019,75062739,75070450,7711,1071,75
75075410,75074130,75082156,8026,1072,75
75087116,75085836,75093863,8027,1073,75
75098734,75097671,75106431,8760,1074,75
75111231,75110168,75118295,8127,1075,75
75123255,75121975,75131269,9294,1076,75
75136228,75134949,75143293,8344,1077,75
75148114,75147051,75156149,9098,1078,75
75161109,75159829,75169777,9948,1079,75
75174736,75173457,75181167,7710,1080,75
75186127,75184847,75194478,9631,1081,75
75199438,75198158,75207136,8978,1082,75
75212000,75210937,75218747,7810,1083,75
75223608,75222545,75230355,7810,1084,75
75235165,75234102,75241912,7810,1085,75
75246749,75245686,75254130,8444,1086,75
75259089,75257810,75266786,8976,1087,75
75271746,75270466,75279443,8977,1088,75
75284261,75283198,75290692,7494,1089,75
75295651,75294372,75302716,8344,1090,75
75307675,75306396,75315689,9293,1091,75
75320521,75319458,75328534,9076,1092,75
75333381,75332318,75342049,9731,1093,75
75346889,75345827,75355240,9413,1094,75
75359983,75358920,75367336,8416,1095,75
75372295,75371016,75380963,9947,1096,75
75385923,75384643,75394590,9947,1097,75
75399550,75398270,75405981,7711,1098,75
75410941,75409661,75417371,7710,1099,75
75422331,75421051,75430345,9294,1100,75
75435209,75434146,75441957,7811,1101,75
75446816,75445753,75453248,7495,1102,75
75457990,75456928,75464710,7782,1103,75
75469543,75468480,75475974,7494,1104,75
75480933,75479654,75488947,9293,1105,75
75493907,75492627,75501287,8660,1106,75
75506030,75504967,75515958,10991,1107,75
75520879,75519817,75529231,9414,1108,75
75534192,75532912,75542543,9631,1109,75
75547503,75546223,75555854,9631,1110,75
75560673,75559611,75567104,7493,1111,75
75572064,75570784,75578812,8028,1112,75
75583772,75582492,75590203,7711,1113,75
75595163,75593883,75602860,8977,1114,75
75607819,75606540,75614883,8343,1115,75
75619680,75618617,75626111,7494,1116,75
75630976,75629913,75638357,8444,1117,75
75643226,75642163,75650607,8444,1118,75
75655566,75654287,75664235,9948,1119,75
75668978,75667915,75676965,9050,1120,75
75681820,75680757,75689201,8444,1121,75
75694161,75692881,75701542,8661,1122,75
75706285,75705222,75715876,10654,1123,75
75720709,75719645,75727660,8015,1124,75
75732507,75731444,75741175,9731,1125,75
75746048,75744985,75752478,7493,1126,75
75757311,75756248,75765008,8760,1127,75
75769751,75768688,75776789,8101,1128,75
75781586,75780523,75788017,7494,1129,75
75792867,75791804,75799615,7811,1130,75
75804357,75803295,75811710,8415,1131,75
75816533,75815470,75823597,8127,1132,75
75828557,75827277,75836592,9315,1133,75
75841551,75840272,75848932,8660,1134,75
75853891,75852612,75860321,7709,1135,75
75865281,75864001,75872028,8027,1136,75
75876987,75875708,75883734,8026,1137,75
75888694,75887414,75895124,7710,1138,75
75900083,75898804,75907779,8975,1139,75
75912643,75911581,75919706,8125,1140,75
75924562,75923500,75933230,9730,1141,75
75938190,75936910,75946204,9294,1142,75
75951035,75949973,75959387,9414,1143,75
75964129,75963067,75971188,8121,1144,75
75976147,75974868,75983528,8660,1145,75
75988359,75987297,75994789,7492,1146,75
75999748,75998469,76006495,8026,1147,75
76011329,76010265,76018077,7812,1148,75
76023036,76021757,76029784,8027,1149,75
76034601,76033538,76042297,8759,1150,75
76047095,76046032,76055763,9731,1151,75
76060723,76059443,76068104,8661,1152,75
76073063,76071784,76079493,7709,1153,75
76084236,76083173,76093511,10338,1154,75
76098559,76097280,76106911,9631,1155,75
76111779,76110716,76118210,7494,1156,75
76123170,76121890,76130234,8344,1157,75
76135194,76133914,76143546,9632,1158,75
76148371,76147308,76155752,8444,1159,75
76160711,76159432,76169063,9631,1160,75
76174023,76172743,76182691,9948,1161,75
76187651,76186371,76195031,8660,1162,75
76199990,76198711,76208658,9947,1163,75
76213454,76212391,76221467,9076,1164,75
76226210,76225147,76233175,8028,1165,75
76238038,76236975,76245103,8128,1166,75
76249945,76248882,76256692,7810,1167,75
76261534,76260471,76268914,8443,1168,75
76273713,76272650,76281094,8444,1169,75
76285901,76284839,76294253,9414,1170,75
76299070,76298007,76305500,7493,1171,75
76310349,76309287,76319017,9730,1172,75
76323856,76322793,76332524,9731,1173,75
76337483,76336204,76344863,8659,1174,75
76349822,76348543,76358173,9630,1175,75
76362995,76361932,76370060,8128,1176,75
76374890,76373827,76382925,9098,1177,75
76387884,76386605,76396553,9948,1178,75
76401408,76400345,76408789,8444,1179,75
76413627,76412564,76421662,9098,1180,75
76426522,76425459,76435190,9731,1181,75
76440149,76438870,76448184,9314,1182,75
76453143,76451864,76461811,9947,1183,75
76466771,76465491,76474469,8978,1184,75
76479428,76478149,76488096,9947,1185,75
76492897,76491834,76499645,7811,1186,75
76504604,76503325,76511035,7710,1187,75
76515874,76514811,76523254,8443,1188,75
76527997,76526934,76536322,9388,1189,75
76541281,76540002,76549632,9630,1190,75
76554445,76553382,76563113,9731,1191,75
76568073,76566793,76576740,9947,1192,75
76581544,76580481,76587974,7493,1193,75
76592773,76591711,76601125,9414,1194,75
76606085,76604805,76613466,8661,1195,75
76618307,76617244,76625054,7810,1196,75
76629797,76628734,76638777,10043,1197,75
76643826,76642546,76651861,9315,1198,75
76656820,76655541,76664201,8660,1199,75
76669030,76667967,76677044,9077,1200,75
76682004,76680724,76689702,8978,1201,75
76694662,76693382,76702359,8977,1202,75
76707170,76706107,76715522,9415,1203,75
76720335,76719272,76728687,9415,1204,75
76733430,76732367,76741437,9070,1205,75
76746397,76745117,76753144,8027,1206,75
76758104,76756824,76766772,9948,1207,75
76771732,76770453,76778164,7711,1208,75
76783124,76781844,76789555,7711,1209,75
76794379,76793317,76803048,9731,1210,75
76807791,76806728,76815778,9050,1211,75
76820737,76819458,76829405,9947,1212,75
76834222,76833159,76842257,9098,1213,75
76847217,76845937,76855884,9947,1214,75
76860754,76859691,76868134,8443,1215,75
76873093,76871814,76881444,9630,1216,75
76886287,76885224,76893035,7811,1217,75
76897851,76896788,76904915,8127,1218,75
76909875,76908595,76918226,9631,1219,75
76923093,76922030,76929840,7810,1220,75
76934660,76933597,76943328,9731,1221,75
76948287,76947008,76955035,8027,1222,75
76959836,76958773,76968504,9731,1223,75
76973353,76972290,76980100,7810,1224,75
76985060,76983780,76993411,9631,1225,75
76998243,76997181,77006594,9413,1226,75
77011413,77010350,77019427,9077,1227,75
77024386,77023107,77033054,9947,1228,75
77038014,77036734,77045394,8660,1229,75
77050251,77049188,77057631,8443,1230,75
77062489,77061426,77070186,8760,1231,75
77075146,77073866,77083814,9948,1232,75
77088774,77087494,77096154,8660,1233,75
77100951,77099888,77108648,8760,1234,75
77113438,77112375,77121472,9097,1235,75
77126317,77125254,77134352,9098,1236,75
77139183,77138120,77147218,9098,1237,75
77152074,77151012,77159771,8759,1238,75
77164628,77163566,77172642,9076,1239,75
77177488,77176425,77186155,9730,1240,75
77191115,77189835,77198495,8660,1241,75
77203238,77202175,77212196,10021,1242,75
77217244,77215965,77224625,8660,1243,75
77229584,77228305,77236647,8342,1244,75
77241462,77240400,77249813,9413,1245,75
77254681,77253618,77262377,8759,1246,75
77267336,77266057,77275688,9631,1247,75
77280558,77279495,77286989,7494,1248,75
77291949,77290669,77300617,9948,1249,75
77305449,77304386,77312197,7811,1250,75
77317156,77315877,77324854,8977,1251,75
77329814,77328534,77337194,8660,1252,75
77342025,77340962,77349090,8128,1253,75
77354050,77352770,77360798,8028,1254,75
77365630,77364567,77372694,8127,1255,75
77377654,77376374,77385351,8977,1256,75
77390196,77389134,77397577,8443,1257,75
77402537,77401257,77409284,8027,1258,75
77414104,77413041,77421802,8761,1259,75
77426641,77425579,77434022,8443,1260,75
77438981,77437702,77446679,8977,1261,75
77451547,77450484,77458611,8127,1262,75
77463570,77462291,77470951,8660,1263,75
77475694,77474631,77483386,8755,1264,75
77488128,77487066,77496452,9386,1265,75
77501195,77500132,77509204,9072,1266,75
77514164,77512884,77522833,9949,1267,75
77527682,77526619,77536033,9414,1268,75
77540993,77539713,77548374,8661,1269,75
77553202,77552139,77561237,9098,1270,75
77566101,77565038,77574770,9732,1271,75
77579600,77578537,77587635,9098,1272,75
77592456,77591393,77598886,7493,1273,75
77603746,77602683,77610493,7810,1274,75
77615453,77614173,77623805,9632,1275,75
77628678,77627615,77635425,7810,1276,75
77640241,77639178,77647305,8127,1277,75
77652265,77650985,77658695,7710,1278,75
77663537,77662475,77671233,8758,1279,75
77676060,77674997,77684412,9415,1280,75
77689258,77688195,77697926,9731,1281,75
77702757,77701694,77709188,7494,1282,75
77714147,77712868,77722816,9948,1283,75
77727624,77726561,77735004,8443,1284,75
77739850,77738788,77746281,7493,1285,75
77751122,77750060,77757870,7810,1286,75
77762704,77761641,77769135,7494,1287,75
77773973,77772910,77780404,7494,1288,75
77785363,77784084,77794031,9947,1289,75
77798833,77797770,77805265,7495,1290,75
77810225,77808945,77816972,8027,1291,75
77821811,77820749,77830480,9731,1292,75
77835313,77834250,77843981,9731,1293,75
77848821,77847758,77855885,8127,1294,75
77860628,77859565,77870241,10676,1295,75
77875289,77874010,77882669,8659,1296,75
77887411,77886349,77895009,8660,1297,75
77899968,77898689,77906399,7710,1298,75
77911358,77910079,77920027,9948,1299,75
77924987,77923707,77933339,9632,1300,75
77938299,77937019,77946968,9949,1301,75
77951928,77950648,77958359,7711,1302,75
77963158,77962095,77969589,7494,1303,75
77974440,77973377,77981188,7811,1304,75
77986009,77984946,77992756,7810,1305,75
77997716,77996436,78004779,8343,1306,75
78009628,78008565,78016692,8127,1307,75
78021435,78020372,78030394,10022,1308,75
78035353,78034290,78043367,9077,1309,75
78048209,78047146,78054956,7810,1310,75
78059700,78058636,78068975,10339,1311,75
78073935,78072872,78080999,8127,1312,75
78085959,78084679,78092706,8027,1313,75
78097499,78096436,78105534,9098,1314,75
78110493,78109214,78117874,8660,1315,75
78122721,78121659,78130419,8760,1316,75
78135278,78134215,78143629,9414,1317,75
78148371,78147309,78156285,8976,1318,75
78161028,78159965,78169036,9071,1319,75
78173830,78172767,78182182,9415,1320,75
78187142,78185862,78194839,8977,1321,75
78199799,78198519,78206547,8028,1322,75
78211347,78210284,78219045,8761,1323,75
78223881,78222818,78230629,7811,1324,75
78235372,78234309,78242407,8098,1325,75
78247366,78246087,78254114,8027,1326,75
78259074,78257794,78266771,8977,1327,75
78271614,78270551,78280282,9731,1328,75
78285242,78283962,78293594,9632,1329,75
78298387,78297324,78306422,9098,1330,75
78311382,78310102,78320049,9947,1331,75
78325008,78323729,78331756,8027,1332,75
78336716,78335436,78345068,9632,1333,75
78349881,78348819,78356629,7810,1334,75
78361418,78360355,78369769,9414,1335,75
78374728,78373449,78382109,8660,1336,75
78386940,78385878,78395609,9731,1337,75
78400405,78399342,78408418,9076,1338,75
78413247,78412184,78419678,7494,1339,75
78424421,78423358,78433378,10020,1340,75
78438210,78437147,78447094,9947,1341,75
78451949,78450886,78458380,7494,1342,75
78463340,78462060,78472009,9949,1343,75
78476805,78475742,78483236,7494,1344,75
78488196,78486916,78494944,8028,1345,75
78499903,78498624,78508255,9631,1346,75
78512998,78511935,78519718,7783,1347,75
78524677,78523398,78532375,8977,1348,75
78537224,78536161,78545576,9415,1349,75
78550536,78549256,78559205,9949,1350,75
78564038,78562975,78570469,7494,1351,75
78575313,78574250,78582694,8444,1352,75
78587493,78586430,78594557,8127,1353,75
78599388,78598325,78606453,8128,1354,75
78611298,78610235,78619649,9414,1355,75
78624493,78623430,78632191,8761,1356,75
78637151,78635871,78643583,7712,1357,75
78648543,78647263,78657211,9948,1358,75
78661954,78660891,78669646,8755,1359,75
78674483,78673420,78681231,7811,1360,75
78686190,78684911,78693888,8977,1361,75
78698847,78697568,78705911,8343,1362,75
78710750,78709687,78717497,7810,1363,75
78722315,78721253,78730011,8758,1364,75
78734810,78733747,78743477,9730,1365,75
78748220,78747157,78756839,9682,1366,75
78761698,78760635,78768446,7811,1367,75
78773189,78772126,78780881,8755,1368,75
78785840,78784561,78794508,9947,1369,75
78799468,78798188,78805899,7711,1370,75
78810858,78809579,78818556,8977,1371,75
78823401,78822338,78830466,8128,1372,75
78835274,78834212,78842971,8759,1373,75
78847931,78846651,78855628,8977,1374,75
78860588,78859308,78867336,8028,1375,75
78872160,78871097,78880512,9415,1376,75
78885472,78884192,78892852,8660,1377,75
78897595,78896532,78906869,10337,1378,75
78911701,78910638,78919616,8978,1379,75
78924576,78923296,78931323,8027,1380,75
78936283,78935003,78949745,14742,1381,75
78954679,78953616,78962693,9077,1382,75
78967552,78966488,78974615,8127,1383,75
78979406,78978343,78988074,9731,1384,75
78993033,78991754,79001385,9631,1385,75
79006127,79005065,79015718,10653,1386,75
79020635,79019572,79028649,9077,1387,75
79033608,79032329,79041621,9292,1388,75
79046581,79045301,79054594,9293,1389,75
79059416,79058354,79066164,7810,1390,75
79071124,79069844,79079792,9948,1391,75
79084751,79083472,79091815,8343,1392,75
79096775,79095495,79104789,9294,1393,75
79109532,79108469,79117539,9070,1394,75
79122404,79121341,79129152,7811,1395,75
79133994,79132931,79140425,7494,1396,75
79145226,79144163,79152290,8127,1397,75
79157103,79156041,79165771,9730,1398,75
79170616,79169553,79177997,8444,1399,75
79182821,79181758,79189568,7810,1400,75
79194367,79193304,79201114,7810,1401,75
79206073,79204794,79214425,9631,1402,75
79219385,79218105,79227737,9632,1403,75
79232696,79231417,79241364,9947,1404,75
79246199,79245136,79254213,9077,1405,75
79258956,79257893,79267914,10021,1406,75
79272823,79271760,79279570,7810,1407,75
79284312,79283250,79291275,8025,1408,75
79296067,79295004,79303131,8127,1409,75
79308090,79306811,79316104,9293,1410,75
79320945,79319882,79327377,7495,1411,75
79332181,79331118,79340532,9414,1412,75
79345376,79344313,79351807,7494,1413,75
79356550,79355487,79363515,8028,1414,75
79368258,79367195,79375929,8734,1415,75
79380888,79379609,79387952,8343,1416,75
79392788,79391725,79399219,7494,1417,75
79404179,79402899,79410927,8028,1418,75
79415887,79414607,79423583,8976,1419,75
79428435,79427371,79436787,9416,1420,75
79441597,79440534,79450264,9730,1421,75
79455007,79453944,79463309,9365,1422,75
79468167,79467105,79474598,7493,1423,75
79479558,79478278,79486939,8661,1424,75
79491899,79490619,79498647,8028,1425,75
79503607,79502327,79512275,9948,1426,75
79517104,79516041,79525456,9415,1427,75
79530301,79529238,79538970,9732,1428,75
79543788,79542726,79551168,8442,1429,75
79555967,79554904,79564318,9414,1430,75
79569144,79568081,79577158,9077,1431,75
79582118,79580838,79590785,9947,1432,75
79595610,79594547,79602040,7493,1433,75
79606838,79605776,79615190,9414,1434,75
79620150,79618870,79627848,8978,1435,75
79632807,79631528,79639555,8027,1436,75
79644413,79643350,79651478,8128,1437,75
79656438,79655158,79664452,9294,1438,75
79669263,79668200,79675694,7494,1439,75
79680488,79679426,79687869,8443,1440,75
79692698,79691636,79699762,8126,1441,75
79704505,79703442,79713124,9682,1442,75
79717866,79716804,79725558,8754,1443,75
79730518,79729238,79738531,9293,1444,75
79743334,79742271,79750081,7810,1445,75
79754874,79753811,79761939,8128,1446,75
79766778,79765715,79773210,7495,1447,75
79778050,79776987,79786719,9732,1448,75
79791583,79790520,79798014,7494,1449,75
79802802,79801739,79811154,9415,1450,75
79815978,79814916,79823675,8759,1451,75
79828545,79827482,79836559,9077,1452,75
79841519,79840239,79848900,8661,1453,75
79853767,79852703,79861465,8762,1454,75
79866261,79865198,79873642,8444,1455,75
79878601,79877322,79886297,8975,1456,75
79891138,79890076,79899152,9076,1457,75
79903996,79902933,79912010,9077,1458,75
79916969,79915690,79925637,9947,1459,75
79930379,79929317,79938388,9071,1460,75
79943209,79942146,79949640,7494,1461,75
79954383,79953320,79964312,10992,1462,75
79969195,79968132,79976575,8443,1463,75
79981374,79980311,79988122,7811,1464,75
79992961,79991898,79999392,7494,1465,75
80004351,80003072,80012701,9629,1466,75
80017661,80016381,80025674,9293,1467,75
80030634,80029354,80038648,9294,1468,75
80043391,80042328,80051062,8734,1469,75
80055905,80054843,80063602,8759,1470,75
80068472,80067409,80074903,7494,1471,75
80079863,80078583,80086610,8027,1472,75
80091420,80090358,80100087,9729,1473,75
80104927,80103865,80112623,8758,1474,75
80117494,80116431,80125190,8759,1475,75
80130002,80128939,80137699,8760,1476,75
80142533,80141470,80149913,8443,1477,75
80154872,80153593,80161936,8343,1478,75
80166777,80165714,80174158,8444,1479,75
80178901,80177838,80186254,8416,1480,75
80191214,80189934,80198278,8344,1481,75
80203085,80202022,80211099,9077,1482,75
80215915,80214853,80224266,9413,1483,75
80229075,80228012,80237427,9415,1484,75
80242387,80241107,80250739,9632,1485,75
80255698,80254419,80263395,8976,1486,75
80268243,80267180,80275624,8444,1487,75
80280584,80279304,80287965,8661,1488,75
80292925,80291645,80299988,8343,1489,75
80304787,80303725,80311534,7809,1490,75
80316494,80315214,80323557,8343,1491,75
80328388,80327325,80336402,9077,1492,75
80341361,80340082,80349375,9293,1493,75
80354201,80353138,80361266,8128,1494,75
80366009,80364946,80373996,9050,1495,75
80378955,80377676,80387307,9631,1496,75
80392267,80390987,80398698,7711,1497,75
80403563,80402500,80410627,8127,1498,75
80415422,80414359,80423436,9077,1499,75
80428395,80427116,80436091,8975,1500,75
80441050,80439771,80447798,8027,1501,75
80452642,80451579,80460022,8443,1502,75
80464981,80463702,80472044,8342,1503,75
80476868,80475805,80483932,8127,1504,75
80488675,80487612,80495732,8120,1505,75
80500592,80499529,80507656,8127,1506,75
80512502,80511439,80520853,9414,1507,75
80525664,80524601,80533678,9077,1508,75
80538539,80537476,80544970,7494,1509,75
80549929,80548650,80556677,8027,1510,75
80561508,80560446,80568255,7809,1511,75
80573215,80571935,80579645,7710,1512,75
80584484,80583421,80591231,7810,1513,75
80596191,80594911,80604543,9632,1514,75
80609502,80608223,80616567,8344,1515,75
80621526,80620247,80629878,9631,1516,75
80634838,80633558,80642218,8660,1517,75
80647178,80645898,80653609,7711,1518,75
80658453,80657390,80666150,8760,1519,75
80671109,80669830,80679777,9947,1520,75
80684626,80683563,80692640,9077,1521,75
80697383,80696320,80705708,9388,1522,75
80710451,80709388,80718437,9049,1523,75
80723397,80722117,80730461,8344,1524,75
80735259,80734196,80742640,8444,1525,75
80747487,80746424,80755838,9414,1526,75
80760679,80759616,80769030,9414,1527,75
80773990,80772710,80781370,8660,1528,75
80786330,80785050,80793395,8345,1529,75
80798263,80797200,80805011,7811,1530,75
80809825,80808762,80818492,9730,1531,75
80823341,80822278,80831692,9414,1532,75
80836435,80835372,80844758,9386,1533,75
80849554,80848492,80857252,8760,1534,75
80862060,80860997,80869441,8444,1535,75
80874184,80873121,80880832,7711,1536,75
80885628,80884565,80892375,7810,1537,75
80897181,80896118,80903612,7494,1538,75
80908420,80907357,80916434,9077,1539,75
80921394,80920114,80928142,8028,1540,75
80932931,80931868,80941599,9731,1541,75
80946446,80945383,80953194,7811,1542,75
80958153,80956874,80966505,9631,1543,75
80971465,80970185,80977895,7710,1544,75
80982854,80981575,80991206,9631,1545,75
80995949,80994886,81003640,8754,1546,75
81008383,81007320,81016707,9387,1547,75
81021498,81020435,81028563,8128,1548,75
81033305,81032243,81040027,7784,1549,75
81044885,81043823,81051633,7810,1550,75
81056446,81055383,81065113,9730,1551,75
81069905,81068842,81076652,7810,1552,75
81081394,81080332,81088749,8417,1553,75
81093709,81092429,81101090,8661,1554,75
81106049,81104770,81114717,9947,1555,75
81119677,81118397,81126425,8028,1556,75
81131385,81130105,81138766,8661,1557,75
81143726,81142446,81151424,8978,1558,75
81156279,81155216,81163659,8443,1559,75
81168402,81167339,81176390,9051,1560,75
81181188,81180125,81189857,9732,1561,75
81194713,81193650,81202727,9077,1562,75
81207516,81206453,81214581,8128,1563,75
81219540,81218261,81228208,9947,1564,75
81233074,81232011,81240454,8443,1565,75
81245197,81244134,81252551,8417,1566,75
81257511,81256231,81263943,7712,1567,75
81268761,81267698,81275825,8127,1568,75
81280624,81279561,81288321,8760,1569,75
81293163,81292100,81300861,8761,1570,75
81305671,81304609,81313051,8442,1571,75
81317794,81316731,81326097,9366,1572,75
81331057,81329777,81337488,7711,1573,75
81342448,81341168,81350800,9632,1574,75
81355759,81354480,81362507,8027,1575,75
81367467,81366187,81375164,8977,1576,75
81380123,81378844,81388136,9292,1577,75
81392999,81391936,81400697,8761,1578,75
81405541,81404478,81411973,7495,1579,75
81416932,81415653,81425284,9631,1580,75
81430027,81428964,81438985,10021,1581,75
81443927,81442864,81450991,8127,1582,75
81455854,81454791,81462919,8128,1583,75
81467662,81466599,81475354,8755,1584,75
81480097,81479034,81489055,10021,1585,75
81493944,81492881,81501641,8760,1586,75
81506514,81505452,81515183,9731,1587,75
81519998,81518936,81527378,8442,1588,75
81532338,81531058,81538769,7711,1589,75
81543573,81542510,81550321,7811,1590,75
81555064,81554001,81562755,8754,1591,75
81567581,81566518,81576250,9732,1592,75
81581089,81580026,81589103,9077,1593,75
81593847,81592784,81609549,16765,1594,75
81614382,81613319,81622643,9324,1595,75
81627385,81626323,81636977,10654,1596,75
81641902,81640840,81648966,8126,1597,75
81653925,81652646,81660990,8344,1598,75
81665950,81664670,81673013,8343,1599,75
81677972,81676693,81684404,7711,1600,75
81689148,81688085,81698761,10676,1601,75
81703655,81702592,81711036,8444,1602,75
81715997,81714717,81723695,8978,1603,75
81728533,81727470,81735596,8126,1604,75
81740443,81739380,81748457,9077,1605,75
81753259,81752196,81761611,9415,1606,75
81766572,81765292,81775240,9948,1607,75
81780201,81778921,81788870,9949,1608,75
81793717,81792654,81800780,8126,1609,75
81805740,81804461,81814091,9630,1610,75
81819051,81817772,81825799,8027,1611,75
81830760,81829480,81837508,8028,1612,75
81842469,81841189,81850166,8977,1613,75
81855126,81853847,81863478,9631,1614,75
81868439,81867159,81876137,8978,1615,75
81881098,81879818,81889112,9294,1616,75
81894072,81892793,81901453,8660,1617,75
81906323,81905260,81914990,9730,1618,75
81919854,81918791,81928522,9731,1619,75
81933389,81932326,81941086,8760,1620,75
81945931,81944869,81954282,9413,1621,75
81959241,81957962,81965671,7709,1622,75
81970414,81969351,81978717,9366,1623,75
81983541,81982478,81990288,7810,1624,75
81995249,81993969,82002629,8660,1625,75
82007445,82006382,82014193,7811,1626,75
82019153,82017873,82026217,8344,1627,75
82031177,82029897,82038874,8977,1628,75
82043707,82042644,82051720,9076,1629,75
82056568,82055505,82062999,7494,1630,75
82067743,82066680,82075729,9049,1631,75
82080555,82079492,82087936,8444,1632,75
82092896,82091616,82099326,7710,1633,75
82104118,82103055,82112786,9731,1634,75
82117746,82116466,82126414,9948,1635,75
82131263,82130200,82139277,9077,1636,75
82144236,82142957,82150983,8026,1637,75
82155823,82154760,82162886,8126,1638,75
82167685,82166622,82176353,9731,1639,75
82181096,82180033,82189400,9367,1640,75
82194207,82193144,82202875,9731,1641,75
82207835,82206556,82215531,8975,1642,75
82220373,82219310,82228725,9415,1643,75
82233560,82232498,82241912,9414,1644,75
82246873,82245593,82255224,9631,1645,75
82260185,82258905,82267566,8661,1646,75
82272396,82271333,82280093,8760,1647,75
82284957,82283893,82293309,9416,1648,75
82298147,82297084,82306815,9731,1649,75
82311684,82310621,82319380,8759,1650,75
82324341,82323061,82331089,8028,1651,75
82335893,82334830,82342957,8127,1652,75
82347916,82346637,82354347,7710,1653,75
82359211,82358149,82367563,9414,1654,75
82372355,82371292,82379102,7810,1655,75
82383901,82382838,82390332,7494,1656,75
82395202,82394139,82402265,8126,1657,75
82407225,82405945,82414606,8661,1658,75
82419404,82418341,82426784,8443,1659,75
82431645,82430583,82439997,9414,1660,75
82444958,82443678,82451706,8028,1661,75
82456571,82455508,82464923,9415,1662,75
82469883,82468604,82478551,9947,1663,75
82483348,82482285,82490729,8444,1664,75
82495689,82494410,82503070,8660,1665,75
82507914,82506851,82514662,7811,1666,75
82519621,82518342,82527317,8975,1667,75
82532277,82530998,82540628,9630,1668,75
82545451,82544388,82553149,8761,1669,75
82558004,82556942,82564435,7493,1670,75
82569396,82568116,82578064,9948,1671,75
82583024,82581744,82589771,8027,1672,75
82594732,82593452,82601163,7711,1673,75
82605994,82604932,82613058,8126,1674,75
82618018,82616738,82626032,9294,1675,75
82630898,82629835,82638596,8761,1676,75
82643441,82642378,82651792,9414,1677,75
82656752,82655473,82663183,7710,1678,75
82668029,82666966,82676381,9415,1679,75
82681183,82680120,82689197,9077,1680,75
82694157,82692878,82702508,9630,1681,75
82707370,82706307,82714751,8444,1682,75
82719495,82718432,82727482,9050,1683,75
82732443,82731163,82740457,9294,1684,75
82745247,82744185,82753599,9414,1685,75
82758419,82757357,82765798,8441,1686,75
82770639,82769577,82778337,8760,1687,75
82783157,82782094,82790854,8760,1688,75
82795652,82794590,82802399,7809,1689,75
82807143,82806080,82813864,7784,1690,75
82818825,82817545,82825256,7711,1691,75
82830216,82828937,82837280,8343,1692,75
82842240,82840961,82849937,8976,1693,75
82854898,82853618,82861329,7711,1694,75
82866290,82865010,82874304,9294,1695,75
82879048,82877985,82886012,8027,1696,75
82890839,82889776,82897587,7811,1697,75
82902449,82901386,82908880,7494,1698,75
82913718,82912655,82920782,8127,1699,75
82925579,82924516,82932643,8127,1700,75
82937387,82936324,82944668,8344,1701,75
82949517,82948454,82956265,7811,1702,75
82961225,82959945,82969892,9947,1703,75
82974690,82973627,82981121,7494,1704,75
82986080,82984801,82993778,8977,1705,75
82998521,82997458,83006825,9367,1706,75
83011786,83010506,83018217,7711,1707,75
83022961,83021898,83030632,8734,1708,75
83035592,83034313,83043288,8975,1709,75
83048098,83047035,83056449,9414,1710,75
83061409,83060130,83069422,9292,1711,75
83074382,83073103,83081763,8660,1712,75
83086723,83085444,83094421,8977,1713,75
83099164,83098102,83106834,8732,1714,75
83111687,83110624,83120038,9414,1715,75
83124881,83123819,83132579,8760,1716,75
83137540,83136260,83144605,8345,1717,75
83149566,83148286,83155996,7710,1718,75
83160796,83159733,83168177,8444,1719,75
83173138,83171858,83181490,9632,1720,75
83186289,83185226,83193670,8444,1721,75
83198630,83197351,83206981,9630,1722,75
83211941,83210662,83220609,9947,1723,75
83225428,83224365,83232493,8128,1724,75
83237453,83236173,83245150,8977,1725,75
83250109,83248830,83258776,9946,1726,75
83263737,83262457,83270802,8345,1727,75
83275653,83274591,83282716,8125,1728,75
83287676,83286397,83295373,8976,1729,75
83300163,83299100,83308515,9415,1730,75
83313475,83312196,83321827,9631,1731,75
83326571,83325508,83335455,9947,1732,75
83340290,83339227,83347671,8444,1733,75
83352474,83351411,83359222,7811,1734,75
83364080,83363017,83371460,8443,1735,75
83376420,83375140,83383484,8344,1736,75
83388281,83387218,83396295,9077,1737,75
83401254,83399975,83409606,9631,1738,75
83414402,83413339,83422754,9415,1739,75
83427715,83426435,83434146,7711,1740,75
83438969,83437906,83447637,9731,1741,75
83452500,83451437,83459564,8127,1742,75
83464371,83463308,83470802,7494,1743,75
83475546,83474483,83484187,9704,1744,75
83489148,83487868,83496529,8661,1745,75
83501489,83500210,83509503,9293,1746,75
83514463,83513184,83522814,9630,1747,75
83527676,83526613,83535690,9077,1748,75
83540525,83539462,83548539,9077,1749,75
83553498,83552219,83560879,8660,1750,75
83565691,83564629,83573726,9097,1751,75
83578563,83577500,83585943,8443,1752,75
83590783,83589720,83598164,8444,1753,75
83603124,83601845,83611476,9631,1754,75
83616437,83615157,83623185,8028,1755,75
83627928,83626865,83634332,7467,1756,75
83639076,83638013,83646744,8731,1757,75
83651488,83650425,83658208,7783,1758,75
83663168,83661889,83670865,8976,1759,75
83675609,83674546,83684249,9703,1760,75
83689054,83687991,83697405,9414,1761,75
83702230,83701167,83708660,7493,1762,75
83713621,83712341,83721973,9632,1763,75
83726934,83725654,83733365,7711,1764,75
83738176,83737113,83746528,9415,1765,75
83751390,83750327,83758137,7810,1766,75
83762963,83761900,83771631,9731,1767,75
83776452,83775389,83783515,8126,1768,75
83788346,83787283,83795727,8444,1769,75
83800687,83799408,83808383,8975,1770,75
83813343,83812063,83822011,9948,1771,75
83826971,83825692,83834352,8660,1772,75
83839312,83838033,83847326,9293,1773,75
83852148,83851085,83860500,9415,1774,75
83865352,83864289,83874020,9731,1775,75
83878842,83877778,83887193,9415,1776,75
83892039,83890976,83900074,9098,1777,75
83904818,83903755,83914113,10358,1778,75
83918944,83917882,83927828,9946,1779,75
83932624,83931561,83939055,7494,1780,75
83944016,83942736,83950762,8026,1781,75
83955506,83954443,83963420,8977,1782,75
83968218,83967155,83975282,8127,1783,75
83980025,83978962,83987716,8754,1784,75
83992676,83991396,84001027,9631,1785,75
84005861,84004799,84013557,8758,1786,75
84018390,84017326,84027058,9732,1787,75
84032019,84030739,84038450,7711,1788,75
84043193,84042130,84051107,8977,1789,75
84056067,84054788,84064081,9293,1790,75
84068886,84067823,84075634,7811,1791,75
84080594,84079314,84087658,8344,1792,75
84092457,84091394,84101125,9731,1793,75
84105940,84104877,84112688,7811,1794,75
84117531,84116468,84124911,8443,1795,75
84129748,84128685,84136179,7494,1796,75
84140922,84139860,84150196,10336,1797,75
84155028,84153965,84163901,9936,1798,75
84168707,84167644,84175138,7494,1799,75
84179984,84178921,84188652,9731,1800,75
84193526,84192463,84202194,9731,1801,75
84207155,84205875,84215823,9948,1802,75
84220672,84219609,84227420,7811,1803,75
84232245,84231183,84240597,9414,1804,75
84245412,84244349,84252158,7809,1805,75
84257002,84255939,84263433,7494,1806,75
84268272,84267210,84274703,7493,1807,75
84279494,84278432,84287845,9413,1808,75
84292806,84291526,84301157,9631,1809,75
84306117,84304838,84314785,9947,1810,75
84319746,84318465,84326493,8028,1811,75
84331453,84330173,84339466,9293,1812,75
84344301,84343238,84352969,9731,1813,75
84357930,84356650,84366282,9632,1814,75
84371071,84370008,84377818,7810,1815,75
84382779,84381499,84390793,9294,1816,75
84395645,84394582,84403997,9415,1817,75
84408956,84407677,84415703,8026,1818,75
84420568,84419506,84426999,7493,1819,75
84431743,84430680,84440700,10020,1820,75
84445628,84444565,84453009,8444,1821,75
84457847,84456784,84465543,8759,1822,75
84470287,84469224,84478274,9050,1823,75
84483234,84481955,84490615,8660,1824,75
84495475,84494412,84502223,7811,1825,75
84507082,84506019,84515096,9077,1826,75
84519900,84518837,84527914,9077,1827,75
84532780,84531717,84539527,7810,1828,75
84544376,84543314,84551757,8443,1829,75
84556597,84555534,84564947,9413,1830,75
84569907,84568628,84577921,9293,1831,75
84582882,84581602,84589946,8344,1832,75
84594907,84593627,84603574,9947,1833,75
84608534,84607254,84615597,8343,1834,75
84620442,84619379,84628456,9077,1835,75
84633416,84632136,84642084,9948,1836,75
84647045,84645765,84655713,9948,1837,75
84660556,84659492,84668908,9416,1838,75
84673748,84672685,84680812,8127,1839,75
84685671,84684609,84693051,8442,1840,75
84697910,84696846,84706578,9732,1841,75
84711404,84710341,84718785,8444,1842,75
84723530,84722466,84731516,9050,1843,75
84736260,84735197,84746166,10969,1844,75
84750998,84749935,84759883,9948,1845,75
84764844,84763564,84771275,7711,1846,75
84776135,84775072,84782566,7494,1847,75
84787527,84786247,84794906,8659,1848,75
84799650,84798587,84807656,9069,1849,75
84812617,84811337,84819998,8661,1850,75
84824858,84823795,84833210,9415,1851,75
84838171,84836891,84845235,8344,1852,75
84849978,84848915,84857670,8755,1853,75
84862629,84861350,84870981,9631,1854,75
84875942,84874662,84882689,8027,1855,75
84887483,84886420,84896150,9730,1856,75
84900976,84899913,84908040,8127,1857,75
84912884,84911821,84921235,9414,1858,75
84926196,84924916,84934231,9315,1859,75
84939030,84937967,84946411,8444,1860,75
84951212,84950149,84958909,8760,1861,75
84963704,84962641,84972371,9730,1862,75
84977234,84976172,84983664,7492,1863,75
84988505,84987442,84995886,8444,1864,75
85000719,84999656,85008416,8760,1865,75
85013284,85012221,85020981,8760,1866,75
85025942,85024662,85033322,8660,1867,75
85038183,85037120,85044930,7810,1868,75
85049890,85048610,85056320,7710,1869,75
85061281,85060001,85069949,9948,1870,75
85074909,85073630,85081974,8344,1871,75
85086846,85085783,85093277,7494,1872,75
85098238,85096958,85105936,8978,1873,75
85110680,85109617,85119565,9948,1874,75
85124406,85123343,85133074,9731,1875,75
85137876,85136813,85145256,8443,1876,75
85150216,85148937,85158229,9292,1877,75
85163190,85161910,85171541,9631,1878,75
85176501,85175222,85184852,9630,1879,75
85189648,85188586,85196078,7492,1880,75
85200822,85199759,85210118,10359,1881,75
85215166,85213887,85223180,9293,1882,75
85228140,85226861,85235838,8977,1883,75
85240634,85239571,85248331,8760,1884,75
85253291,85252011,85260039,8028,1885,75
85264855,85263793,85272552,8759,1886,75
85277425,85276362,85284806,8444,1887,75
85289632,85288569,85297646,9077,1888,75
85302390,85301327,85310959,9632,1889,75
85315814,85314751,85324166,9415,1890,75
85328910,85327847,85338185,10338,1891,75
85343125,85342062,85351139,9077,1892,75
85356099,85354819,85364113,9294,1893,75
85369073,85367793,85376453,8660,1894,75
85381197,85380134,85388793,8659,1895,75
85393753,85392473,85401449,8976,1896,75
85406193,85405130,85414424,9294,1897,75
85419245,85418181,85427913,9732,1898,75
85432873,85431594,85440254,8660,1899,75
85445214,85443934,85453882,9948,1900,75
85458671,85457608,85466684,9076,1901,75
85471644,85470365,85479025,8660,1902,75
85483986,85482706,85490733,8027,1903,75
85495476,85494413,85504433,10020,1904,75
85509482,85508202,85517179,8977,1905,75
85522017,85520954,85530031,9077,1906,75
85534870,85533807,85541300,7493,1907,75
85546260,85544981,85554612,9631,1908,75
85559356,85558293,85568241,9948,1909,75
85573201,85571922,85579631,7709,1910,75
85584592,85583312,85591340,8028,1911,75
85596144,85595081,85604496,9415,1912,75
85609239,85608177,85617470,9293,1913,75
85622305,85621242,85629370,8128,1914,75
85634177,85633114,85641241,8127,1915,75
85646071,85645008,85653452,8444,1916,75
85658252,85657190,85665316,8126,1917,75
85670140,85669077,85677204,8127,1918,75
85681948,85680885,85690588,9703,1919,75
85695331,85694268,85701978,7710,1920,75
85706939,85705659,85715290,9631,1921,75
85720127,85719063,85726874,7811,1922,75
85731729,85730666,85739427,8761,1923,75
85744171,85743108,85753056,9948,1924,75
85757800,85756737,85766031,9294,1925,75
85770991,85769712,85779025,9313,1926,75
85783858,85782795,85791238,8443,1927,75
85796077,85795014,85802508,7494,1928,75
85807300,85806237,85814048,7811,1929,75
85818897,85817834,85827248,9414,1930,75
85832208,85830928,85839589,8661,1931,75
85844412,85843350,85850843,7493,1932,75
85855586,85854524,85864880,10356,1933,75
85869928,85868649,85877626,8977,1934,75
85882435,85881372,85890787,9415,1935,75
85895609,85894547,85902672,8125,1936,75
85907526,85906462,85913957,7495,1937,75
85918917,85917638,85926952,9314,1938,75
85931913,85930633,85938978,8345,1939,75
85943768,85942705,85951466,8761,1940,75
85956302,85955240,85964337,9097,1941,75
85969193,85968129,85975940,7811,1942,75
85980900,85979621,85987647,8026,1943,75
85992502,85991439,85998933,7494,1944,75
86003784,86002721,86011165,8444,1945,75
86015990,86014927,86024005,9078,1946,75
86028857,86027794,86035605,7811,1947,75
86040565,86039285,86049232,9947,1948,75
86054192,86052912,86061890,8978,1949,75
86066737,86065673,86074118,8445,1950,75
86078986,86077924,86085416,7492,1951,75
86090375,86089096,86097123,8027,1952,75
86101955,86100892,86109335,8443,1953,75
86114137,86113074,86122489,9415,1954,75
86127449,86126170,86135463,9293,1955,75
86140206,86139144,86149090,9946,1956,75
86153833,86152771,86161209,8438,1957,75
86166169,86164890,86174204,9314,1958,75
86179061,86177998,86186441,8443,1959,75
86191400,86190121,86198781,8660,1960,75
86203742,86202462,86211777,9315,1961,75
86216604,86215541,86223669,8128,1962,75
86228529,86227466,86235593,8127,1963,75
86240397,86239335,86246828,7493,1964,75
86251652,86250588,86258400,7812,1965,75
86263227,86262165,86269975,7810,1966,75
86274935,86273656,86283603,9947,1967,75
86288462,86287399,86296813,9414,1968,75
86301648,86300585,86309682,9097,1969,75
86314643,86313363,86321707,8344,1970,75
86326544,86325481,86334241,8760,1971,75
86339202,86337922,86345633,7711,1972,75
86350592,86349313,86357973,8660,1973,75
86362717,86361654,86371695,10041,1974,75
86376745,86375465,86384780,9315,1975,75
86389588,86388525,86396653,8128,1976,75
86401472,86400409,86410140,9731,1977,75
86414981,86413918,86422362,8444,1978,75
86427207,86426144,86433637,7493,1979,75
86438597,86437318,86445978,8660,1980,75
86450939,86449659,86459606,9947,1981,75
86464567,86463287,86472265,8978,1982,75
86477122,86476059,86483870,7811,1983,75
86488830,86487551,86497498,9947,1984,75
86502323,86501260,86510674,9414,1985,75
86515635,86514355,86524302,9947,1986,75
86529263,86527983,86536960,8977,1987,75
86541763,86540701,86550113,9412,1988,75
86554857,86553794,86562231,8437,1989,75
86567103,86566040,86573534,7494,1990,75
86578495,86577215,86586509,9294,1991,75
86591468,86590189,86600135,9946,1992,75
86604879,86603816,86613857,10041,1993,75
86618744,86617681,86626758,9077,1994,75
86631582,86630520,86638646,8126,1995,75
86643607,86642327,86650988,8661,1996,75
86655846,86654783,86662910,8127,1997,75
86667764,86666701,86674828,8127,1998,75
86679692,86678629,86687390,8761,1999,75
86692350,86691071,86699731,8660,2000,75
86704692,86703412,86712390,8978,2001,75
86717226,86716164,86723974,7810,2002,75
86728807,86727744,86736188,8444,2003,75
86741149,86739869,86748529,8660,2004,75
86753335,86752272,86762003,9731,2005,75
86766963,86765684,86774977,9293,2006,75
86779803,86778740,86787817,9077,2007,75
86792663,86791600,86799728,8128,2008,75
86804524,86803461,86812876,9415,2009,75
86817709,86816646,86825722,9076,2010,75
86830683,86829403,86837748,8345,2011,75
86842605,86841542,86849352,7810,2012,75
86854178,86853115,86862191,9076,2013,75
86867152,86865872,86875503,9631,2014,75
86880247,86879184,86887600,8416,2015,75
86892434,86891371,86899497,8126,2016,75
86904362,86903299,86913030,9731,2017,75
86917864,86916801,86925899,9098,2018,75
86930643,86929580,86939917,10337,2019,75
86944825,86943762,86953493,9731,2020,75
86958305,86957243,86965052,7809,2021,75
86969853,86968790,86976283,7493,2022,75
86981244,86979964,86989596,9632,2023,75
86994465,86993402,87002817,9415,2024,75
87007778,87006498,87015475,8977,2025,75
87020348,87019285,87027096,7811,2026,75
87031956,87030893,87039653,8760,2027,75
87044482,87043419,87052834,9415,2028,75
87057578,87056515,87066220,9705,2029,75
87071066,87070003,87078130,8127,2030,75
87082981,87081918,87090045,8127,2031,75
87094854,87093792,87102552,8760,2032,75
87107512,87106233,87114259,8026,2033,75
87119114,87118050,87127128,9078,2034,75
87132089,87130809,87138519,7710,2035,75
87143480,87142200,87150228,8028,2036,75
87155189,87153909,87161621,7712,2037,75
87166470,87165407,87175138,9731,2038,75
87179976,87178913,87188644,9731,2039,75
87193604,87192325,87201955,9630,2040,75
87206916,87205636,87213346,7710,2041,75
87218306,87217027,87226341,9314,2042,75
87231140,87230077,87239492,9415,2043,75
87244321,87243258,87251386,8128,2044,75
87256129,87255067,87266373,11306,2045,75
87271421,87270142,87277852,7710,2046,75
87282649,87281586,87289080,7494,2047,75
87293929,87292867,87300360,7493,2048,75
87305199,87304136,87312895,8759,2049,75
87317712,87316650,87325093,8443,2050,75
87330054,87328774,87337433,8659,2051,75
87342232,87341169,87349613,8444,2052,75
87354357,87353294,87363631,10337,2053,75
87368680,87367400,87377031,9631,2054,75
87381992,87380712,87389056,8344,2055,75
87393904,87392841,87400335,7494,2056,75
87405079,87404016,87413700,9684,2057,75
87418514,87417451,87424945,7494,2058,75
87429757,87428694,87436505,7811,2059,75
87441345,87440282,87448092,7810,2060,75
87452912,87451850,87459976,8126,2061,75
87464937,87463657,87472635,8978,2062,75
87477378,87476316,87485703,9387,2063,75
87490528,87489465,87498880,9415,2064,75
87503841,87502561,87510272,7711,2065,75
87515107,87514044,87522805,8761,2066,75
87527765,87526486,87534513,8027,2067,75
87539341,87538278,87546721,8443,2068,75
87551524,87550461,87558272,7811,2069,75
87563109,87562046,87570174,8128,2070,75
87574980,87573917,87583330,9413,2071,75
87588156,87587093,87595220,8127,2072,75
87600181,87598901,87606929,8028,2073,75
87611726,87610663,87620078,9415,2074,75
87624900,87623838,87633250,9412,2075,75
87638211,87636931,87645908,8977,2076,75
87650781,87649718,87659133,9415,2077,75
87663921,87662858,87672273,9415,2078,75
87677234,87675954,87684298,8344,2079,75
87689105,87688042,87697118,9076,2080,75
87701862,87700799,87710165,9366,2081,75
87714909,87713846,87722507,8661,2082,75
87727467,87726188,87735819,9631,2083,75
87740780,87739500,87747845,8345,2084,75
87752674,87751611,87760370,8759,2085,75
87765198,87764135,87773548,9413,2086,75
87778395,87777332,87785776,8444,2087,75
87790520,87789457,87798845,9388,2088,75
87803806,87802526,87810237,7711,2089,75
87815197,87813918,87823549,9631,2090,75
87828391,87827328,87834821,7493,2091,75
87839612,87838550,87846360,7810,2092,75
87851156,87850093,87858854,8761,2093,75
87863815,87862535,87871829,9294,2094,75
87876790,87875510,87884804,9294,2095,75
87889764,87888485,87898116,9631,2096,75
87903077,87901797,87910457,8660,2097,75
87915418,87914138,87923116,8978,2098,75
87927908,87926845,87935921,9076,2099,75
87940790,87939727,87947537,7810,2100,75
87952362,87951299,87960376,9077,2101,75
87965121,87964058,87973761,9703,2102,75
87978505,87977442,87984908,7466,2103,75
87989741,87988678,87996805,8127,2104,75
88001651,88000587,88009032,8445,2105,75
88013992,88012713,88021690,8977,2106,75
88026560,88025498,88035228,9730,2107,75
88040086,88039023,88046834,7811,2108,75
88051795,88050515,88059493,8978,2109,75
88064337,88063274,88071401,8127,2110,75
88076227,88075164,88083925,8761,2111,75
88088886,88087606,88095633,8027,2112,75
88100445,88099382,88107509,8127,2113,75
88112253,88111190,88120578,9388,2114,75
88125539,88124259,88133891,9632,2115,75
88138730,88137667,88145478,7811,2116,75
88150306,88149243,88158975,9732,2117,75
88163839,88162776,88170269,7493,2118,75
88175230,88173950,88183243,9293,2119,75
88188204,88186924,88194635,7711,2120,75
88199469,88198406,88208137,9731,2121,75
88212936,88211873,88220633,8760,2122,75
88225594,88224314,88233291,8977,2123,75
88238118,88237055,88244549,7494,2124,75
88249293,88248230,88257524,9294,2125,75
88262366,88261304,88270718,9414,2126,75
88275569,88274506,88283267,8761,2127,75
88288228,88286948,88294659,7711,2128,75
88299619,88298340,88306049,7709,2129,75
88311009,88309730,88319361,9631,2130,75
88324104,88323042,88333717,10675,2131,75
88338594,88337531,88345974,8443,2132,75
88350846,88349783,88358543,8760,2133,75
88363286,88362224,88372244,10020,2134,75
88377293,88376014,88385645,9631,2135,75
88390452,88389389,88396883,7494,2136,75
88401627,88400564,88408275,7711,2137,75
88413135,88412072,88419565,7493,2138,75
88424405,88423343,88432440,9097,2139,75
88437400,88436121,88445098,8977,2140,75
88449938,88448874,88456368,7494,2141,75
88461111,88460049,88468074,8025,2142,75
88473035,88471755,88481386,9631,2143,75
88486130,88485067,88495014,9947,2144,75
88499808,88498745,88508158,9413,2145,75
88513033,88511970,88520731,8761,2146,75
88525691,88524412,88534359,9947,2147,75
88539320,88538040,88546067,8027,2148,75
88551028,88549748,88557459,7711,2149,75
88562203,88561140,88570210,9070,2150,75
88575170,88573891,88583837,9946,2151,75
88588798,88587518,88596178,8660,2152,75
88601139,88599859,88609807,9948,2153,75
88614626,88613564,88622977,9413,2154,75
88627793,88626729,88634224,7495,2155,75
88639018,88637955,88646715,8760,2156,75
88651573,88650510,88659925,9415,2157,75
88664765,88663703,88672463,8760,2158,75
88677207,88676144,88686503,10359,2159,75
88691432,88690369,88699784,9415,2160,75
88704745,88703465,88712443,8978,2161,75
88717247,88716185,88723677,7492,2162,75
88728502,88727439,88736200,8761,2163,75
88741161,88739881,88747908,8027,2164,75
88752733,88751670,88761401,9731,2165,75
88766232,88765169,88774246,9077,2166,75
88779094,88778031,88786792,8761,2167,75
88791617,88790554,88800286,9732,2168,75
88805124,88804061,88811872,7811,2169,75
88816709,88815646,88825377,9731,2170,75
88830249,88829186,88838262,9076,2171,75
88843223,88841943,88851574,9631,2172,75
88856420,88855357,88864118,8761,2173,75
88869079,88867799,88877747,9948,2174,75
88882612,88881548,88891281,9733,2175,75
88896134,88895072,88904486,9414,2176,75
88909446,88908167,88916510,8343,2177,75
88921334,88920272,88928398,8126,2178,75
88933358,88932079,88942026,9947,2179,75
88946892,88945828,88960140,14312,2180,75
88965087,88964023,88973756,9733,2181,75
88978717,88977437,88987386,9949,2182,75
88992130,88991067,89000044,8977,2183,75
89004911,89003848,89011659,7811,2184,75
89016473,89015410,89022904,7494,2185,75
89027701,89026638,89034132,7494,2186,75
89039092,89037813,89045522,7709,2187,75
89050320,89049257,89058355,9098,2188,75
89063100,89062037,89070138,8101,2189,75
89074882,89073819,89081919,8100,2190,75
89086664,89085601,89094356,8755,2191,75
89099317,89098037,89106382,8345,2192,75
89111234,89110172,89119902,9730,2193,75
89124733,89123671,89131798,8127,2194,75
89136542,89135479,89144866,9387,2195,75
89149610,89148547,89156258,7711,2196,75
89161130,89160067,89167878,7811,2197,75
89172622,89171559,89181580,10021,2198,75
89186629,89185350,89194010,8660,2199,75
89198843,89197780,89207195,9415,2200,75
89211939,89210876,89218586,7710,2201,75
89223547,89222267,89231245,8978,2202,75
89236069,89235006,89243450,8444,2203,75
89248298,89247235,89256966,9731,2204,75
89261830,89260767,89268893,8126,2205,75
89273854,89272574,89281868,9294,2206,75
89286719,89285656,89293150,7494,2207,75
89298110,89296831,89305490,8659,2208,75
89310282,89309219,89317979,8760,2209,75
89322724,89321660,89329688,8028,2210,75
89334489,89333426,89343157,9731,2211,75
89348118,89346838,89356786,9948,2212,75
89361626,89360563,89368374,7811,2213,75
89373118,89372055,89380082,8027,2214,75
89385042,89383763,89392423,8660,2215,75
89397221,89396157,89404602,8445,2216,75
89409562,89408283,89416310,8027,2217,75
89421147,89420084,89428527,8443,2218,75
89433322,89432259,89441336,9077,2219,75
89446132,89445069,89454484,9415,2220,75
89459444,89458165,89466508,8343,2221,75
89471339,89470277,89478404,8127,2222,75
89483250,89482187,89491602,9415,2223,75
89496446,89495383,89503826,8443,2224,75
89508787,89507508,89515851,8343,2225,75
89520701,89519638,89528082,8444,2226,75
89532883,89531821,89541235,9414,2227,75
89546094,89545032,89553158,8126,2228,75
89557902,89556839,89565910,9071,2229,75
89570654,89569591,89579591,10000,2230,75
89584640,89583361,89593307,9946,2231,75
89598141,89597078,89605522,8444,2232,75
89610483,89609203,89618181,8978,2233,75
89623006,89621943,89630387,8444,2234,75
89635203,89634141,89641633,7492,2235,75
89646594,89645314,89655261,9947,2236,75
89660103,89659040,89668455,9415,2237,75
89673291,89672228,89680037,7809,2238,75
89684894,89683831,89693246,9415,2239,75
89698089,89697026,89704520,7494,2240,75
89709326,89708263,89717676,9413,2241,75
89722420,89721357,89730334,8977,2242,75
89735295,89734015,89742676,8661,2243,75
89747519,89746456,89755216,8760,2244,75
89760040,89758978,89766471,7493,2245,75
89771432,89770152,89779782,9630,2246,75
89784743,89783463,89791807,8344,2247,75
89796672,89795609,89804685,9076,2248,75
89809484,89808421,89818152,9731,2249,75
89822961,89821898,89830026,8128,2250,75
89834880,89833817,89842261,8444,2251,75
89847004,89845942,89855962,10020,2252,75
89861012,89859732,89869026,9294,2253,75
89873851,89872788,89881231,8443,2254,75
89886081,89885018,89892829,7811,2255,75
89897573,89896510,89905582,9072,2256,75
89910385,89909322,89917766,8444,2257,75
89922623,89921560,89930003,8443,2258,75
89934964,89933684,89943316,9632,2259,75
89948276,89946997,89955340,8343,2260,75
89960301,89959021,89967364,8343,2261,75
89972228,89971165,89979926,8761,2262,75
89984887,89983607,89992585,8978,2263,75
89997451,89996388,90005464,9076,2264,75
90010339,90009276,90017403,8127,2265,75
90022233,90021170,90030584,9414,2266,75
90035423,90034360,90042170,7810,2267,75
90047039,90045976,90054737,8761,2268,75
90059698,90058418,90068050,9632,2269,75
90072896,90071833,90080277,8444,2270,75
90085237,90083958,90092302,8344,2271,75
90097262,90095983,90103693,7710,2272,75
90108438,90107375,90116763,9388,2273,75
90121724,90120444,90128471,8027,2274,75
90133431,90132152,90142099,9947,2275,75
90147059,90145780,90155726,9946,2276,75
90160470,90159407,90167508,8101,2277,75
90172356,90171293,90180708,9415,2278,75
90185579,90184517,90192644,8127,2279,75
90197604,90196325,90205955,9630,2280,75
90210804,90209741,90218185,8444,2281,75
90223145,90221866,90230526,8660,2282,75
90235486,90234207,90241917,7710,2283,75
90246779,90245716,90254476,8760,2284,75
90259436,90258157,90266499,8342,2285,75
90271328,90270265,90277759,7494,2286,75
90282503,90281440,90289857,8417,2287,75
90294818,90293538,90303169,9631,2288,75
90308129,90306850,90314560,7710,2289,75
90319418,90318355,90328086,9731,2290,75
90332830,90331767,90340183,8416,2291,75
90345144,90343864,90351575,7711,2292,75
90356535,90355256,90363600,8344,2293,75
90368560,90367281,90376257,8976,2294,75
90381218,90379938,90389886,9948,2295,75
90394681,90393618,90402695,9077,2296,75
90407566,90406504,90415916,9412,2297,75
90420756,90419693,90428137,8444,2298,75
90433098,90431818,90441112,9294,2299,75
90445856,90444793,90454476,9683,2300,75
90459330,90458267,90467681,9414,2301,75
90472526,90471462,90479907,8445,2302,75
90484651,90483588,90491686,8098,2303,75
90496646,90495367,90503710,8343,2304,75
90508670,90507391,90515418,8027,2305,75
90520227,90519164,90528895,9731,2306,75
90533856,90532576,90541553,8977,2307,75
90546371,90545308,90553119,7811,2308,75
90558080,90556800,90564511,7711,2309,75
90569472,90568192,90576853,8661,2310,75
90581814,90580534,90589195,8661,2311,75
90594155,90592876,90602507,9631,2312,75
90607468,90606188,90615165,8977,2313,75
90619909,90618846,90626630,7784,2314,75
90631472,90630409,90639824,9415,2315,75
90644785,90643505,90651216,7711,2316,75
90656176,90654897,90663556,8659,2317,75
90668516,90667237,90674947,7710,2318,75
90679907,90678628,90687605,8977,2319,75
90692400,90691337,90699781,8444,2320,75
90704597,90703535,90712293,8758,2321,75
90717038,90715975,90725605,9630,2322,75
90730567,90729287,90739235,9948,2323,75
90744066,90743003,90751447,8444,2324,75
90756407,90755128,90764758,9630,2325,75
90769608,90768545,90776671,8126,2326,75
90781518,90780455,90789215,8760,2327,75
90794176,90792896,90801872,8976,2328,75
90806699,90805636,90813447,7811,2329,75
90818270,90817207,90826622,9415,2330,75
90831472,90830409,90839824,9415,2331,75
90844674,90843611,90852688,9077,2332,75
90857532,90856469,90863963,7494,2333,75
90868769,90867706,90875200,7494,2334,75
90880161,90878881,90887858,8977,2335,75
90892725,90891662,90901392,9730,2336,75
90906352,90905073,90914703,9630,2337,75
90919503,90918440,90926883,8443,2338,75
90931730,90930667,90939765,9098,2339,75
90944636,90943574,90952017,8443,2340,75
90956978,90955698,90965646,9948,2341,75
90970517,90969454,90978552,9098,2342,75
90983401,90982338,90990148,7810,2343,75
90995110,90993830,91003462,9632,2344,75
91008263,91007200,91014693,7493,2345,75
91019544,91018481,91028212,9731,2346,75
91033173,91031893,91041208,9315,2347,75
91046065,91045003,91053762,8759,2348,75
91058723,91057443,91065471,8028,2349,75
91070432,91069152,91076863,7711,2350,75
91081724,91080661,91088472,7811,2351,75
91093433,91092153,91102100,9947,2352,75
91106899,91105836,91114934,9098,2353,75
91119894,91118615,91127929,9314,2354,75
91132890,91131610,91139637,8027,2355,75
91144484,91143422,91151547,8125,2356,75
91156410,91155347,91163791,8444,2357,75
91168614,91167552,91177282,9730,2358,75
91182026,91180963,91190985,10022,2359,75
91195867,91194805,91204535,9730,2360,75
91209387,91208325,91217083,8758,2361,75
91222044,91220764,91229425,8661,2362,75
91234293,91233230,91241674,8444,2363,75
91246634,91245355,91254015,8660,2364,75
91258884,91257821,91265315,7494,2365,75
91270275,91268996,91277972,8976,2366,75
91282716,91281653,91289754,8101,2367,75
91294543,91293480,91302557,9077,2368,75
91307355,91306292,91313786,7494,2369,75
91318639,91317576,91325071,7495,2370,75
91330031,91328752,91336463,7711,2371,75
91341295,91340232,91348042,7810,2372,75
91352881,91351818,91360578,8760,2373,75
91365538,91364259,91373235,8976,2374,75
91378082,91377020,91386096,9076,2375,75
91390893,91389831,91399245,9414,2376,75
91404068,91403005,91412419,9414,2377,75
91417246,91416183,91425260,9077,2378,75
91430066,91429003,91437446,8443,2379,75
91442246,91441183,91448994,7811,2380,75
91453955,91452675,91462306,9631,2381,75
91467171,91466108,91475839,9731,2382,75
91480583,91479520,91487936,8416,2383,75
91492762,91491699,91499193,7494,2384,75
91504155,91502875,91512507,9632,2385,75
91517468,91516188,91524849,8661,2386,75
91529810,91528530,91537190,8660,2387,75
91541934,91540871,91549848,8977,2388,75
91554674,91553611,91562370,8759,2389,75
91567114,91566051,91575682,9631,2390,75
91580514,91579451,91587578,8127,2391,75
91592539,91591259,91600891,9632,2392,75
91605635,91604572,91615078,10506,2393,75
91620005,91618942,91636271,17329,2394,75
91641233,91640170,91647665,7495,2395,75
91652409,91651347,91660978,9631,2396,75
91665823,91664761,91673837,9076,2397,75
91678798,91677518,91685229,7711,2398,75
91690044,91688981,91697108,8127,2399,75
91702069,91700790,91710083,9293,2400,75
91714828,91713765,91723786,10021,2401,75
91728715,91727652,91736096,8444,2402,75
91740841,91739778,91750432,10654,2403,75
91755482,91754202,91762230,8028,2404,75
91767066,91766003,91774764,8761,2405,75
91779725,91778445,91788393,9948,2406,75
91793137,91792074,91799858,7784,2407,75
91804819,91803539,91812517,8978,2408,75
91817261,91816198,91824226,8028,2409,75
91829089,91828026,91837440,9414,2410,75
91842242,91841179,91848673,7494,2411,75
91853633,91852354,91860697,8343,2412,75
91865657,91864378,91873671,9293,2413,75
91878631,91877352,91885062,7710,2414,75
91889862,91888799,91897242,8443,2415,75
91902203,91900923,91910555,9632,2416,75
91915298,91914236,91922653,8417,2417,75
91927458,91926395,91934204,7809,2418,75
91939164,91937885,91947516,9631,2419,75
91952341,91951278,91959721,8443,2420,75
91964561,91963498,91971942,8444,2421,75
91976741,91975678,91984122,8444,2422,75
91988962,91987899,91996659,8760,2423,75
92001483,92000421,92009834,9413,2424,75
92014578,92013515,92023536,10021,2425,75
92028446,92027384,92037114,9730,2426,75
92041918,92040854,92048983,8129,2427,75
92053835,92052772,92062186,9414,2428,75
92067146,92065867,92074843,8976,2429,75
92079686,92078623,92088038,9415,2430,75
92092999,92091720,92101013,9293,2431,75
92105826,92104763,92114178,9415,2432,75
92118922,92117859,92127880,10021,2433,75
92132930,92131650,92140943,9293,2434,75
92145754,92144692,92153452,8760,2435,75
92158240,92157178,92165621,8443,2436,75
92170486,92169423,92176916,7493,2437,75
92181790,92180727,92188537,7810,2438,75
92193498,92192218,92201850,9632,2439,75
92206673,92205610,92213737,8127,2440,75
92218481,92217418,92226785,9367,2441,75
92231746,92230466,92238177,7711,2442,75
92243138,92241858,92250836,8978,2443,75
92255695,92254633,92262758,8125,2444,75
92267608,92266546,92274039,7493,2445,75
92278999,92277720,92287013,9293,2446,75
92291821,92290759,92300173,9414,2447,75
92305134,92303854,92312514,8660,2448,75
92317475,92316195,92326143,9948,2449,75
92330956,92329893,92338336,8443,2450,75
92343184,92342122,92351219,9097,2451,75
92356180,92354900,92362611,7711,2452,75
92367409,92366346,92374789,8443,2453,75
92379633,92378570,92388301,9731,2454,75
92393146,92392083,92401496,9413,2455,75
92406306,92405243,92414657,9414,2456,75
92419402,92418339,92426440,8101,2457,75
92431309,92430246,92439977,9731,2458,75
92444835,92443773,92453186,9413,2459,75
92457929,92456867,92465620,8753,2460,75
92470581,92469301,92477011,7710,2461,75
92481847,92480784,92489545,8761,2462,75
92494376,92493313,92503044,9731,2463,75
92507833,92506771,92515531,8760,2464,75
92520491,92519212,92528505,9293,2465,75
92533465,92532186,92541163,8977,2466,75
92545907,92544844,92552871,8027,2467,75
92557615,92556552,92564263,7711,2468,75
92569224,92567944,92576288,8344,2469,75
92581161,92580098,92587908,7810,2470,75
92592869,92591589,92600903,9314,2471,75
92605751,92604688,92613132,8444,2472,75
92617966,92616904,92624714,7810,2473,75
92629675,92628395,92638343,9948,2474,75
92643173,92642110,92651525,9415,2475,75
92656485,92655206,92663866,8660,2476,75
92668827,92667547,92675890,8343,2477,75
92680851,92679571,92689519,9948,2478,75
92694390,92693327,92702742,9415,2479,75
92707531,92706469,92713962,7493,2480,75
92718794,92717731,92727462,9731,2481,75
92732423,92731144,92738854,7710,2482,75
92743815,92742535,92751195,8660,2483,75
92755987,92754924,92764339,9415,2484,75
92769299,92768020,92777334,9314,2485,75
92782190,92781128,92789886,8758,2486,75
92794847,92793567,92802883,9316,2487,75
92807627,92806564,92815225,8661,2488,75
92820076,92819013,92828744,9731,2489,75
92833617,92832554,92840048,7494,2490,75
92844792,92843729,92852462,8733,2491,75
92857276,92856213,92865289,9076,2492,75
92870250,92868970,92876998,8028,2493,75
92881872,92880809,92888936,8127,2494,75
92893897,92892617,92900328,7711,2495,75
92905163,92904100,92913176,9076,2496,75
92918136,92916857,92926804,9947,2497,75
92931548,92930485,92939556,9071,2498,75
92944300,92943237,92952941,9704,2499,75
92957790,92956727,92964221,7494,2500,75
92968965,92967902,92977849,9947,2501,75
92982593,92981531,92991868,10337,2502,75
92996816,92995753,93004830,9077,2503,75
93009791,93008511,93018459,9948,2504,75
93023303,93022240,93031001,8761,2505,75
93035961,93034682,93044312,9630,2506,75
93049272,93047993,93056020,8027,2507,75
93060980,93059701,93068994,9293,2508,75
93073738,93072675,93082379,9704,2509,75
93087245,93086183,93095597,9414,2510,75
93100433,93099370,93107498,8128,2511,75
93112242,93111179,93119840,8661,2512,75
93124690,93123627,93132388,8761,2513,75
93137207,93136145,93144271,8126,2514,75
93149105,93148042,93157773,9731,2515,75
93162606,93161543,93169987,8444,2516,75
93174948,93173668,93182645,8977,2517,75
93187607,93186327,93194988,8661,2518,75
93199856,93198793,93207870,9077,2519,75
93212671,93211608,93220685,9077,2520,75
93225534,93224472,93233547,9075,2521,75
93238404,93237341,93245151,7810,2522,75
93249966,93248904,93256397,7493,2523,75
93261357,93260078,93270025,9947,2524,75
93274866,93273803,93283534,9731,2525,75
93288494,93287215,93295558,8343,2526,75
93300418,93299355,93307482,8127,2527,75
93312443,93311163,93318874,7711,2528,75
93323835,93322555,93332186,9631,2529,75
93337046,93335983,93344110,8127,2530,75
93348954,93347891,93357306,9415,2531,75
93362147,93361084,93369527,8443,2532,75
93374366,93373302,93383034,9732,2533,75
93387996,93386716,93394744,8028,2534,75
93399705,93398425,93408057,9632,2535,75
93412801,93411738,93421443,9705,2536,75
93426283,93425220,93433030,7810,2537,75
93437902,93436839,93444965,8126,2538,75
93449925,93448646,93457621,8975,2539,75
93462456,93461393,93470470,9077,2540,75
93475431,93474151,93482495,8344,2541,75
93487238,93486176,93494909,8733,2542,75
93499870,93498590,93507251,8661,2543,75
93512094,93511031,93520108,9077,2544,75
93524953,93523891,93531701,7810,2545,75
93536527,93535464,93545195,9731,2546,75
93550040,93548977,93556471,7494,2547,75
93561215,93560152,93571460,11308,2548,75
93576293,93575230,93584554,9324,2549,75
93589375,93588312,93596755,8443,2550,75
93601548,93600486,93608928,8442,2551,75
93613672,93612609,93621046,8437,2552,75
93625919,93624856,93633933,9077,2553,75
93638894,93637614,93647246,9632,2554,75
93652206,93650927,93659587,8660,2555,75
93664391,93663328,93672088,8760,2556,75
93677050,93675770,93683798,8028,2557,75
93688759,93687479,93695189,7710,2558,75
93700046,93698983,93707742,8759,2559,75
93712574,93711512,93720925,9413,2560,75
93725726,93724662,93734393,9731,2561,75
93739355,93738075,93748023,9948,2562,75
93752768,93751705,93761071,9366,2563,75
93765923,93764861,93773303,8442,2564,75
93778095,93777032,93786762,9730,2565,75
93791507,93790444,93799199,8755,2566,75
93804008,93802945,93810755,7810,2567,75
93815717,93814437,93822465,8028,2568,75
93827334,93826272,93834398,8126,2569,75
93839142,93838080,93847056,8976,2570,75
93851875,93850812,93860543,9731,2571,75
93865382,93864319,93874049,9730,2572,75
93879011,93877731,93885759,8028,2573,75
93890594,93889531,93897342,7811,2574,75
93902168,93901106,93908598,7492,2575,75
93913389,93912326,93921403,9077,2576,75
93926238,93925175,93932668,7493,2577,75
93937478,93936414,93944858,8444,2578,75
93949820,93948540,93957834,9294,2579,75
93962796,93961516,93969226,7710,2580,75
93974054,93972992,93981118,8126,2581,75
93985927,93984864,93993308,8444,2582,75
93998270,93996990,94005967,8977,2583,75
94010928,94009649,94018963,9314,2584,75
94023924,94022645,94032276,9631,2585,75
94037130,94036067,94045481,9414,2586,75
94050288,94049225,94057352,8127,2587,75
94062209,94061146,94068641,7495,2588,75
94073602,94072323,94081616,9293,2589,75
94086577,94085298,94093325,8027,2590,75
94098286,94097006,94106300,9294,2591,75
94111092,94110029,94118790,8761,2592,75
94123535,94122472,94131860,9388,2593,75
94136716,94135653,94145068,9415,2594,75
94150029,94148750,94158043,9293,2595,75
94162865,94161803,94169613,7810,2596,75
94174575,94173295,94182273,8978,2597,75
94187124,94186061,94195138,9077,2598,75
94200100,94198820,94206531,7711,2599,75
94211492,94210213,94218872,8659,2600,75
94223834,94222554,94231848,9294,2601,75
94236640,94235577,94244992,9415,2602,75
94249737,94248674,94257743,9069,2603,75
94262705,94261425,94269137,7712,2604,75
94273882,94272819,94281163,8344,2605,75
94285986,94284923,94293682,8759,2606,75
94298519,94297457,94306871,9414,2607,75
94311832,94310553,94319530,8977,2608,75
94324492,94323212,94331872,8660,2609,75
94336724,94335661,94343788,8127,2610,75
94348532,94347470,94357468,9998,2611,75
94362430,94361150,94370782,9632,2612,75
94375744,94374464,94383441,8977,2613,75
94388232,94387169,94396584,9415,2614,75
94401453,94400390,94408517,8127,2615,75
94413478,94412198,94419909,7711,2616,75
94424701,94423639,94432081,8442,2617,75
94436940,94435878,94445608,9730,2618,75
94450442,94449379,94457822,8443,2619,75
94462783,94461504,94470797,9293,2620,75
94475632,94474569,94483646,9077,2621,75
94488608,94487328,94496305,8977,2622,75
94501266,94499986,94509618,9632,2623,75
94514581,94513300,94522932,9632,2624,75
94527894,94526614,94535592,8978,2625,75
94540419,94539356,94547167,7811,2626,75
94551981,94550918,94559046,8128,2627,75
94563791,94562728,94572360,9632,2628,75
94577210,94576147,94585562,9415,2629,75
94590523,94589244,94596955,7711,2630,75
94601798,94600736,94608545,7809,2631,75
94613507,94612227,94620887,8660,2632,75
94625741,94624678,94633754,9076,2633,75
94638499,94637436,94646097,8661,2634,75
94650953,94649891,94658017,8126,2635,75
94662821,94661758,94670835,9077,2636,75
94675647,94674584,94684316,9732,2637,75
94689106,94688043,94695853,7810,2638,75
94700598,94699535,94709167,9632,2639,75
94713976,94712913,94720407,7494,2640,75
94725369,94724089,94732433,8344,2641,75
94737298,94736235,94745966,9731,2642,75
94750815,94749753,94758195,8442,2643,75
94762940,94761877,94770295,8418,2644,75
94775039,94773976,94782320,8344,2645,75
94787281,94786002,94795295,9293,2646,75
94800160,94799097,94806591,7494,2647,75
94811416,94810353,94818480,8127,2648,75
94823225,94822162,94831233,9071,2649,75
94836195,94834915,94844864,9949,2650,75
94849826,94848546,94857207,8661,2651,75
94861950,94860888,94868354,7466,2652,75
94873316,94872036,94880697,8661,2653,75
94885659,94884379,94894327,9948,2654,75
94899072,94898009,94907376,9367,2655,75
94912239,94911176,94918986,7810,2656,75
94923731,94922668,94931962,9294,2657,75
94936924,94935644,94944305,8661,2658,75
94949128,94948065,94957796,9731,2659,75
94962541,94961478,94971180,9702,2660,75
94975994,94974931,94983691,8760,2661,75
94988653,94987373,94995085,7712,2662,75
94999830,94998767,95008471,9704,2663,75
95013433,95012153,95022102,9949,2664,75
95026910,95025848,95035262,9414,2665,75
95040007,95038944,95050252,11308,2666,75
95055303,95054023,95063001,8978,2667,75
95067963,95066683,95075027,8344,2668,75
95079884,95078821,95086948,8127,2669,75
95091740,95090677,95100408,9731,2670,75
95105370,95104090,95113067,8977,2671,75
95117858,95116795,95124605,7810,2672,75
95129567,95128287,95138236,9949,2673,75
95143198,95141918,95150261,8343,2674,75
95155223,95153943,95163575,9632,2675,75
95168320,95167257,95178248,10991,2676,75
95183176,95182113,95189607,7494,2677,75
95194451,95193388,95201199,7811,2678,75
95206063,95205000,95212495,7495,2679,75
95217456,95216177,95226124,9947,2680,75
95230988,95229924,95238052,8128,2681,75
95243014,95241734,95249762,8028,2682,75
95254724,95253444,95261787,8343,2683,75
95266625,95265562,95273372,7810,2684,75
95278212,95277149,95286879,9730,2685,75
95291710,95290648,95300378,9730,2686,75
95305339,95304060,95311770,7710,2687,75
95316575,95315512,95323323,7811,2688,75
95328160,95327097,95335857,8760,2689,75
95340673,95339610,95347421,7811,2690,75
95352383,95351103,95358815,7712,2691,75
95363612,95362549,95371964,9415,2692,75
95376824,95375761,95383887,8126,2693,75
95388731,95387668,95396429,8761,2694,75
95401390,95400111,95409742,9631,2695,75
95414704,95413424,95423371,9947,2696,75
95428197,95427134,95435262,8128,2697,75
95440223,95438944,95448574,9630,2698,75
95453535,95452256,95460600,8344,2699,75
95465562,95464282,95472310,8028,2700,75
95477161,95476098,95485513,9415,2701,75
95490351,95489288,95497732,8444,2702,75
95502571,95501508,95510585,9077,2703,75
95515546,95514267,95522611,8344,2704,75
95527573,95526293,95534321,8028,2705,75
95539130,95538067,95545561,7494,2706,75
95550361,95549298,95557742,8444,2707,75
95562487,95561424,95571446,10022,2708,75
95576336,95575273,95585004,9731,2709,75
95589813,95588750,95596243,7493,2710,75
95600988,95599925,95608585,8660,2711,75
95613547,95612267,95620928,8661,2712,75
95625890,95624610,95632638,8028,2713,75
95637383,95636320,95644981,8661,2714,75
95649942,95648663,95656373,7710,2715,75
95661119,95660055,95668789,8734,2716,75
95673632,95672569,95681330,8761,2717,75
95686146,95685083,95694813,9730,2718,75
95699774,95698495,95706838,8343,2719,75
95711800,95710520,95720468,9948,2720,75
95725430,95724150,95731861,7711,2721,75
95736732,95735669,95744746,9077,2722,75
95749543,95748480,95755974,7494,2723,75
95760771,95759708,95768151,8443,2724,75
95773013,95771950,95779444,7494,2725,75
95784241,95783178,95791937,8759,2726,75
95796771,95795708,95805440,9732,2727,75
95810311,95809248,95816742,7494,2728,75
95821600,95820537,95828347,7810,2729,75
95833219,95832156,95839967,7811,2730,75
95844817,95843754,95852515,8761,2731,75
95857334,95856271,95863765,7494,2732,75
95868562,95867499,95875310,7811,2733,75
95880119,95879056,95888787,9731,2734,75
95893749,95892469,95900813,8344,2735,75
95905775,95904495,95914442,9947,2736,75
95919404,95918124,95927418,9294,2737,75
95932379,95931100,95938810,7710,2738,75
95943621,95942558,95951635,9077,2739,75
95956496,95955433,95964510,9077,2740,75
95969471,95968192,95976218,8026,2741,75
95981179,95979900,95989193,9293,2742,75
95994029,95992966,96001726,8760,2743,75
96006551,96005489,96014249,8760,2744,75
96019108,96018046,96027776,9730,2745,75
96032608,96031545,96039039,7494,2746,75
96044000,96042721,96051064,8343,2747,75
96056026,96054746,96064378,9632,2748,75
96069184,96068121,96076565,8444,2749,75
96081309,96080247,96091553,11306,2750,75
96096484,96095421,96103548,8127,2751,75
96108378,96107315,96115126,7811,2752,75
96119977,96118914,96127357,8443,2753,75
96132189,96131127,96139887,8760,2754,75
96144720,96143657,96152100,8443,2755,75
96156958,96155896,96165627,9731,2756,75
96170372,96169309,96177408,8099,2757,75
96182216,96181153,96189914,8761,2758,75
96194659,96193596,96201696,8100,2759,75
96206499,96205437,96214196,8759,2760,75
96219158,96217878,96227509,9631,2761,75
96232311,96231248,96240008,8760,2762,75
96244880,96243817,96253549,9732,2763,75
96258510,96257231,96266523,9292,2764,75
96271357,96270294,96279371,9077,2765,75
96284209,96283146,96290956,7810,2766,75
96295794,96294731,96302225,7494,2767,75
96307050,96305987,96314748,8761,2768,75
96319586,96318523,96327600,9077,2769,75
96332561,96331282,96341229,9947,2770,75
96346072,96345009,96354424,9415,2771,75
96359386,96358106,96367400,9294,2772,75
96372190,96371127,96380541,9414,2773,75
96385503,96384223,96392884,8661,2774,75
96397754,96396691,96405452,8761,2775,75
96410413,96409134,96418111,8977,2776,75
96422903,96421840,96431571,9731,2777,75
96436533,96435253,96444546,9293,2778,75
96449508,96448228,96457859,9631,2779,75
96462820,96461541,96470834,9293,2780,75
96475795,96474516,96483809,9293,2781,75
96488605,96487542,96496618,9076,2782,75
96501487,96500424,96507918,7494,2783,75
96512787,96511724,96521455,9731,2784,75
96526310,96525247,96534977,9730,2785,75
96539771,96538707,96546518,7811,2786,75
96551326,96550263,96558707,8444,2787,75
96563669,96562389,96570734,8345,2788,75
96575695,96574416,96584046,9630,2789,75
96589008,96587728,96597676,9948,2790,75
96602500,96601437,96610197,8760,2791,75
96615158,96613879,96621589,7710,2792,75
96626441,96625378,96633506,8128,2793,75
96638363,96637301,96644794,7493,2794,75
96649755,96648476,96657136,8660,2795,75
96662098,96660818,96668529,7711,2796,75
96673352,96672288,96681704,9416,2797,75
96686564,96685501,96693628,8127,2798,75
96698373,96697310,96705021,7711,2799,75
96709860,96708797,96718528,9731,2800,75
96723490,96722210,96732158,9948,2801,75
96736903,96735840,96745545,9705,2802,75
96750506,96749227,96757569,8342,2803,75
96762530,96761251,96769278,8027,2804,75
96774240,96772960,96781938,8978,2805,75
96786774,96785711,96794471,8760,2806,75
96799341,96798278,96807038,8760,2807,75
96811889,96810826,96819903,9077,2808,75
96824865,96823585,96831612,8027,2809,75
96836573,96835294,96844270,8976,2810,75
96849087,96848024,96856151,8127,2811,75
96861002,96859939,96869016,9077,2812,75
96873860,96872797,96881557,8760,2813,75
96886422,96885360,96893802,8442,2814,75
96898638,96897575,96907306,9731,2815,75
96912165,96911103,96920833,9730,2816,75
96925794,96924515,96934145,9630,2817,75
96938989,96937926,96945421,7495,2818,75
96950257,96949194,96957321,8127,2819,75
96962282,96961003,96970295,9292,2820,75
96975256,96973977,96983270,9293,2821,75
96988231,96986952,96995928,8976,2822,75
97000779,96999716,97009447,9731,2823,75
97014408,97013129,97021472,8343,2824,75
97026433,97025154,97032864,7710,2825,75
97037609,97036546,97047199,10653,2826,75
97052033,97050970,97060569,9599,2827,75
97065443,97064381,97073795,9414,2828,75
97078540,97077477,97085577,8100,2829,75
97090374,97089312,97098726,9414,2830,75
97103547,97102485,97110294,7809,2831,75
97115151,97114088,97123820,9732,2832,75
97128691,97127628,97136387,8759,2833,75
97141231,97140167,97147979,7812,2834,75
97152724,97151661,97160099,8438,2835,75
97164895,97163832,97171642,7810,2836,75
97176472,97175410,97184169,8759,2837,75
97189131,97187851,97196828,8977,2838,75
97201789,97200510,97209803,9293,2839,75
97214663,97213600,97222677,9077,2840,75
97227639,97226359,97234702,8343,2841,75
97239663,97238384,97248015,9631,2842,75
97252976,97251697,97260673,8976,2843,75
97265635,97264355,97274302,9947,2844,75
97279136,97278073,97287150,9077,2845,75
97291956,97290893,97299969,9076,2846,75
97304797,97303734,97312495,8761,2847,75
97317240,97316177,97325809,9632,2848,75
97330554,97329491,97338225,8734,2849,75
97343050,97341987,97351064,9077,2850,75
97355809,97354746,97364039,9293,2851,75
97368871,97367808,97376884,9076,2852,75
97381728,97380665,97388792,8127,2853,75
97393607,97392544,97401621,9077,2854,75
97406432,97405369,97412862,7493,2855,75
97417824,97416544,97425520,8976,2856,75
97430265,97429202,97437546,8344,2857,75
97442508,97441228,97450522,9294,2858,75
97455364,97454301,97463378,9077,2859,75
97468226,97467163,97475607,8444,2860,75
97480447,97479384,97488143,8759,2861,75
97492969,97491906,97500983,9077,2862,75
97505829,97504766,97513209,8443,2863,75
97518082,97517019,97526434,9415,2864,75
97531233,97530170,97537664,7494,2865,75
97542472,97541410,97550168,8758,2866,75
97555041,97553978,97561471,7493,2867,75
97566307,97565244,97573054,7810,2868,75
97578016,97576736,97585396,8660,2869,75
97590358,97589078,97599026,9948,2870,75
97603828,97602765,97612496,9731,2871,75
97617338,97616275,97625036,8761,2872,75
97629998,97628718,97636430,7712,2873,75
97641391,97640112,97649743,9631,2874,75
97654705,97653425,97662086,8661,2875,75
97667048,97665768,97675400,9632,2876,75
97680264,97679201,97688615,9414,2877,75
97693360,97692297,97702949,10652,2878,75
97708000,97706720,97716352,9632,2879,75
97721219,97720156,97727966,7810,2880,75
97732711,97731648,97741352,9704,2881,75
97746148,97745085,97753529,8444,2882,75
97758274,97757211,97766578,9367,2883,75
97771374,97770311,97777805,7494,2884,75
97782767,97781487,97790148,8661,2885,75
97794949,97793887,97802963,9076,2886,75
97807924,97806645,97816276,9631,2887,75
97821122,97820059,97828818,8759,2888,75
97833670,97832608,97840101,7493,2889,75
97844902,97843839,97853570,9731,2890,75
97858367,97857304,97866719,9415,2891,75
97871530,97870467,97879544,9077,2892,75
97884505,97883226,97891885,8659,2893,75
97896727,97895664,97904741,9077,2894,75
97909703,97908423,97918054,9631,2895,75
97923015,97921736,97931028,9292,2896,75
97935871,97934808,97942935,8127,2897,75
97947741,97946678,97955754,9076,2898,75
97960716,97959436,97967147,7711,2899,75
97972109,97970829,97978539,7710,2900,75
97983386,97982323,97991737,9414,2901,75
97996538,97995475,98003919,8444,2902,75
98008880,98007601,98015310,7709,2903,75
98020112,98019049,98027492,8443,2904,75
98032453,98031174,98039517,8343,2905,75
98044378,98043315,98051442,8127,2906,75
98056281,98055217,98062712,7495,2907,75
98067457,98066394,98076341,9947,2908,75
98081197,98080134,98088262,8128,2909,75
98093059,98091996,98101411,9415,2910,75
98106279,98105216,98114293,9077,2911,75
98119254,98117975,98126951,8976,2912,75
98131913,98130633,98138660,8027,2913,75
98143404,98142342,98151728,9386,2914,75
98156473,98155410,98164165,8755,2915,75
98169126,98167847,98177794,9947,2916,75
98182609,98181547,98190961,9414,2917,75
98195923,98194643,98202353,7710,2918,75
98207194,98206131,98214892,8761,2919,75
98219742,98218679,98228094,9415,2920,75
98233056,98231776,98240121,8345,2921,75
98245082,98243803,98252146,8343,2922,75
98256982,98255918,98265651,9733,2923,75
98270483,98269420,98278179,8759,2924,75
98282924,98281861,98291808,9947,2925,75
98296627,98295564,98305296,9732,2926,75
98310041,98308978,98319948,10970,2927,75
98324892,98323830,98331955,8125,2928,75
98336916,98335636,98344613,8977,2929,75
98349574,98348294,98356322,8028,2930,75
98361190,98360128,98368888,8760,2931,75
98373848,98372569,98381862,9293,2932,75
98386691,98385628,98394705,9077,2933,75
98399666,98398387,98407046,8659,2934,75
98411857,98410795,98418605,7810,2935,75
98423567,98422287,98432235,9948,2936,75
98437091,98436028,98445105,9077,2937,75
98450066,98448787,98458734,9947,2938,75
98463479,98462416,98471783,9367,2939,75
98476619,98475557,98483367,7810,2940,75
98488239,98487177,98496253,9076,2941,75
98501091,98500028,98507839,7811,2942,75
98512713,98511650,98520727,9077,2943,75
98525563,98524500,98533260,8760,2944,75
98538095,98537032,98545793,8761,2945,75
98550755,98549475,98559423,9948,2946,75
98564251,98563188,98571631,8443,2947,75
98576472,98575408,98584824,9416,2948,75
98589672,98588609,98597686,9077,2949,75
98602647,98601368,98610345,8977,2950,75
98615201,98614139,98621948,7809,2951,75
98626910,98625630,98635578,9948,2952,75
98640445,98639382,98647826,8444,2953,75
98652571,98651508,98659609,8101,2954,75
98664454,98663392,98671518,8126,2955,75
98676479,98675200,98683227,8027,2956,75
98687971,98686908,98696613,9705,2957,75
98701462,98700400,98708526,8126,2958,75
98713488,98712208,98720236,8028,2959,75
98725078,98724015,98732776,8761,2960,75
98737593,98736530,98744341,7811,2961,75
98749303,98748023,98756999,8976,2962,75
98761831,98760768,98768895,8127,2963,75
98773857,98772577,98781555,8978,2964,75
98786394,98785331,98794408,9077,2965,75
98799267,98798204,98807281,9077,2966,75
98812026,98810963,98818674,7711,2967,75
98823513,98822450,98830261,7811,2968,75
98835223,98833943,98842921,8978,2969,75
98847730,98846667,98854162,7495,2970,75
98858907,98857844,98867791,9947,2971,75
98872753,98871473,98881421,9948,2972,75
98886265,98885202,98893329,8127,2973,75
98898290,98897010,98905671,8661,2974,75
98910633,98909353,98918985,9632,2975,75
98923811,98922749,98932163,9414,2976,75
98937124,98935845,98943871,8026,2977,75
98948695,98947633,98956076,8443,2978,75
98961037,98959758,98969388,9630,2979,75
98974350,98973070,98980781,7711,2980,75
98985594,98984531,98992658,8127,2981,75
98997478,98996415,99005492,9077,2982,75
99010453,99009174,99018467,9293,2983,75
99023333,99022270,99031030,8760,2984,75
99035877,99034814,99043574,8760,2985,75
99048439,99047377,99056791,9414,2986,75
99061536,99060473,99069521,9048,2987,75
99074266,99073203,99082834,9631,2988,75
99087795,99086516,99096147,9631,2989,75
99100957,99099894,99108654,8760,2990,75
99113492,99112429,99121188,8759,2991,75
99126047,99124984,99133428,8444,2992,75
99138173,99137110,99146160,9050,2993,75
99150905,99149842,99158595,8753,2994,75
99163557,99162277,99171255,8978,2995,75
99176217,99174937,99184231,9294,2996,75
99189074,99188011,99195504,7493,2997,75
99200250,99199186,99208890,9704,2998,75
99213851,99212572,99222519,9947,2999,75
99227371,99226308,99236038,9730,3000,75
99240836,99239773,99247266,7493,3001,75
99252227,99250948,99258657,7709,3002,75
99263618,99262339,99270682,8343,3003,75
99275481,99274418,99284150,9732,3004,75
99288997,99287934,99297348,9414,3005,75
99302205,99301142,99309903,8761,3006,75
99314864,99313585,99323533,9948,3007,75
99328327,99327265,99336995,9730,3008,75
99341805,99340742,99348235,7493,3009,75
99353031,99351968,99360095,8127,3010,75
99364932,99363869,99373599,9730,3011,75
99378457,99377395,99387125,9730,3012,75
99391869,99390807,99400194,9387,3013,75
99405027,99403964,99412408,8444,3014,75
99417153,99416090,99424191,8101,3015,75
99429003,99427940,99437017,9077,3016,75
99441978,99440699,99450646,9947,3017,75
99455486,99454423,99462867,8444,3018,75
99467829,99466549,99475210,8661,3019,75
99480063,99479000,99487760,8760,3020,75
99492577,99491515,99501245,9730,3021,75
99506206,99504927,99512638,7711,3022,75
99517600,99516320,99524031,7711,3023,75
99528993,99527713,99537345,9632,3024,75
99542090,99541027,99548495,7468,3025,75
99553365,99552302,99561716,9414,3026,75
99566677,99565398,99574691,9293,3027,75
99579653,99578373,99587667,9294,3028,75
99592412,99591349,99601370,10021,3029,75
99606420,99605141,99614434,9293,3030,75
99619395,99618116,99626776,8660,3031,75
99631592,99630529,99639606,9077,3032,75
99644433,99643370,99651498,8128,3033,75
99656301,99655239,99664653,9414,3034,75
99669398,99668335,99678673,10338,3035,75
99683506,99682443,99691409,8966,3036,75
99696371,99695091,99704069,8978,3037,75
99708933,99707870,99715997,8127,3038,75
99720959,99719679,99728657,8978,3039,75
99733618,99732339,99741632,9293,3040,75
99746594,99745314,99753658,8344,3041,75
99758403,99757340,99766388,9048,3042,75
99771177,99770115,99778875,8760,3043,75
99783678,99782616,99792030,9414,3044,75
99796887,99795824,99805554,9730,3045,75
99810402,99809340,99818100,8760,3046,75
99822969,99821906,99831638,9732,3047,75
99836600,99835320,99845267,9947,3048,75
99850228,99848949,99858897,9948,3049,75
99863718,99862655,99872070,9415,3050,75
99876925,99875862,99884939,9077,3051,75
99889684,99888621,99897691,9070,3052,75
99902536,99901472,99908966,7494,3053,75
99913929,99912648,99922280,9632,3054,75
99927087,99926024,99934467,8443,3055,75
99939428,99938149,99945858,7709,3056,75
99950704,99949642,99958718,9076,3057,75
99963524,99962461,99970588,8127,3058,75
99975333,99974270,99984923,10653,3059,75
99989757,99988694,99996710,8016,3060,75
100001542,100000479,100009242,8763,3061,75
100014468,100013188,100022483,9295,3062,75
100027614,100026552,100034364,7812,3063,75
100039589,100038310,100048258,9948,3064,75
100053314,100052251,100060063,7812,3065,75
100065131,100064068,100072514,8446,3066,75
100077637,100076574,100084387,7813,3067,75
100089447,100088384,100096197,7813,3068,75
100101304,100100241,100109320,9079,3069,75
100114393,100113330,100121142,7812,3070,75
100126251,100125188,100134267,9079,3071,75
100139493,100138213,100145926,7713,3072,75
100151032,100149969,100158415,8446,3073,75
100163641,100162361,100170073,7712,3074,75
100175298,100174019,100182681,8662,3075,75
100187690,100186627,100194340,7713,3076,75
100199439,100198376,100207455,9079,3077,75
100212566,100211503,100221237,9734,3078,75
100226372,100225310,100235041,9731,3079,75
100240267,100238987,100247650,8663,3080,75
100252716,100251653,100259150,7497,3081,75
100264228,100263165,100272243,9078,3082,75
100277325,100276262,100285341,9079,3083,75
100290433,100289370,100298448,9078,3084,75
100303532,100302468,100312201,9733,3085,75
100317270,100316207,100324969,8762,3086,75
100330195,100328915,100338211,9296,3087,75
100343297,100342234,100350680,8446,3088,75
100355762,100354699,100364116,9417,3089,75
100369341,100368062,100377378,9316,3090,75
100382603,100381324,100390640,9316,3091,75
100395866,100394586,100404536,9950,3092,75
100409545,100408482,100417461,8979,3093,75
100422530,100421467,100429912,8445,3094,75
100435137,100433858,100443491,9633,3095,75
100448579,100447516,100456595,9079,3096,75
100461681,100460618,100469064,8446,3097,75
100474195,100473132,100480628,7496,3098,75
100485854,100484574,100492604,8030,3099,75
100497672,100496610,100506342,9732,3100,75
100511568,100510288,100519584,9296,3101,75
100524664,100523601,100531097,7496,3102,75
100536323,100535043,100544677,9634,3103,75
100549766,100548703,100556200,7497,3104,75
100561209,100560146,100569261,9115,3105,75
100574486,100573207,100582501,9294,3106,75
100587576,100586513,100595275,8762,3107,75
100600364,100599301,100607429,8128,3108,75
100612655,100611375,100620671,9296,3109,75
100625794,100624732,100632543,7811,3110,75
100637673,100636610,100645373,8763,3111,75
100650486,100649424,100658502,9078,3112,75
100663727,100662448,100670160,7712,3113,75
100675219,100674156,100682602,8446,3114,75
100687828,100686548,100696181,9633,3115,75
100701406,100700127,100708473,8346,3116,75
100713698,100712419,100721397,8978,3117,75
100726498,100725435,100732930,7495,3118,75
100738043,100736980,100746397,9417,3119,75
100751474,100750411,100758224,7813,3120,75
100763279,100762217,100771633,9416,3121,75
100776642,100775579,100784874,9295,3122,75
100789992,100788929,100796742,7813,3123,75
100801831,100800768,100810184,9416,3124,75
100815410,100814130,100822159,8029,3125,75
100827384,100826105,100835400,9295,3126,75
100840626,100839346,100847693,8347,3127,75
100852755,100851693,100859188,7495,3128,75
100864313,100863251,100872012,8761,3129,75
100877021,100875958,100885254,9296,3130,75
100890321,100889258,100897704,8446,3131,75
100902793,100901730,100910492,8762,3132,75
100915582,100914520,100922648,8128,3133,75
100927726,100926663,100934475,7812,3134,75
100939484,100938421,100947401,8980,3135,75
100952627,100951347,100960643,9296,3136,75
100965743,100964680,100974097,9417,3137,75
100979167,100978104,100986549,8445,3138,75
100991648,100990585,100998715,8130,3139,75
101003940,101002661,101010690,8029,3140,75
101015699,101014636,101023434,8798,3141,75
101028551,101027488,101034985,7497,3142,75
101040094,101039031,101047476,8445,3143,75
101052535,101051472,101059917,8445,3144,75
101064926,101063863,101072345,8482,3145,75
101077427,101076364,101085127,8763,3146,75
101090192,101089130,101096626,7496,3147,75
101101852,101100572,101109551,8979,3148,75
101114776,101113497,101122792,9295,3149,75
101127891,101126828,101136562,9734,3150,75
101141666,101140603,101149366,8763,3151,75
101154462,101153399,101161527,8128,3152,75
101166536,101165473,101174273,8800,3153,75
101179393,101178330,101186142,7812,3154,75
101191151,101190088,101198888,8800,3155,75
101203996,101202933,101211696,8763,3156,75
101216836,101215772,101224852,9080,3157,75
101230078,101228798,101238749,9951,3158,75
101243861,101242798,101250927,8129,3159,75
101255992,101254930,101264662,9732,3160,75
101269736,101268674,101276170,7496,3161,75
101281396,101280116,101290065,9949,3162,75
101295290,101294011,101303961,9950,3163,75
101308971,101307908,101315938,8030,3164,75
101321030,101319967,101329384,9417,3165,75
101334511,101333448,101341576,8128,3166,75
101346688,101345626,101353120,7494,3167,75
101358189,101357126,101364623,7497,3168,75
101369684,101368622,101376750,8128,3169,75
101381812,101380749,101389195,8446,3170,75
101394307,101393244,101401690,8446,3171,75
101406764,101405701,101414464,8763,3172,75
101419533,101418471,101427549,9078,3173,75
101432642,101431579,101440025,8446,3174,75
101445114,101444052,101451547,7495,3175,75
101456625,101455562,101464008,8446,3176,75
101469077,101468015,101477431,9416,3177,75
101482440,101481377,101490176,8799,3178,75
101495243,101494180,101503259,9079,3179,75
101508320,101507257,101516020,8763,3180,75
101521121,101520058,101528821,8763,3181,75
101533919,101532856,101541302,8446,3182,75
101546528,101545248,101553277,8029,3183,75
101558286,101557223,101566992,9769,3184,75
101572064,101571001,101580734,9733,3185,75
101585799,101584737,101592549,7812,3186,75
101597774,101596495,101604841,8346,3187,75
101609850,101608787,101616499,7712,3188,75
101621724,101620445,101629423,8978,3189,75
101634432,101633369,101644067,10698,3190,75
101649226,101648163,101657897,9734,3191,75
101662981,101661918,101670364,8446,3192,75
101675472,101674410,101684143,9733,3193,75
101689247,101688184,101696313,8129,3194,75
101701392,101700329,101708141,7812,3195,75
101713263,101712200,101719697,7497,3196,75
101724750,101723688,101732450,8762,3197,75
101737676,101736396,101746347,9951,3198,75
101751356,101750293,101760380,10087,3199,75
101765478,101764415,101775029,10614,3200,75
101780127,101779064,101787409,8345,3201,75
101792505,101791442,101799255,7813,3202,75
101804345,101803282,101811411,8129,3203,75
101816478,101815415,101823228,7813,3204,75
101828454,101827174,101834888,7714,3205,75
101839954,101838891,101848623,9732,3206,75
101853697,101852634,101860130,7496,3207,75
101865355,101864076,101873371,9295,3208,75
101878379,101877317,101886612,9295,3209,75
101891621,101890558,101900623,10065,3210,75
101905793,101904730,101912543,7813,3211,75
101917609,101916545,101925625,9080,3212,75
101930634,101929571,101937737,8166,3213,75
101942822,101941760,101949572,7812,3214,75
101954798,101953518,101962498,8980,3215,75
101967561,101966498,101975578,9080,3216,75
101980671,101979609,101988370,8761,3217,75
101993468,101992405,102001822,9417,3218,75
102007047,102005768,102014430,8662,3219,75
102019507,102018444,102026574,8130,3220,75
102031673,102030611,102038107,7496,3221,75
102043211,102042149,102050911,8762,3222,75
102055993,102054931,102063060,8129,3223,75
102068114,102067051,102074548,7497,3224,75
102079631,102078568,102086381,7813,3225,75
102091606,102090327,102098356,8029,3226,75
102103421,102102358,102111121,8763,3227,75
102116190,102115127,102124861,9734,3228,75
102129919,102128856,102138590,9734,3229,75
102143665,102142602,102150415,7813,3230,75
102155484,102154421,102163500,9079,3231,75
102168605,102167542,102175355,7813,3232,75
102180580,102179301,102189250,9949,3233,75
102194351,102193288,102203021,9733,3234,75
102208084,102207021,102216754,9733,3235,75
102221865,102220802,102229882,9080,3236,75
102235108,102233828,102241541,7713,3237,75
102246595,102245533,102254947,9414,3238,75
102260173,102258893,102268527,9634,3239,75
102273536,102272473,102282221,9748,3240,75
102287322,102286259,102295675,9416,3241,75
102300751,102299688,102308768,9080,3242,75
102313872,102312809,102320622,7813,3243,75
102325848,102324568,102334518,9950,3244,75
102339526,102338464,102347262,8798,3245,75
102352488,102351208,102358922,7714,3246,75
102363932,102362868,102373588,10720,3247,75
102378902,102377623,102385969,8346,3248,75
102391195,102389915,102399865,9950,3249,75
102404965,102403902,102411397,7495,3250,75
102416622,102415342,102424975,9633,3251,75
102430034,102428971,102438704,9733,3252,75
102443816,102442754,102452486,9732,3253,75
102457567,102456504,102464000,7496,3254,75
102469089,102468027,102477442,9415,3255,75
102482668,102481388,102490684,9296,3256,75
102495775,102494712,102504445,9733,3257,75
102509669,102508390,102518339,9949,3258,75
102523423,102522360,102531122,8762,3259,75
102536224,102535161,102544240,9079,3260,75
102549353,102548290,102556420,8130,3261,75
102561646,102560366,102568079,7713,3262,75
102573149,102572086,102579582,7496,3263,75
102584591,102583528,102592643,9115,3264,75
102597708,102596646,102606378,9732,3265,75
102611499,102610436,102618882,8446,3266,75
102623890,102622828,102632122,9294,3267,75
102637131,102636068,102645363,9295,3268,75
102650451,102649387,102657517,8130,3269,75
102662607,102661544,102669357,7813,3270,75
102674581,102673302,102681963,8661,3271,75
102687039,102685976,102695393,9417,3272,75
102700619,102699339,102707369,8030,3273,75
102712594,102711314,102719343,8029,3274,75
102724475,102723413,102732175,8762,3275,75
102737243,102736181,102743993,7812,3276,75
102749081,102748018,102756148,8130,3277,75
102761222,102760159,102767654,7495,3278,75
102772746,102771683,102779179,7496,3279,75
102784239,102783176,102791305,8129,3280,75
102796406,102795343,102803473,8130,3281,75
102808482,102807419,102817484,10065,3282,75
102822799,102821519,102829231,7712,3283,75
102834305,102833243,102841054,7811,3284,75
102846119,102845056,102852868,7812,3285,75
102857946,102856884,102864696,7812,3286,75
102869761,102868699,102876194,7495,3287,75
102881420,102880140,102889436,9296,3288,75
102894661,102893382,102903015,9633,3289,75
102908094,102907031,102914526,7495,3290,75
102919610,102918547,102928280,9733,3291,75
102933345,102932283,102942014,9731,3292,75
102947023,102945960,102954758,8798,3293,75
102959832,102958770,102968502,9732,3294,75
102973728,102972448,102980160,7712,3295,75
102985386,102984106,102994056,9950,3296,75
102999141,102998079,103005891,7812,3297,75
103011117,103009837,103019133,9296,3298,75
103024358,103023079,103031425,8346,3299,75
103036534,103035471,103044234,8763,3300,75
103049460,103048180,103058131,9951,3301,75
103063140,103062077,103070876,8799,3302,75
103075978,103074915,103082728,7813,3303,75
103087835,103086772,103094585,7813,3304,75
103099717,103098654,103107417,8763,3305,75
103112642,103111363,103119075,7712,3306,75
103124173,103123110,103130606,7496,3307,75
103135676,103134613,103142741,8128,3308,75
103147967,103146687,103156319,9632,3309,75
103161545,103160265,103170214,9949,3310,75
103175290,103174227,103183961,9734,3311,75
103189187,103187907,103196570,8663,3312,75
103201796,103200516,103208546,8030,3313,75
103213612,103212549,103221312,8763,3314,75
103226429,103225366,103234445,9079,3315,75
103239454,103238391,103246557,8166,3316,75
103251641,103250578,103259994,9416,3317,75
103265219,103263940,103272602,8662,3318,75
103277693,103276631,103286047,9416,3319,75
103291127,103290064,103297559,7495,3320,75
103302652,103301589,103309085,7496,3321,75
103314094,103313031,103322779,9748,3322,75
103327875,103326812,103335258,8446,3323,75
103340267,103339204,103349606,10402,3324,75
103354809,103353747,103361242,7495,3325,75
103366332,103365269,103375002,9733,3326,75
103380011,103378948,103388696,9748,3327,75
103393757,103392694,103400189,7495,3328,75
103405282,103404220,103413952,9732,3329,75
103419059,103417996,103426125,8129,3330,75
103431240,103430177,103438622,8445,3331,75
103443710,103442647,103450143,7496,3332,75
103455368,103454089,103464038,9949,3333,75
103469114,103468051,103475864,7813,3334,75
103480923,103479860,103488622,8762,3335,75
103493700,103492637,103500767,8130,3336,75
103505859,103504797,103512609,7812,3337,75
103517675,103516612,103524109,7497,3338,75
103529334,103528055,103537350,9295,3339,75
103542458,103541395,103550812,9417,3340,75
103555898,103554835,103563598,8763,3341,75
103568729,103567665,103575162,7497,3342,75
103580248,103579185,103587631,8446,3343,75
103592759,103591696,103599825,8129,3344,75
103605051,103603771,103613067,9296,3345,75
103618152,103617089,103625850,8761,3346,75
103631077,103629796,103639092,9296,3347,75
103644317,103643037,103651699,8662,3348,75
103656778,103655716,103664794,9078,3349,75
103669884,103668822,103676634,7812,3350,75
103681859,103680580,103690213,9633,3351,75
103695439,103694159,103702506,8347,3352,75
103707731,103706452,103714481,8029,3353,75
103719567,103718504,103727921,9417,3354,75
103733146,103731867,103739579,7712,3355,75
103744680,103743617,103752380,8763,3356,75
103757389,103756326,103764492,8166,3357,75
103769718,103768438,103777734,9296,3358,75
103782810,103781747,103789559,7812,3359,75
103794622,103793560,103802321,8761,3360,75
103807386,103806323,103813818,7495,3361,75
103818876,103817813,103825941,8128,3362,75
103831000,103829937,103837434,7497,3363,75
103842442,103841380,103850177,8797,3364,75
103855283,103854221,103863953,9732,3365,75
103869010,103867947,103876075,8128,3366,75
103881188,103880125,103887937,7812,3367,75
103893022,103891959,103901038,9079,3368,75
103906125,103905062,103914479,9417,3369,75
103919705,103918425,103926455,8030,3370,75
103931681,103930401,103940034,9633,3371,75
103945121,103944058,103953475,9417,3372,75
103958547,103957484,103966563,9079,3373,75
103971788,103970509,103979804,9295,3374,75
103984881,103983818,103993551,9733,3375,75
103998657,103997594,104007010,9416,3376,75
104012018,104010956,104020386,9430,3377,75
104025611,104024332,104034281,9949,3378,75
104039507,104038227,104046889,8662,3379,75
104051970,104050907,104060301,9394,3380,75
104065409,104064346,104073107,8761,3381,75
104078210,104077147,104084960,7813,3382,75
104090039,104088976,104097422,8446,3383,75
104102431,104101368,104109714,8346,3384,75
104114783,104113720,104123454,9734,3385,75
104128512,104127449,104134945,7496,3386,75
104140080,104139017,104147463,8446,3387,75
104152549,104151486,104161219,9733,3388,75
104166310,104165247,104174326,9079,3389,75
104179436,104178373,104187136,8763,3390,75
104192195,104191133,104199578,8445,3391,75
104204656,104203594,104212672,9078,3392,75
104217765,104216702,104224515,7813,3393,75
104229571,104228508,104237271,8763,3394,75
104242394,104241331,104250409,9078,3395,75
104255486,104254423,104262552,8129,3396,75
104267778,104266498,104275478,8980,3397,75
104280569,104279506,104289239,9733,3398,75
104294301,104293238,104302655,9417,3399,75
104307719,104306656,104315102,8446,3400,75
104320183,104319120,104327565,8445,3401,75
104332791,104331511,104340173,8662,3402,75
104345398,104344119,104352463,8344,3403,75
104357530,104356467,104365546,9079,3404,75
104370772,104369492,104377522,8030,3405,75
104382640,104381577,104390994,9417,3406,75
104396220,104394940,104404574,9634,3407,75
104409671,104408608,104417687,9079,3408,75
104422798,104421735,104430498,8763,3409,75
104435561,104434498,104442628,8130,3410,75
104447722,104446659,104454788,8129,3411,75
104459796,104458734,104466582,7848,3412,75
104471659,104470597,104480329,9732,3413,75
104485404,104484341,104493758,9417,3414,75
104498983,104497704,104505415,7711,3415,75
104510481,104509418,104517231,7813,3416,75
104522298,104521235,104529998,8763,3417,75
104535061,104533998,104542127,8129,3418,75
104547353,104546073,104555707,9634,3419,75
104560796,104559734,104567862,8128,3420,75
104572975,104571912,104580675,8763,3421,75
104585732,104584669,104594085,9416,3422,75
104599094,104598031,104606060,8029,3423,75
104611286,104610006,104618668,8662,3424,75
104623893,104622614,104631909,9295,3425,75
104636968,104635905,104645639,9734,3426,75
104650648,104649585,104658068,8483,3427,75
104663293,104662014,104669726,7712,3428,75
104674735,104673672,104683420,9748,3429,75
104688646,104687366,104695396,8030,3430,75
104700523,104699460,104709192,9732,3431,75
104714418,104713138,104721800,8662,3432,75
104726905,104725842,104734288,8446,3433,75
104739514,104738234,104747529,9295,3434,75
104752755,104751475,104759505,8030,3435,75
104764575,104763512,104771958,8446,3436,75
104777047,104775984,104784747,8763,3437,75
104789845,104788782,104797544,8762,3438,75
104802770,104801490,104810152,8662,3439,75
104815377,104814098,104823393,9295,3440,75
104828619,104827339,104835369,8030,3441,75
104840428,104839365,104848443,9078,3442,75
104853500,104852437,104861516,9079,3443,75
104866650,104865587,104874350,8763,3444,75
104879575,104878296,104887275,8979,3445,75
104892285,104891222,104900517,9295,3446,75
104905527,104904464,104914415,9951,3447,75
104919641,104918362,104927657,9295,3448,75
104932733,104931670,104941403,9733,3449,75
104946478,104945415,104954178,8763,3450,75
104959405,104958125,104967422,9297,3451,75
104972557,104971494,104980572,9078,3452,75
104985657,104984594,104994010,9416,3453,75
104999122,104998060,105005556,7496,3454,75
105010782,105009503,105018799,9296,3455,75
105023899,105022837,105032570,9733,3456,75
105037630,105036567,105044696,8129,3457,75
105049705,105048642,105058391,9749,3458,75
105063486,105062423,105071185,8762,3459,75
105076288,105075225,105083671,8446,3460,75
105088794,105087731,105095228,7497,3461,75
105100238,105099175,105108607,9432,3462,75
105113746,105112683,105122100,9417,3463,75
105127326,105126047,105135343,9296,3464,75
105140353,105139290,105150010,10720,3465,75
105155325,105154045,105162075,8030,3466,75
105167166,105166103,105173600,7497,3467,75
105178827,105177547,105187181,9634,3468,75
105192298,105191236,105199364,8128,3469,75
105204495,105203432,105210929,7497,3470,75
105216156,105214876,105223222,8346,3471,75
105228308,105227245,105236978,9733,3472,75
105242082,105241019,105250098,9079,3473,75
105255169,105254106,105263522,9416,3474,75
105268616,105267554,105277286,9732,3475,75
105282296,105281233,105289262,8029,3476,75
105294326,105293263,105302680,9417,3477,75
105307907,105306627,105316578,9951,3478,75
105321710,105320647,105329093,8446,3479,75
105334177,105333114,105342531,9417,3480,75
105347616,105346554,105355970,9416,3481,75
105361068,105360004,105369085,9081,3482,75
105374169,105373106,105382523,9417,3483,75
105387642,105386579,105395996,9417,3484,75
105401077,105400014,105408143,8129,3485,75
105413226,105412163,105421580,9417,3486,75
105426684,105425621,105434700,9079,3487,75
105439927,105438647,105447627,8980,3488,75
105452854,105451574,105460869,9295,3489,75
105465879,105464816,105473614,8798,3490,75
105478840,105477561,105487194,9633,3491,75
105492273,105491210,105499655,8445,3492,75
105504748,105503685,105513418,9733,3493,75
105518428,105517365,105527114,9749,3494,75
105532341,105531061,105539408,8347,3495,75
105544418,105543355,105551838,8483,3496,75
105556920,105555857,105564304,8447,3497,75
105569375,105568312,105575809,7497,3498,75
105580819,105579756,105587470,7714,3499,75
105592480,105591417,105601504,10087,3500,75
105606820,105605540,105613569,8029,3501,75
105618631,105617568,105626985,9417,3502,75
105632083,105631020,105640436,9416,3503,75
105645515,105644452,105652265,7813,3504,75
105657492,105656212,105665509,9297,3505,75
105670735,105669456,105678752,9296,3506,75
105683761,105682698,105691498,8800,3507,75
105696724,105695444,105704107,8663,3508,75
105709206,105708143,105717877,9734,3509,75
105722887,105721824,105730170,8346,3510,75
105735396,105734117,105744067,9950,3511,75
105749188,105748125,105757204,9079,3512,75
105762279,105761216,105769346,8130,3513,75
105774429,105773366,105781812,8446,3514,75
105786903,105785841,105793653,7812,3515,75
105798756,105797693,105805823,8130,3516,75
105810902,105809839,105819256,9417,3517,75
105824482,105823203,105832836,9633,3518,75
105838063,105836783,105846080,9297,3519,75
105851306,105850027,105859660,9633,3520,75
105864766,105863703,105871517,7814,3521,75
105876743,105875464,105884443,8979,3522,75
105889501,105888438,105896884,8446,3523,75
105902111,105900831,105910465,9634,3524,75
105915691,105914412,105922442,8030,3525,75
105927669,105926389,105935051,8662,3526,75
105940135,105939073,105946884,7811,3527,75
105952110,105950831,105958544,7713,3528,75
105963770,105962491,105970837,8346,3529,75
105975914,105974851,105983297,8446,3530,75
105988421,105987358,105997092,9734,3531,75
106002319,106001039,106010019,8980,3532,75
106015246,106013966,106022945,8979,3533,75
106028059,106026996,106036413,9417,3534,75
106041639,106040360,106050309,9949,3535,75
106055441,106054378,106062508,8130,3536,75
106067593,106066530,106075947,9417,3537,75
106080957,106079894,106087744,7850,3538,75
106092850,106091787,106100233,8446,3539,75
106105320,106104257,106113336,9079,3540,75
106118460,106117397,106126160,8763,3541,75
106131253,106130191,106138952,8761,3542,75
106144179,106142899,106152849,9950,3543,75
106158075,106156796,106166092,9296,3544,75
106171160,106170098,106179514,9416,3545,75
106184576,106183513,106191010,7497,3546,75
106196237,106194957,106203937,8980,3547,75
106209163,106207884,106215914,8030,3548,75
106221140,106219861,106229811,9950,3549,75
106235037,106233758,106243053,9295,3550,75
106248130,106247066,106254880,7814,3551,75
106260001,106258939,106268018,9079,3552,75
106273129,106272066,106279879,7813,3553,75
106284949,106283886,106292332,8446,3554,75
106297457,106296394,106303891,7497,3555,75
106308946,106307883,106317299,9416,3556,75
106322525,106321246,106329907,8661,3557,75
106335000,106333937,106343670,9733,3558,75
106348759,106347696,106355509,7813,3559,75
106360736,106359456,106368435,8979,3560,75
106373497,106372435,106382167,9732,3561,75
106387261,106386198,106393695,7497,3562,75
106398813,106397750,106405562,7812,3563,75
106410788,106409509,106419459,9950,3564,75
106424558,106423495,106431309,7814,3565,75
106436319,106435256,106444688,9432,3566,75
106449784,106448722,106456851,8129,3567,75
106461975,106460912,106469992,9080,3568,75
106475218,106473939,106483572,9633,3569,75
106488670,106487607,106495736,8129,3570,75
106500745,106499683,106507532,7849,3571,75
106512607,106511544,106520624,9080,3572,75
106525714,106524652,106532146,7494,3573,75
106537156,106536093,106544892,8799,3574,75
106549964,106548900,106557663,8763,3575,75
106562733,106561670,106571087,9417,3576,75
106576178,106575115,106583561,8446,3577,75
106588641,106587578,106595075,7497,3578,75
106600159,106599096,106608176,9080,3579,75
106613403,106612123,106622073,9950,3580,75
106627157,106626094,106635511,9417,3581,75
106640615,106639553,106649285,9732,3582,75
106654351,106653289,106661418,8129,3583,75
106666644,106665365,106674661,9296,3584,75
106679779,106678717,106687479,8762,3585,75
106692706,106691426,106700089,8663,3586,75
106705230,106704167,106713583,9416,3587,75
106718690,106717628,106725757,8129,3588,75
106730838,106729775,106737904,8129,3589,75
106743009,106741946,106749443,7497,3590,75
106754570,106753507,106761004,7497,3591,75
106766230,106764951,106774585,9634,3592,75
106779658,106778595,106786408,7813,3593,75
106791517,106790454,106799534,9080,3594,75
106804624,106803561,106812008,8447,3595,75
106817070,106816007,106824137,8130,3596,75
106829363,106828084,106837717,9633,3597,75
106842944,106841664,106850644,8980,3598,75
106855731,106854668,106863115,8447,3599,75
106868245,106867183,106876915,9732,3600,75
106882142,106880862,106890158,9296,3601,75
106895384,106894105,106903400,9295,3602,75
106908626,106907347,106916643,9296,3603,75
106921706,106920643,106930060,9417,3604,75
106935287,106934007,106943303,9296,3605,75
106948363,106947300,106956717,9417,3606,75
106961791,106960729,106969491,8762,3607,75
106974558,106973495,106982258,8763,3608,75
106987485,106986205,106994551,8346,3609,75
106999678,106998616,107007695,9079,3610,75
107012762,107011699,107020144,8445,3611,75
107025371,107024091,107033070,8979,3612,75
107038187,107037124,107045254,8130,3613,75
107050327,107049264,107057077,7813,3614,75
107062188,107061126,107070859,9733,3615,75
107075960,107074897,107082394,7497,3616,75
107087512,107086449,107094579,8130,3617,75
107099667,107098605,107108020,9415,3618,75
107113247,107111967,107120314,8347,3619,75
107125398,107124334,107133097,8763,3620,75
107138175,107137112,107146191,9079,3621,75
107151201,107150138,107160858,10720,3622,75
107166173,107164894,107173557,8663,3623,75
107178693,107177630,107185760,8130,3624,75
107190770,107189707,107198507,8800,3625,75
107203594,107202531,107210344,7813,3626,75
107215420,107214357,107222803,8446,3627,75
107227928,107226865,107234995,8130,3628,75
107240005,107238942,107248575,9633,3629,75
107253655,107252591,107261355,8764,3630,75
107266426,107265363,107274780,9417,3631,75
107280007,107278727,107287707,8980,3632,75
107292783,107291720,107299216,7496,3633,75
107304293,107303230,107310727,7497,3634,75
107315953,107314674,107323020,8346,3635,75
107328029,107326967,107337052,10085,3636,75
107342213,107341150,107348647,7497,3637,75
107353874,107352594,107360307,7713,3638,75
107365365,107364302,107373719,9417,3639,75
107378822,107377759,107387493,9734,3640,75
107392580,107391516,107399329,7813,3641,75
107404555,107403276,107412255,8979,3642,75
107417326,107416263,107425997,9734,3643,75
107431115,107430052,107439470,9418,3644,75
107444697,107443417,107452396,8979,3645,75
107457406,107456343,107464193,7850,3646,75
107469202,107468140,107476623,8483,3647,75
107481714,107480651,107489097,8446,3648,75
107494217,107493154,107500968,7814,3649,75
107506098,107505035,107513165,8130,3650,75
107518286,107517223,107524719,7496,3651,75
107529728,107528666,107536830,8164,3652,75
107541923,107540860,107548672,7812,3653,75
107553773,107552710,107561156,8446,3654,75
107566383,107565103,107574736,9633,3655,75
107579745,107578682,107588114,9432,3656,75
107593340,107592061,107600407,8346,3657,75
107605523,107604460,107613876,9416,3658,75
107618989,107617926,107626055,8129,3659,75
107631180,107630117,107637613,7496,3660,75
107642839,107641560,107651194,9634,3661,75
107656307,107655244,107663690,8446,3662,75
107668776,107667713,107676160,8447,3663,75
107681225,107680162,107689896,9734,3664,75
107694987,107693924,107702687,8763,3665,75
107707914,107706634,107716584,9950,3666,75
107721594,107720531,107729331,8800,3667,75
107734558,107733278,107742912,9634,3668,75
107748029,107746966,107756382,9416,3669,75
107761480,107760417,107769835,9418,3670,75
107774947,107773884,107782647,8763,3671,75
107787873,107786594,107795890,9296,3672,75
107801004,107799941,107809020,9079,3673,75
107814247,107812967,107822264,9297,3674,75
107827367,107826304,107834750,8446,3675,75
107839760,107838697,107848467,9770,3676,75
107853534,107852471,107860600,8129,3677,75
107865737,107864674,107873437,8763,3678,75
107878519,107877457,107886873,9416,3679,75
107891970,107890907,107899669,8762,3680,75
107904679,107903616,107913047,9431,3681,75
107918109,107917046,107925176,8130,3682,75
107930272,107929209,107937655,8446,3683,75
107942775,107941712,107951446,9734,3684,75
107956502,107955439,107963885,8446,3685,75
107968961,107967899,107977315,9416,3686,75
107982542,107981262,107989292,8030,3687,75
107994382,107993319,108001132,7813,3688,75
108006226,108005163,108014896,9733,3689,75
108019999,108018936,108027383,8447,3690,75
108032454,108031392,108040154,8762,3691,75
108045258,108044195,108051692,7497,3692,75
108056803,108055740,108065157,9417,3693,75
108070250,108069187,108078265,9078,3694,75
108083491,108082212,108091508,9296,3695,75
108096518,108095455,108104254,8799,3696,75
108109337,108108274,108116720,8446,3697,75
108121792,108120729,108129174,8445,3698,75
108134271,108133208,108142942,9734,3699,75
108148043,108146980,108155743,8763,3700,75
108160970,108159690,108168353,8663,3701,75
108173455,108172393,108181155,8762,3702,75
108186165,108185102,108192951,7849,3703,75
108198086,108197023,108205785,8762,3704,75
108210876,108209813,108219546,9733,3705,75
108224610,108223547,108231676,8129,3706,75
108236738,108235675,108243487,7812,3707,75
108248497,108247434,108256730,9296,3708,75
108261740,108260677,108269995,9318,3709,75
108275100,108274038,108283771,9733,3710,75
108288844,108287781,108296882,9101,3711,75
108301950,108300888,108309334,8446,3712,75
108314412,108313350,108323082,9732,3713,75
108328308,108327029,108336007,8978,3714,75
108341101,108340038,108347852,7814,3715,75
108352913,108351850,108360297,8447,3716,75
108365523,108364244,108374194,9950,3717,75
108379253,108378191,108387606,9415,3718,75
108392700,108391637,108401370,9733,3719,75
108406478,108405415,108413229,7814,3720,75
108418322,108417259,108425389,8130,3721,75
108430495,108429433,108438512,9079,3722,75
108443522,108442459,108450488,8029,3723,75
108455498,108454435,108464205,9770,3724,75
108469432,108468152,108478103,9951,3725,75
108483330,108482050,108489763,7713,3726,75
108494875,108493812,108501625,7813,3727,75
108506728,108505664,108514766,9102,3728,75
108519903,108518840,108526970,8130,3729,75
108532045,108530982,108539112,8130,3730,75
108544212,108543149,108552229,9080,3731,75
108557361,108556298,108564745,8447,3732,75
108569754,108568692,108577806,9114,3733,75
108582902,108581839,108590286,8447,3734,75
108595343,108594280,108602410,8130,3735,75
108607497,108606434,108616168,9734,3736,75
108621178,108620115,108629865,9750,3737,75
108635005,108633942,108641756,7814,3738,75
108646842,108645779,108654880,9101,3739,75
108659956,108658893,108667973,9080,3740,75
108673199,108671920,108679633,7713,3741,75
108684759,108683696,108691510,7814,3742,75
108696592,108695529,108703658,8129,3743,75
108708723,108707660,108716760,9100,3744,75
108721987,108720707,108729687,8980,3745,75
108734914,108733634,108741664,8030,3746,75
108746773,108745710,108755444,9734,3747,75
108760670,108759391,108767104,7713,3748,75
108772113,108771051,108779850,8799,3749,75
108784860,108783797,108793884,10087,3750,75
108799200,108797920,108806266,8346,3751,75
108811359,108810296,108818109,7813,3752,75
108823335,108822055,108831352,9297,3753,75
108836465,108835402,108845136,9734,3754,75
108850362,108849083,108857111,8028,3755,75
108862337,108861058,108868770,7712,3756,75
108873868,108872805,108882222,9417,3757,75
108887315,108886253,108894699,8446,3758,75
108899926,108898646,108907310,8664,3759,75
108912391,108911328,108919775,8447,3760,75
108925001,108923722,108932067,8345,3761,75
108937293,108936014,108945308,9294,3762,75
108950406,108949342,108957473,8131,3763,75
108962699,108961420,108971370,9950,3764,75
108976596,108975317,108983980,8663,3765,75
108989082,108988019,108997436,9417,3766,75
109002663,109001383,109011018,9635,3767,75
109016107,109015045,109023489,8444,3768,75
109028543,109027480,109034977,7497,3769,75
109040042,109038979,109048396,9417,3770,75
109053495,109052432,109061532,9100,3771,75
109066759,109065479,109075113,9634,3772,75
109080185,109079122,109086934,7812,3773,75
109092021,109090958,109100692,9734,3774,75
109105750,109104687,109112501,7814,3775,75
109117581,109116518,109124015,7497,3776,75
109129025,109127962,109137278,9316,3777,75
109142505,109141225,109149254,8029,3778,75
109154315,109153252,109161699,8447,3779,75
109166925,109165646,109175279,9633,3780,75
109180506,109179226,109189177,9951,3781,75
109194186,109193124,109202556,9432,3782,75
109207677,109206614,109214744,8130,3783,75
109219754,109218691,109226403,7712,3784,75
109231484,109230421,109239501,9080,3785,75
109244727,109243448,109252744,9296,3786,75
109257971,109256691,109265038,8347,3787,75
109270103,109269040,109278457,9417,3788,75
109283683,109282404,109290750,8346,3789,75
109295976,109294697,109302726,8029,3790,75
109307807,109306744,109315845,9101,3791,75
109320956,109319893,109328023,8130,3792,75
109333155,109332093,109340854,8761,3793,75
109345989,109344925,109354027,9102,3794,75
109359121,109358058,109366504,8446,3795,75
109371514,109370451,109381171,10720,3796,75
109386366,109385303,109393750,8447,3797,75
109398977,109397697,109407332,9635,3798,75
109412392,109411328,109421063,9735,3799,75
109426142,109425079,109434495,9416,3800,75
109439557,109438494,109446624,8130,3801,75
109451850,109450571,109458284,7713,3802,75
109463294,109462231,109470079,7848,3803,75
109475305,109474026,109482688,8662,3804,75
109487915,109486635,109494349,7714,3805,75
109499435,109498372,109507452,9080,3806,75
109512462,109511399,109522119,10720,3807,75
109527294,109526231,109534045,7814,3808,75
109539056,109537993,109546159,8166,3809,75
109551227,109550165,109557661,7496,3810,75
109562747,109561684,109570131,8447,3811,75
109575228,109574164,109583582,9418,3812,75
109588809,109587529,109596509,8980,3813,75
109601735,109600456,109609750,9294,3814,75
109614833,109613770,109623187,9417,3815,75
109628197,109627134,109636884,9750,3816,75
109642111,109640831,109650466,9635,3817,75
109655563,109654499,109663263,8764,3818,75
109668272,109667210,109677929,10719,3819,75
109683108,109682045,109690492,8447,3820,75
109695574,109694511,109702325,7814,3821,75
109707398,109706335,109715415,9080,3822,75
109720517,109719454,109727583,8129,3823,75
109732809,109731530,109741162,9632,3824,75
109746389,109745109,109753139,8030,3825,75
109758366,109757086,109766721,9635,3826,75
109771730,109770668,109779149,8481,3827,75
109784375,109783096,109790809,7713,3828,75
109795819,109794756,109804390,9634,3829,75
109809514,109808451,109818185,9734,3830,75
109823278,109822215,109831632,9417,3831,75
109836746,109835683,109845417,9734,3832,75
109850527,109849464,109858880,9416,3833,75
109863965,109862903,109870399,7496,3834,75
109875626,109874346,109882692,8346,3835,75
109887919,109886639,109895619,8980,3836,75
109900846,109899566,109908863,9297,3837,75
109914090,109912810,109921157,8347,3838,75
109926253,109925191,109934924,9733,3839,75
109940042,109938979,109947741,8762,3840,75
109952968,109951688,109961322,9634,3841,75
109966332,109965269,109973118,7849,3842,75
109978344,109977065,109986698,9633,3843,75
109991789,109990726,109998222,7496,3844,75
110003232,110002169,110011284,9115,3845,75
110016365,110015302,110025036,9734,3846,75
110030169,110029107,110037235,8128,3847,75
110042360,110041298,110049427,8129,3848,75
110054437,110053374,110062173,8799,3849,75
110067399,110066120,110073832,7712,3850,75
110078843,110077780,110087414,9634,3851,75
110092502,110091439,110100856,9417,3852,75
110105953,110104890,110113970,9080,3853,75
110119060,110117997,110126127,8130,3854,75
110131254,110130192,110138637,8445,3855,75
110143864,110142584,110151564,8980,3856,75
110156656,110155593,110163406,7813,3857,75
110168509,110167446,110176863,9417,3858,75
110181955,110180892,110189655,8763,3859,75
110194882,110193602,110201315,7713,3860,75
110206542,110205262,110212976,7714,3861,75
110218203,110216923,110224637,7714,3862,75
110229720,110228657,110236154,7497,3863,75
110241164,110240101,110247635,7534,3864,75
110252749,110251686,110261103,9417,3865,75
110266329,110265050,110273713,8663,3866,75
110278773,110277711,110286790,9079,3867,75
110292016,110290737,110299716,8979,3868,75
110304800,110303738,110312500,8762,3869,75
110317623,110316560,110325322,8762,3870,75
110330452,110329389,110337519,8130,3871,75
110342745,110341466,110349495,8029,3872,75
110354505,110353442,110363529,10087,3873,75
110368700,110367637,110375450,7813,3874,75
110380569,110379506,110388585,9079,3875,75
110393812,110392532,110402483,9951,3876,75
110407492,110406430,110416811,10381,3877,75
110422127,110420847,110429511,8664,3878,75
110434522,110433458,110441287,7829,3879,75
110446396,110445333,110453146,7813,3880,75
110458201,110457138,110465900,8762,3881,75
110471023,110469960,110479377,9417,3882,75
110484603,110483324,110493274,9950,3883,75
110498376,110497313,110506076,8763,3884,75
110511181,110510118,110517932,7814,3885,75
110523068,110522005,110530768,8763,3886,75
110535849,110534786,110544204,9418,3887,75
110549281,110548218,110557297,9079,3888,75
110562392,110561329,110569459,8130,3889,75
110574686,110573406,110582070,8664,3890,75
110587160,110586097,110593909,7812,3891,75
110599008,110597945,110607362,9417,3892,75
110612436,110611373,110620136,8763,3893,75
110625362,110624083,110631795,7712,3894,75
110636873,110635810,110643623,7813,3895,75
110648698,110647635,110656714,9079,3896,75
110661814,110660751,110670484,9733,3897,75
110675582,110674519,110684253,9734,3898,75
110689361,110688298,110697377,9079,3899,75
110702452,110701390,110710152,8762,3900,75
110715259,110714196,110722009,7813,3901,75
110727236,110725956,110735906,9950,3902,75
110740969,110739906,110748035,8129,3903,75
110753139,110752075,110760521,8446,3904,75
110765531,110764468,110772814,8346,3905,75
110778040,110776761,110786057,9296,3906,75
110791283,110790004,110799638,9634,3907,75
110804701,110803638,110811450,7812,3908,75
110816676,110815397,110823743,8346,3909,75
110828969,110827690,110837322,9632,3910,75
110842332,110841269,110851219,9950,3911,75
110856294,110855232,110863994,8762,3912,75
110869004,110867941,110877374,9433,3913,75
110882466,110881403,110890799,9396,3914,75
110895853,110894791,110903553,8762,3915,75
110908620,110907557,110915054,7497,3916,75
110920109,110919047,110926858,7811,3917,75
110931967,110930904,110939983,9079,3918,75
110944993,110943930,110953226,9296,3919,75
110958303,110957240,110965053,7813,3920,75
110970125,110969061,110976876,7815,3921,75
110981886,110980823,110989802,8979,3922,75
110994912,110993850,111003583,9733,3923,75
111008593,111007530,111017596,10066,3924,75
111022824,111021761,111031178,9417,3925,75
111036286,111035223,111044640,9417,3926,75
111049728,111048665,111058083,9418,3927,75
111063166,111062103,111070550,8447,3928,75
111075777,111074497,111083477,8980,3929,75
111088557,111087494,111094991,7497,3930,75
111100104,111099041,111106855,7814,3931,75
111111940,111110877,111120610,9733,3932,75
111125695,111124632,111132761,8129,3933,75
111137988,111136708,111144737,8029,3934,75
111149747,111148684,111156217,7533,3935,75
111161333,111160271,111169350,9079,3936,75
111174577,111173297,111183248,9951,3937,75
111188475,111187195,111195225,8030,3938,75
111200290,111199227,111208644,9417,3939,75
111213654,111212591,111222340,9749,3940,75
111227432,111226369,111234499,8130,3941,75
111239602,111238539,111248273,9734,3942,75
111253283,111252220,111260048,7828,3943,75
111265122,111264059,111271872,7813,3944,75
111276940,111275877,111284640,8763,3945,75
111289718,111288656,111297101,8445,3946,75
111302157,111301093,111309541,8448,3947,75
111314625,111313562,111321374,7812,3948,75
111326384,111325321,111333667,8346,3949,75
111338772,111337710,111347443,9733,3950,75
111352504,111351441,111360203,8762,3951,75
111365430,111364150,111372497,8347,3952,75
111377606,111376543,111385960,9417,3953,75
111390969,111389907,111399971,10064,3954,75
111405287,111404007,111412038,8031,3955,75
111417265,111415985,111424332,8347,3956,75
111429434,111428371,111435867,7496,3957,75
111440877,111439814,111447980,8166,3958,75
111453207,111451927,111459640,7713,3959,75
111464750,111463687,111472450,8763,3960,75
111477461,111476397,111484428,8031,3961,75
111489505,111488442,111497520,9078,3962,75
111502611,111501548,111510311,8763,3963,75
111515320,111514258,111524006,9748,3964,75
111529116,111528053,111537787,9734,3965,75
111543014,111541734,111550080,8346,3966,75
111555308,111554027,111563661,9634,3967,75
111568752,111567689,111575818,8129,3968,75
111580914,111579851,111589268,9417,3969,75
111594378,111593315,111609212,15897,3970,75
111614403,111613340,111621153,7813,3971,75
111626255,111625191,111634271,9080,3972,75
111639390,111638327,111646141,7814,3973,75
111651215,111650153,111659886,9733,3974,75
111664997,111663934,111672063,8129,3975,75
111677189,111676127,111685543,9416,3976,75
111690552,111689490,111698152,8662,3977,75
111703379,111702099,111712050,9951,3978,75
111717150,111716087,111725504,9417,3979,75
111730730,111729451,111737164,7713,3980,75
111742174,111741111,111749911,8800,3981,75
111755013,111753950,111762396,8446,3982,75
111767623,111766343,111775323,8980,3983,75
111780550,111779270,111786984,7714,3984,75
111792210,111790931,111799593,8662,3985,75
111804820,111803540,111813491,9951,3986,75
111818547,111817484,111825930,8446,3987,75
111831156,111829877,111839173,9296,3988,75
111844282,111843219,111850716,7497,3989,75
111855943,111854663,111863959,9296,3990,75
111869051,111867988,111876118,8130,3991,75
111881243,111880180,111887993,7813,3992,75
111893123,111892060,111901477,9417,3993,75
111906487,111905424,111914855,9431,3994,75
111920081,111918802,111928434,9632,3995,75
111933511,111932448,111940261,7813,3996,75
111945324,111944261,111951758,7497,3997,75
111956768,111955705,111963872,8167,3998,75
111969098,111967819,111975848,8029,3999,75
111981075,111979795,111988458,8663,4000,75
111993558,111992495,112000942,8447,4001,75
112006057,112004994,112013441,8447,4002,75
112018542,112017479,112026241,8762,4003,75
112031251,112030188,112038037,7849,4004,75
112043113,112042050,112049863,7813,4005,75
112054927,112053864,112063597,9733,4006,75
112068688,112067626,112077359,9733,4007,75
112082496,112081433,112088930,7497,4008,75
112093940,112092877,112101044,8167,4009,75
112106167,112105104,112113551,8447,4010,75
112118688,112117625,112126388,8763,4011,75
112131478,112130415,112138227,7812,4012,75
112143454,112142174,112151808,9634,4013,75
112157035,112155755,112164419,8664,4014,75
112169547,112168484,112176931,8447,4015,75
112182032,112180969,112190703,9734,4016,75
112195809,112194746,112203193,8447,4017,75
112208261,112207198,112215012,7814,4018,75
112220238,112218959,112227621,8662,4019,75
112232847,112231568,112240863,9295,4020,75
112246090,112244810,112254444,9634,4021,75
112259549,112258486,112266300,7814,4022,75
112271385,112270322,112279402,9080,4023,75
112284629,112283349,112291378,8029,4024,75
112296605,112295325,112305276,9951,4025,75
112310352,112309289,112317735,8446,4026,75
112322820,112321757,112331174,9417,4027,75
112336275,112335212,112344946,9734,4028,75
112350084,112349022,112358755,9733,4029,75
112363892,112362830,112370959,8129,4030,75
112376185,112374906,112384539,9633,4031,75
112389549,112388486,112397602,9116,4032,75
112402612,112401549,112409083,7534,4033,75
112414093,112413030,112421060,8030,4034,75
112426286,112425007,112433986,8979,4035,75
112439115,112438052,112447469,9417,4036,75
112452696,112451416,112460713,9297,4037,75
112465786,112464723,112473485,8762,4038,75
112478712,112477432,112486729,9297,4039,75
112491809,112490746,112498560,7814,4040,75
112503787,112502507,112510538,8031,4041,75
112515765,112514485,112523465,8980,4042,75
112528573,112527510,112536273,8763,4043,75
112541333,112540270,112548400,8130,4044,75
112553627,112552347,112560378,8031,4045,75
112565490,112564427,112572874,8447,4046,75
112578101,112576821,112584535,7714,4047,75
112589619,112588557,112597974,9417,4048,75
112602984,112601921,112611217,9296,4049,75
112616328,112615266,112623079,7813,4050,75
112628138,112627075,112635205,8130,4051,75
112640432,112639152,112647181,8029,4052,75
112652318,112651255,112660989,9734,4053,75
112666127,112665064,112673511,8447,4054,75
112678574,112677511,112686273,8762,4055,75
112691499,112690220,112698566,8346,4056,75
112703576,112702513,112713550,11037,4057,75
112718699,112717636,112725766,8130,4058,75
112730829,112729766,112738211,8445,4059,75
112743221,112742158,112750504,8346,4060,75
112755731,112754451,112763115,8664,4061,75
112768214,112767152,112776883,9731,4062,75
112782109,112780830,112790780,9950,4063,75
112796006,112794727,112804360,9633,4064,75
112809437,112808374,112815871,7497,4065,75
112820881,112819818,112827532,7714,4066,75
112832664,112831601,112840681,9080,4067,75
112845789,112844726,112852223,7497,4068,75
112857450,112856170,112864199,8029,4069,75
112869304,112868241,112877659,9418,4070,75
112882734,112881671,112889168,7497,4071,75
112894395,112893115,112902095,8980,4072,75
112907223,112906160,112914605,8445,4073,75
112919659,112918597,112927043,8446,4074,75
112932142,112931079,112938576,7497,4075,75
112943668,112942605,112951685,9080,4076,75
112956912,112955632,112963663,8031,4077,75
112968673,112967610,112978646,11036,4078,75
112983797,112982734,112990864,8130,4079,75
112996090,112994811,113002839,8028,4080,75
113007943,113006880,113015010,8130,4081,75
113020100,113019037,113028771,9734,4082,75
113033781,113032718,113043247,10529,4083,75
113048563,113047283,113054997,7714,4084,75
113060080,113059017,113068097,9080,4085,75
113073155,113072092,113079905,7813,4086,75
113085021,113083958,113093692,9734,4087,75
113098702,113097639,113108040,10401,4088,75
113113354,113112075,113120737,8662,4089,75
113125809,113124746,113133192,8446,4090,75
113138283,113137220,113144716,7496,4091,75
113149789,113148726,113156540,7814,4092,75
113161550,113160487,113169602,9115,4093,75
113174693,113173630,113183047,9417,4094,75
113188112,113187050,113196783,9733,4095,75
113201900,113200837,113209284,8447,4096,75
113214370,113213307,113221754,8447,4097,75
113226857,113225794,113233291,7497,4098,75
113238301,113237238,113246036,8798,4099,75
113251262,113249983,113258644,8661,4100,75
113263701,113262638,113271718,9080,4101,75
113276784,113275721,113285139,9418,4102,75
113290366,113289086,113296799,7713,4103,75
113301901,113300838,113310572,9734,4104,75
113315798,113314519,113323182,8663,4105,75
113328268,113327205,113335968,8763,4106,75
113341041,113339978,113348108,8130,4107,75
113353201,113352138,113359635,7497,4108,75
113364757,113363694,113373427,9733,4109,75
113378527,113377464,113385909,8445,4110,75
113390975,113389913,113397409,7496,4111,75
113402481,113401418,113408915,7497,4112,75
113414004,113412941,113420437,7496,4113,75
113425502,113424439,113433519,9080,4114,75
113438657,113437595,113446041,8446,4115,75
113451051,113449988,113459105,9117,4116,75
113464332,113463052,113472348,9296,4117,75
113477428,113476365,113484494,8129,4118,75
113489551,113488488,113497251,8763,4119,75
113502317,113501253,113510017,8764,4120,75
113515029,113513965,113523081,9116,4121,75
113528162,113527099,113536516,9417,4122,75
113541743,113540463,113549442,8979,4123,75
113554510,113553447,113561577,8130,4124,75
113566803,113565524,113573869,8345,4125,75
113579095,113577816,113587766,9950,4126,75
113592900,113591837,113600917,9080,4127,75
113606144,113604864,113613844,8980,4128,75
113619071,113617791,113625505,7714,4129,75
113630598,113629535,113637032,7497,4130,75
113642107,113641044,113650778,9734,4131,75
113656005,113654725,113664676,9951,4132,75
113669903,113668623,113677286,8663,4133,75
113682512,113681233,113689895,8662,4134,75
113695122,113693842,113703137,9295,4135,75
113708147,113707084,113715250,8166,4136,75
113720477,113719197,113727226,8029,4137,75
113732316,113731254,113740333,9079,4138,75
113745560,113744280,113754231,9951,4139,75
113759457,113758178,113766524,8346,4140,75
113771618,113770555,113779973,9418,4141,75
113785090,113784028,113792790,8762,4142,75
113797923,113796860,113805307,8447,4143,75
113810533,113809254,113817600,8346,4144,75
113822723,113821660,113830422,8762,4145,75
113835548,113834486,113842614,8128,4146,75
113847841,113846561,113856196,9635,4147,75
113861206,113860143,113869891,9748,4148,75
113875000,113873937,113883354,9417,4149,75
113888468,113887405,113895219,7814,4150,75
113900304,113899241,113907687,8446,4151,75
113912914,113911634,113919664,8030,4152,75
113924791,113923728,113932491,8763,4153,75
113937605,113936542,113944989,8447,4154,75
113950057,113948994,113956491,7497,4155,75
113961717,113960438,113969101,8663,4156,75
113974181,113973118,113981248,8130,4157,75
113986345,113985282,113995016,9734,4158,75
114000113,113999050,114008784,9734,4159,75
114013890,114012827,114021273,8446,4160,75
114026373,114025310,114032807,7497,4161,75
114037897,114036834,114044963,8129,4162,75
114050084,114049021,114058438,9417,4163,75
114063505,114062442,114070256,7814,4164,75
114075365,114074302,114081798,7496,4165,75
114086808,114085745,114095495,9750,4166,75
114100577,114099514,114109247,9733,4167,75
114114356,114113293,114123027,9734,4168,75
114128082,114127019,114136752,9733,4169,75
114141828,114140766,114148579,7813,4170,75
114153661,114152598,114161678,9080,4171,75
114166734,114165671,114174751,9080,4172,75
114179977,114178698,114186411,7713,4173,75
114191517,114190454,114198901,8447,4174,75
114204010,114202947,114211392,8445,4175,75
114216449,114215387,114223516,8129,4176,75
114228637,114227574,114236021,8447,4177,75
114241120,114240057,114249137,9080,4178,75
114254364,114253084,114263035,9951,4179,75
114268166,114267103,114276520,9417,4180,75
114281747,114280467,114288813,8346,4181,75
114293909,114292846,114301609,8763,4182,75
114306836,114305556,114313587,8031,4183,75
114318683,114317620,114325117,7497,4184,75
114330196,114329133,114336946,7813,4185,75
114342009,114340946,114350364,9418,4186,75
114355590,114354311,114362024,7713,4187,75
114367250,114365971,114374317,8346,4188,75
114379379,114378315,114387395,9080,4189,75
114392476,114391413,114399859,8446,4190,75
114405086,114403806,114413757,9951,4191,75
114418813,114417751,114426830,9079,4192,75
114431933,114430870,114439949,9079,4193,75
114445176,114443896,114452876,8980,4194,75
114457996,114456933,114466349,9416,4195,75
114471577,114470297,114478960,8663,4196,75
114484042,114482979,114492395,9416,4197,75
114497490,114496427,114504557,8130,4198,75
114509633,114508570,114516700,8130,4199,75
114521927,114520647,114530282,9635,4200,75
114535509,114534229,114542893,8664,4201,75
114547904,114546841,114557224,10383,4202,75
114562385,114561322,114570740,9418,4203,75
114575823,114574761,114584178,9417,4204,75
114589249,114588186,114596949,8763,4205,75
114602176,114600896,114609560,8664,4206,75
114614787,114613507,114622487,8980,4207,75
114627550,114626488,114634301,7813,4208,75
114639369,114638306,114647722,9416,4209,75
114652786,114651723,114659537,7814,4210,75
114664612,114663549,114672313,8764,4211,75
114677383,114676320,114685400,9080,4212,75
114690628,114689348,114698011,8663,4213,75
114703021,114701958,114711707,9749,4214,75
114716933,114715654,114723683,8029,4215,75
114728909,114727630,114735343,7713,4216,75
114740570,114739290,114747320,8030,4217,75
114752330,114751267,114759412,8145,4218,75
114764494,114763431,114771877,8446,4219,75
114777104,114775824,114784170,8346,4220,75
114789180,114788117,114797865,9748,4221,75
114803092,114801812,114811108,9296,4222,75
114816186,114815123,114822936,7813,4223,75
114828008,114826945,114836679,9734,4224,75
114841753,114840689,114848503,7814,4225,75
114853513,114852450,114862852,10402,4226,75
114868011,114866948,114876027,9079,4227,75
114881036,114879974,114890354,10380,4228,75
114895524,114894461,114903877,9416,4229,75
114909104,114907824,114916488,8664,4230,75
114921597,114920534,114929613,9079,4231,75
114934623,114933560,114942359,8799,4232,75
114947585,114946306,114954652,8346,4233,75
114959742,114958679,114967759,9080,4234,75
114972986,114971706,114981656,9950,4235,75
114986883,114985603,114995238,9635,4236,75
115000465,114999185,115008165,8980,4237,75
115013256,115012193,115021610,9417,4238,75
115026697,115025634,115033131,7497,4239,75
115038199,115037135,115046215,9080,4240,75
115051292,115050229,115059646,9417,4241,75
115064872,115063593,115073227,9634,4242,75
115078312,115077249,115085695,8446,4243,75
115090811,115089748,115099164,9416,4244,75
115104234,115103171,115112250,9079,4245,75
115117367,115116304,115124118,7814,4246,75
115129210,115128147,115136910,8763,4247,75
115142011,115140948,115149078,8130,4248,75
115154199,115153136,115162554,9418,4249,75
115167657,115166594,115176012,9418,4250,75
115181023,115179960,115189392,9432,4251,75
115194508,115193445,115203178,9733,4252,75
115208238,115207175,115215621,8446,4253,75
115220847,115219568,115227913,8345,4254,75
115233020,115231957,115241374,9417,4255,75
115246385,115245321,115253489,8168,4256,75
115258577,115257515,115266594,9079,4257,75
115271820,115270541,115278253,7712,4258,75
115283365,115282302,115292036,9734,4259,75
115297045,115295983,115304961,8978,4260,75
115310068,115309006,115317134,8128,4261,75
115322226,115321163,115329926,8763,4262,75
115335152,115333873,115342536,8663,4263,75
115347673,115346610,115354740,8130,4264,75
115359966,115358687,115366716,8029,4265,75
115371792,115370729,115378225,7496,4266,75
115383353,115382290,115391707,9417,4267,75
115396827,115395764,115403260,7496,4268,75
115408486,115407207,115416503,9296,4269,75
115421583,115420521,115430253,9732,4270,75
115435480,115434200,115443496,9296,4271,75
115448506,115447443,115456740,9297,4272,75
115461967,115460687,115468717,8030,4273,75
115473726,115472664,115481008,8344,4274,75
115486234,115484955,115493933,8978,4275,75
115499160,115497880,115506226,8346,4276,75
115511453,115510173,115518203,8030,4277,75
115523264,115522201,115530331,8130,4278,75
115535557,115534278,115544228,9950,4279,75
115549364,115548301,115557381,9080,4280,75
115562607,115561328,115569040,7712,4281,75
115574156,115573093,115580589,7496,4282,75
115585815,115584536,115592565,8029,4283,75
115597687,115596624,115605387,8763,4284,75
115610476,115609414,115618830,9416,4285,75
115623840,115622777,115631757,8980,4286,75
115636767,115635704,115645000,9296,4287,75
115650226,115648947,115658580,9633,4288,75
115663695,115662632,115670446,7814,4289,75
115675673,115674393,115682422,8029,4290,75
115687530,115686467,115695230,8763,4291,75
115700315,115699252,115707066,7814,4292,75
115712171,115711108,115719870,8762,4293,75
115725097,115723817,115733114,9297,4294,75
115738239,115737176,115746910,9734,4295,75
115751970,115750907,115759037,8130,4296,75
115764131,115763069,115772484,9415,4297,75
115777614,115776551,115784048,7497,4298,75
115789275,115787995,115796024,8029,4299,75
115801251,115799971,115809922,9951,4300,75
115815030,115813968,115822729,8761,4301,75
115827841,115826778,115834908,8130,4302,75
115840135,115838855,115848805,9950,4303,75
115854032,115852752,115861099,8347,4304,75
115866165,115865103,115872916,7813,4305,75
115878037,115876974,115885737,8763,4306,75
115890963,115889684,115898029,8345,4307,75
115903256,115901976,115909689,7713,4308,75
115914915,115913636,115921982,8346,4309,75
115927208,115925929,115934908,8979,4310,75
115939988,115938926,115947687,8761,4311,75
115952806,115951743,115959873,8130,4312,75
115964959,115963897,115972026,8129,4313,75
115977253,115975973,115984637,8664,4314,75
115989647,115988584,115998016,9432,4315,75
116003111,116002048,116009862,7814,4316,75
116014997,116013934,116022697,8763,4317,75
116027778,116026716,116034528,7812,4318,75
116039593,116038530,116047947,9417,4319,75
116052957,116051894,116059426,7532,4320,75
116064543,116063480,116070977,7497,4321,75
116076048,116074985,116082482,7497,4322,75
116087571,116086508,116094638,8130,4323,75
116099728,116098666,116107427,8761,4324,75
116112653,116111374,116121006,9632,4325,75
116126016,116124953,116134384,9431,4326,75
116139512,116138449,116147865,9416,4327,75
116152936,116151873,116160953,9080,4328,75
116165963,116164900,116174332,9432,4329,75
116179426,116178363,116187781,9418,4330,75
116192885,116191822,116201556,9734,4331,75
116206646,116205583,116214346,8763,4332,75
116219406,116218343,116226156,7813,4333,75
116231268,116230205,116238968,8763,4334,75
116244195,116242915,116250628,7713,4335,75
116255855,116254575,116264210,9635,4336,75
116269276,116268213,116277631,9418,4337,75
116282770,116281707,116290470,8763,4338,75
116295545,116294483,116304215,9732,4339,75
116309344,116308281,116317044,8763,4340,75
116322128,116321065,116328562,7497,4341,75
116333636,116332574,116340069,7495,4342,75
116345079,116344016,116353312,9296,4343,75
116358539,116357259,116365605,8346,4344,75
116370666,116369603,116378049,8446,4345,75
116383275,116381996,116390342,8346,4346,75
116395568,116394289,116402634,8345,4347,75
116407861,116406581,116414612,8031,4348,75
116419839,116418559,116426905,8346,4349,75
116432022,116430959,116438456,7497,4350,75
116443562,116442499,116451917,9418,4351,75
116456927,116455864,116465497,9633,4352,75
116470582,116469519,116477649,8130,4353,75
116482789,116481726,116490172,8446,4354,75
116495398,116494119,116503752,9633,4355,75
116508866,116507803,116517537,9734,4356,75
116522640,116521577,116530994,9417,4357,75
116536221,116534941,116543605,8664,4358,75
116548686,116547623,116556068,8445,4359,75
116561144,116560081,116569161,9080,4360,75
116574223,116573160,116580974,7814,4361,75
116586041,116584978,116593741,8763,4362,75
116598751,116597688,116606351,8663,4363,75
116611442,116610379,116618192,7813,4364,75
116623202,116622139,116630939,8800,4365,75
116635950,116634887,116643053,8166,4366,75
116648146,116647084,116654580,7496,4367,75
116659694,116658631,116667711,9080,4368,75
116672937,116671658,116681291,9633,4369,75
116686360,116685297,116694060,8763,4370,75
116699126,116698064,116707143,9079,4371,75
116712236,116711173,116718986,7813,4372,75
116724043,116722980,116731110,8130,4373,75
116736173,116735110,116742923,7813,4374,75
116747998,116746935,116754748,7813,4375,75
116759818,116758755,116767835,9080,4376,75
116772923,116771860,116780623,8763,4377,75
116785706,116784643,116793723,9080,4378,75
116798784,116797720,116807455,9735,4379,75
116812559,116811497,116820914,9417,4380,75
116825991,116824928,116832740,7812,4381,75
116837967,116836687,116845666,8979,4382,75
116850772,116849709,116859126,9417,4383,75
116864244,116863181,116871944,8763,4384,75
116877171,116875891,116884870,8979,4385,75
116889928,116888865,116898282,9417,4386,75
116903414,116902351,116909848,7497,4387,75
116915075,116913795,116922459,8664,4388,75
116927531,116926468,116935547,9079,4389,75
116940557,116939494,116949445,9951,4390,75
116954520,116953457,116962219,8762,4391,75
116967332,116966269,116974083,7814,4392,75
116979309,116978030,116987324,9294,4393,75
116992409,116991346,116998842,7496,4394,75
117003947,117002884,117010380,7496,4395,75
117015503,117014440,117021936,7496,4396,75
117026946,117025883,117035180,9297,4397,75
117040302,117039239,117048972,9733,4398,75
117054107,117053045,117061490,8445,4399,75
117066591,117065528,117073975,8447,4400,75
117079202,117077922,117086902,8980,4401,75
117092040,117090977,117099106,8129,4402,75
117104219,117103157,117111286,8129,4403,75
117116512,117115233,117122946,7713,4404,75
117128173,117126893,117135239,8346,4405,75
117140249,117139186,117149569,10383,4406,75
117154772,117153709,117162472,8763,4407,75
117167482,117166419,117176370,9951,4408,75
117181494,117180431,117189848,9417,4409,75
117194906,117193843,117202923,9080,4410,75
117208012,117206949,117215079,8130,4411,75
117220306,117219026,117228976,9950,4412,75
117234086,117233023,117241468,8445,4413,75
117246578,117245515,117254595,9080,4414,75
117259714,117258651,117268068,9417,4415,75
117273151,117272088,117280850,8762,4416,75
117285910,117284847,117292976,8129,4417,75
117298041,117296978,117306058,9080,4418,75
117311067,117310005,117319752,9747,4419,75
117324825,117323763,117333179,9416,4420,75
117338319,117337255,117346674,9419,4421,75
117351773,117350710,117359789,9079,4422,75
117364869,117363806,117372253,8447,4423,75
117377339,117376276,117384722,8446,4424,75
117389847,117388783,117396914,8131,4425,75
117402023,117400960,117409090,8130,4426,75
117414183,117413120,117421883,8763,4427,75
117426944,117425882,117433694,7812,4428,75
117438767,117437705,117446150,8445,4429,75
117451378,117450098,117457812,7714,4430,75
117463038,117461759,117471708,9949,4431,75
117476764,117475701,117484464,8763,4432,75
117489576,117488513,117497276,8763,4433,75
117502502,117501223,117508935,7712,4434,75
117514001,117512938,117522356,9418,4435,75
117527367,117526304,117535283,8979,4436,75
117540509,117539230,117548526,9296,4437,75
117553754,117552474,117560188,7714,4438,75
117565274,117564212,117572658,8446,4439,75
117577726,117576664,117586396,9732,4440,75
117591624,117590343,117598373,8030,4441,75
117603493,117602431,117611848,9417,4442,75
117616918,117615855,117624301,8446,4443,75
117629413,117628351,117638084,9733,4444,75
117643311,117642031,117650062,8031,4445,75
117655164,117654101,117661915,7814,4446,75
117667000,117665937,117675017,9080,4447,75
117680244,117678964,117688915,9951,4448,75
117693924,117692862,117701977,9115,4449,75
117706987,117705924,117716961,11037,4450,75
117722142,117721079,117729842,8763,4451,75
117734976,117733913,117742676,8763,4452,75
117747802,117746739,117756157,9418,4453,75
117761168,117760105,117768270,8165,4454,75
117773497,117772217,117781514,9297,4455,75
117786741,117785461,117794758,9297,4456,75
117799885,117798822,117807268,8446,4457,75
117812367,117811304,117819434,8130,4458,75
117824526,117823463,117830960,7497,4459,75
117836086,117835023,117843786,8763,4460,75
117848868,117847805,117857222,9417,4461,75
117862281,117861218,117869981,8763,4462,75
117875087,117874024,117881838,7814,4463,75
117886896,117885833,117895251,9418,4464,75
117900478,117899198,117908177,8979,4465,75
117913306,117912243,117920373,8130,4466,75
117925600,117924320,117934271,9951,4467,75
117939341,117938278,117946408,8130,4468,75
117951634,117950355,117958068,7713,4469,75
117963143,117962080,117971814,9734,4470,75
117976888,117975825,117983321,7496,4471,75
117988415,117987352,117995797,8445,4472,75
118001024,117999744,118008406,8662,4473,75
118013480,118012417,118021179,8762,4474,75
118026189,118025126,118034559,9433,4475,75
118039785,118038506,118046852,8346,4476,75
118051943,118050880,118060297,9417,4477,75
118065367,118064304,118072751,8447,4478,75
118077846,118076783,118085546,8763,4479,75
118090641,118089579,118098658,9079,4480,75
118103667,118102605,118112036,9431,4481,75
118117114,118116052,118123548,7496,4482,75
118128626,118127564,118136009,8445,4483,75
118141019,118139956,118148755,8799,4484,75
118153837,118152775,118162190,9415,4485,75
118167416,118166137,118175769,9632,4486,75
118180870,118179807,118189224,9417,4487,75
118194311,118193248,118202982,9734,4488,75
118208082,118207019,118214515,7496,4489,75
118219742,118218462,118227759,9297,4490,75
118232769,118231706,118241455,9749,4491,75
118246682,118245402,118254064,8662,4492,75
118259202,118258140,118266585,8445,4493,75
118271685,118270622,118279702,9080,4494,75
118284928,118283649,118291679,8030,4495,75
118296769,118295706,118303203,7497,4496,75
118308265,118307202,118316936,9734,4497,75
118322010,118320947,118328444,7497,4498,75
118333542,118332479,118340926,8447,4499,75
118346030,118344967,118352781,7814,4500,75
118358007,118356728,118366024,9296,4501,75
118371251,118369971,118378951,8980,4502,75
118384024,118382961,118390773,7812,4503,75
118395885,118394822,118403901,9079,4504,75
118409009,118407946,118417025,9079,4505,75
118422251,118420972,118430922,9950,4506,75
118436052,118434989,118444722,9733,4507,75
118449779,118448716,118457479,8763,4508,75
118462706,118461426,118469772,8346,4509,75
118474867,118473804,118481934,8130,4510,75
118487047,118485984,118494430,8446,4511,75
118499489,118498426,118505923,7497,4512,75
118511149,118509870,118518215,8345,4513,75
118523441,118522162,118531140,8978,4514,75
118536198,118535135,118542948,7813,4515,75
118548027,118546964,118555727,8763,4516,75
118560830,118559767,118567264,7497,4517,75
118572327,118571264,118579076,7812,4518,75
118584201,118583139,118592555,9416,4519,75
118597673,118596611,118604740,8129,4520,75
118609967,118608687,118617034,8347,4521,75
118622132,118621069,118628883,7814,4522,75
118633975,118632913,118641991,9078,4523,75
118647218,118645938,118654918,8980,4524,75
118660145,118658865,118668816,9951,4525,75
118673826,118672763,118682513,9750,4526,75
118687649,118686587,118695033,8446,4527,75
118700124,118699061,118708478,9417,4528,75
118713574,118712512,118720324,7812,4529,75
118725387,118724324,118733742,9418,4530,75
118738838,118737775,118747192,9417,4531,75
118752419,118751139,118759803,8664,4532,75
118765030,118763750,118773384,9634,4533,75
118778468,118777406,118786485,9079,4534,75
118791712,118790432,118798461,8029,4535,75
118803563,118802499,118812234,9735,4536,75
118817321,118816258,118825674,9416,4537,75
118830762,118829699,118838779,9080,4538,75
118843863,118842800,118850613,7813,4539,75
118855723,118854660,118862157,7497,4540,75
118867245,118866182,118873679,7497,4541,75
118878905,118877626,118885338,7712,4542,75
118890416,118889353,118897165,7812,4543,75
118902175,118901112,118908825,7713,4544,75
118914051,118912772,118920802,8030,4545,75
118926028,118924749,118933728,8979,4546,75
118938954,118937675,118946654,8979,4547,75
118951880,118950601,118958947,8346,4548,75
118964038,118962975,118971104,8129,4549,75
118976331,118975051,118983398,8347,4550,75
118988483,118987420,118995550,8130,4551,75
119000776,118999497,119009131,9634,4552,75
119014229,119013167,119021929,8762,4553,75
119027030,119025967,119034731,8764,4554,75
119039958,119038679,119048313,9634,4555,75
119053403,119052341,119061758,9417,4556,75
119066985,119065705,119074369,8664,4557,75
119079469,119078406,119086853,8447,4558,75
119091942,119090879,119100296,9417,4559,75
119105361,119104298,119112110,7812,4560,75
119117227,119116164,119125580,9416,4561,75
119130693,119129630,119139364,9734,4562,75
119144429,119143367,119150863,7496,4563,75
119155991,119154928,119164661,9733,4564,75
119169888,119168608,119176955,8347,4565,75
119182042,119180979,119189426,8447,4566,75
119194530,119193467,119200963,7496,4567,75
119206082,119205020,119214753,9733,4568,75
119219813,119218750,119226880,8130,4569,75
119232107,119230827,119238541,7714,4570,75
119243637,119242574,119250386,7812,4571,75
119255396,119254333,119264715,10382,4572,75
119270030,119268751,119277729,8978,4573,75
119282955,119281676,119289388,7712,4574,75
119294500,119293437,119300934,7497,4575,75
119306056,119304992,119312807,7815,4576,75
119317817,119316754,119325871,9117,4577,75
119330979,119329916,119339333,9417,4578,75
119344560,119343280,119352913,9633,4579,75
119358016,119356953,119365715,8762,4580,75
119370849,119369787,119377283,7496,4581,75
119382353,119381290,119389736,8446,4582,75
119394746,119393683,119404402,10719,4583,75
119409559,119408497,119416626,8129,4584,75
119421636,119420573,119428740,8167,4585,75
119433829,119432766,119441528,8762,4586,75
119446755,119445475,119455109,9634,4587,75
119460226,119459163,119467293,8130,4588,75
119472377,119471314,119479128,7814,4589,75
119484211,119483149,119491911,8762,4590,75
119497028,119495965,119503778,7813,4591,75
119508909,119507846,119516292,8446,4592,75
119521391,119520328,119530061,9733,4593,75
119535151,119534088,119543505,9417,4594,75
119548604,119547541,119555355,7814,4595,75
119560455,119559392,119568155,8763,4596,75
119573381,119572102,119581398,9296,4597,75
119586491,119585427,119594508,9081,4598,75
119599518,119598455,119607572,9117,4599,75
119612635,119611572,119619702,8130,4600,75
119624810,119623747,119631560,7813,4601,75
119636623,119635560,119643689,8129,4602,75
119648790,119647727,119655540,7813,4603,75
119660641,119659578,119668025,8447,4604,75
119673035,119671972,119682037,10065,4605,75
119687189,119686125,119695206,9081,4606,75
119700311,119699249,119707695,8446,4607,75
119712800,119711737,119720183,8446,4608,75
119725193,119724130,119733426,9296,4609,75
119738558,119737495,119745941,8446,4610,75
119751168,119749888,119758235,8347,4611,75
119763313,119762250,119770695,8445,4612,75
119775773,119774710,119782523,7813,4613,75
119787606,119786543,119795960,9417,4614,75
119801083,119800021,119808149,8128,4615,75
119813375,119812096,119819808,7712,4616,75
119825034,119823755,119833705,9950,4617,75
119838931,119837652,119845682,8030,4618,75
119850796,119849733,119858496,8763,4619,75
119863636,119862573,119870069,7496,4620,75
119875177,119874115,119883194,9079,4621,75
119888259,119887196,119896276,9080,4622,75
119901339,119900276,119908405,8129,4623,75
119913508,119912444,119921862,9418,4624,75
119926983,119925920,119933734,7814,4625,75
119938790,119937727,119947144,9417,4626,75
119952153,119951091,119959753,8662,4627,75
119964980,119963701,119972364,8663,4628,75
119977452,119976388,119985469,9081,4629,75
119990479,119989416,119997763,8347,4630,75
120002773,120001710,120010509,8799,4631,75
120015735,120014456,120024406,9950,4632,75
120029505,120028442,120036572,8130,4633,75
120041582,120040519,120049951,9432,4634,75
120055062,120053999,120061813,7814,4635,75
120066903,120065840,120073970,8130,4636,75
120078980,120077917,120086717,8800,4637,75
120091848,120090785,120100519,9734,4638,75
120105654,120104591,120114325,9734,4639,75
120119463,120118400,120127480,9080,4640,75
120132552,120131489,120139302,7813,4641,75
120144373,120143310,120151440,8130,4642,75
120156496,120155434,120163563,8129,4643,75
120168666,120167603,120175417,7814,4644,75
120180503,120179440,120187570,8130,4645,75
120192670,120191607,120200054,8447,4646,75
120205165,120204102,120212865,8763,4647,75
120218002,120216940,120225701,8761,4648,75
120230791,120229728,120237542,7814,4649,75
120242652,120241589,120251007,9418,4650,75
120256072,120255009,120264743,9734,4651,75
120269753,120268690,120278439,9749,4652,75
120283666,120282386,120290733,8347,4653,75
120295743,120294680,120303027,8347,4654,75
120308085,120307022,120314836,7814,4655,75
120319905,120318842,120326973,8131,4656,75
120332200,120330920,120340217,9297,4657,75
120345444,120344164,120352194,8030,4658,75
120357204,120356141,120364307,8166,4659,75
120369534,120368254,120378204,9950,4660,75
120383308,120382245,120390058,7813,4661,75
120395161,120394098,120403176,9078,4662,75
120408187,120407124,120415290,8166,4663,75
120420387,120419324,120428087,8763,4664,75
120433314,120432034,120441331,9297,4665,75
120446341,120445278,120453309,8031,4666,75
120458535,120457256,120464969,7713,4667,75
120470065,120469002,120478735,9733,4668,75
120483962,120482682,120490713,8031,4669,75
120495814,120494752,120504167,9415,4670,75
120509278,120508215,120517295,9080,4671,75
120522522,120521242,120530539,9297,4672,75
120535646,120534583,120544001,9418,4673,75
120549074,120548011,120556141,8130,4674,75
120561232,120560170,120567983,7813,4675,75
120573047,120571984,120580747,8763,4676,75
120585813,120584750,120593197,8447,4677,75
120598424,120597145,120607094,9949,4678,75
120612219,120611156,120619286,8130,4679,75
120624398,120623335,120631149,7814,4680,75
120636251,120635189,120643002,7813,4681,75
120648138,120647075,120654888,7813,4682,75
120660115,120658835,120667499,8664,4683,75
120672509,120671447,120679295,7848,4684,75
120684373,120683310,120693043,9733,4685,75
120698111,120697048,120706128,9080,4686,75
120711214,120710151,120718913,8762,4687,75
120723981,120722918,120731681,8763,4688,75
120736765,120735702,120745436,9734,4689,75
120750503,120749440,120756937,7497,4690,75
120761947,120760884,120771583,10699,4691,75
120776898,120775619,120785253,9634,4692,75
120790480,120789201,120798497,9296,4693,75
120803507,120802444,120811876,9432,4694,75
120817015,120815952,120825685,9733,4695,75
120830788,120829725,120837222,7497,4696,75
120842286,120841222,120850640,9418,4697,75
120855777,120854714,120862210,7496,4698,75
120867300,120866237,120874367,8130,4699,75
120879430,120878367,120886180,7813,4700,75
120891242,120890179,120899259,9080,4701,75
120904486,120903206,120911869,8663,4702,75
120916976,120915914,120925647,9733,4703,75
120930787,120929724,120937853,8129,4704,75
120943080,120941800,120953653,11853,4705,75
120958883,120957820,120967237,9417,4706,75
120972463,120971184,120980479,9295,4707,75
120985536,120984473,120992602,8129,4708,75
120997611,120996549,121005981,9432,4709,75
121011081,121010018,121019435,9417,4710,75
121024662,121023383,121031096,7713,4711,75
121036105,121035043,121045108,10065,4712,75
121050260,121049197,121056693,7496,4713,75
121061779,121060716,121068530,7814,4714,75
121073602,121072539,121080036,7497,4715,75
121085105,121084043,121091539,7496,4716,75
121096622,121095558,121103689,8131,4717,75
121108916,121107636,121117586,9950,4718,75
121122813,121121534,121129247,7713,4719,75
121134368,121133305,121143039,9734,4720,75
121148141,121147078,121156158,9080,4721,75
121161385,121160105,121168768,8663,4722,75
121173884,121172820,121180318,7498,4723,75
121185435,121184373,121192817,8444,4724,75
121197913,121196850,121204980,8130,4725,75
121210093,121209031,121217160,8129,4726,75
121222255,121221192,121230610,9418,4727,75
121235678,121234615,121243378,8763,4728,75
121248447,121247384,121255831,8447,4729,75
121260959,121259896,121268342,8446,4730,75
121273569,121272289,121282240,9951,4731,75
121287466,121286187,121294850,8663,4732,75
121299939,121298876,121306690,7814,4733,75
121311916,121310637,121319933,9296,4734,75
121325066,121324003,121332450,8447,4735,75
121337460,121336397,121346462,10065,4736,75
121351617,121350554,121358366,7812,4737,75
121363592,121362313,121370343,8030,4738,75
121375415,121374352,121383431,9079,4739,75
121388517,121387454,121395900,8446,4740,75
121401017,121399953,121418235,18282,4741,75
121423335,121422272,121432886,10614,4742,75
121438201,121436922,121445267,8345,4743,75
121450276,121449214,121458847,9633,4744,75
121463924,121462862,121472595,9733,4745,75
121477659,121476596,121486330,9734,4746,75
121491399,121490336,121498783,8447,4747,75
121503793,121502730,121510444,7714,4748,75
121515671,121514391,121522105,7714,4749,75
121527116,121526053,121534083,8030,4750,75
121539205,121538142,121547876,9734,4751,75
121552886,121551823,121562205,10382,4752,75
121567363,121566300,121575063,8763,4753,75
121580074,121579011,121588760,9749,4754,75
121593821,121592758,121600255,7497,4755,75
121605265,121604202,121613973,9771,4756,75
121619090,121618027,121627761,9734,4757,75
121632838,121631775,121640855,9080,4758,75
121645935,121644872,121653002,8130,4759,75
121658068,121657004,121666422,9418,4760,75
121671649,121670369,121678082,7713,4761,75
121683163,121682100,121690547,8447,4762,75
121695642,121694579,121702076,7497,4763,75
121707303,121706023,121713737,7714,4764,75
121718816,121717753,121726516,8763,4765,75
121731581,121730518,121738015,7497,4766,75
121743135,121742072,121751152,9080,4767,75
121756260,121755198,121763011,7813,4768,75
121768069,121767006,121776740,9734,4769,75
121781846,121780783,121790200,9417,4770,75
121795427,121794148,121801860,7712,4771,75
121806951,121805889,121815306,9417,4772,75
121820370,121819307,121827121,7814,4773,75
121832348,121831068,121838781,7713,4774,75
121843909,121842846,121850975,8129,4775,75
121856094,121855031,121863478,8447,4776,75
121868614,121867551,121875048,7497,4777,75
121880275,121878995,121887342,8347,4778,75
121892425,121891362,121899492,8130,4779,75
121904719,121903439,121911470,8031,4780,75
121916553,121915491,121923304,7813,4781,75
121928530,121927251,121936885,9634,4782,75
121941967,121940904,121948400,7496,4783,75
121953627,121952347,121962297,9950,4784,75
121967403,121966340,121974786,8446,4785,75
121979796,121978733,121986246,7513,4786,75
121991311,121990248,121998695,8447,4787,75
122003763,122002700,122012433,9733,4788,75
122017514,122016450,122025213,8763,4789,75
122030279,122029216,122036712,7496,4790,75
122041940,122040660,122048691,8031,4791,75
122053917,122052638,122062271,9633,4792,75
122067367,122066304,122075067,8763,4793,75
122080295,122079015,122087044,8029,4794,75
122092271,122090991,122099654,8663,4795,75
122104880,122103601,122111947,8346,4796,75
122117174,122115894,122123608,7714,4797,75
122128708,122127645,122137062,9417,4798,75
122142143,122141080,122150813,9733,4799,75
122156041,122154761,122162792,8031,4800,75
122167894,122166831,122175277,8446,4801,75
122180366,122179304,122188719,9415,4802,75
122193731,122192667,122203051,10384,4803,75
122208366,122207087,122216066,8979,4804,75
122221156,122220093,122229826,9733,4805,75
122234922,122233859,122242305,8446,4806,75
122247379,122246315,122254446,8131,4807,75
122259456,122258393,122268776,10383,4808,75
122273921,122272858,122282274,9416,4809,75
122287409,122286346,122294159,7813,4810,75
122299278,122298215,122306345,8130,4811,75
122311470,122310407,122318537,8130,4812,75
122323764,122322484,122330831,8347,4813,75
122336057,122334778,122343124,8346,4814,75
122348265,122347202,122355964,8762,4815,75
122361078,122360015,122368462,8447,4816,75
122373529,122372466,122381545,9079,4817,75
122386628,122385565,122393694,8129,4818,75
122398796,122397733,122405547,7814,4819,75
122410646,122409583,122417080,7497,4820,75
122422152,122421089,122430507,9418,4821,75
122435602,122434539,122443619,9080,4822,75
122448738,122447675,122455804,8129,4823,75
122460914,122459851,122469268,9417,4824,75
122474279,122473216,122482965,9749,4825,75
122488106,122487043,122495806,8763,4826,75
122500923,122499861,122507989,8128,4827,75
122513086,122512023,122521440,9417,4828,75
122526667,122525387,122535337,9950,4829,75
122540347,122539284,122549034,9750,4830,75
122554261,122552982,122562931,9949,4831,75
122568014,122566951,122574448,7497,4832,75
122579458,122578395,122586561,8166,4833,75
122591787,122590508,122599171,8663,4834,75
122604266,122603203,122612283,9080,4835,75
122617357,122616294,122624424,8130,4836,75
122629557,122628494,122636624,8130,4837,75
122641735,122640672,122650089,9417,4838,75
122655154,122654091,122661904,7813,4839,75
122666981,122665919,122674682,8763,4840,75
122679910,122678630,122688580,9950,4841,75
122693590,122692527,122703246,10719,4842,75
122708412,122707350,122715163,7813,4843,75
122720278,122719215,122727027,7812,4844,75
122732254,122730974,122740270,9296,4845,75
122745360,122744297,122751794,7497,4846,75
122756884,122755822,122764268,8446,4847,75
122769496,122768216,122776880,8664,4848,75
122782107,122780828,122790778,9950,4849,75
122796005,122794725,122803072,8347,4850,75
122808081,122807019,122816969,9950,4851,75
122822061,122820998,122828812,7814,4852,75
122834039,122832759,122841106,8347,4853,75
122846228,122845165,122852662,7497,4854,75
122857889,122856610,122865272,8662,4855,75
122870283,122869220,122877884,8664,4856,75
122882973,122881910,122889407,7497,4857,75
122894490,122893428,122903160,9732,4858,75
122908387,122907107,122915136,8029,4859,75
122920248,122919185,122926999,7814,4860,75
122932055,122930992,122940072,9080,4861,75
122945153,122944091,122952535,8444,4862,75
122957636,122956573,122965335,8762,4863,75
122970417,122969355,122978117,8762,4864,75
122983229,122982166,122990612,8446,4865,75
122995838,122994559,123003222,8663,4866,75
123008449,123007169,123017118,9949,4867,75
123022224,123021161,123030241,9080,4868,75
123035326,123034263,123042392,8129,4869,75
123047477,123046415,123055176,8761,4870,75
123060266,123059203,123066699,7496,4871,75
123071926,123070646,123078992,8346,4872,75
123084092,123083029,123091792,8763,4873,75
123097019,123095739,123104403,8664,4874,75
123109482,123108419,123116549,8130,4875,75
123121776,123120496,123129476,8980,4876,75
123134703,123133423,123141770,8347,4877,75
123146911,123145848,123154927,9079,4878,75
123160033,123158970,123166466,7496,4879,75
123171554,123170492,123178937,8445,4880,75
123184036,123182973,123190470,7497,4881,75
123195557,123194495,123203257,8762,4882,75
123208340,123207277,123215407,8130,4883,75
123220469,123219406,123227536,8130,4884,75
123232630,123231567,123239380,7813,4885,75
123244389,123243327,123252759,9432,4886,75
123257860,123256798,123266531,9733,4887,75
123271541,123270478,123280112,9634,4888,75
123285182,123284119,123293852,9733,4889,75
123298862,123297799,123306598,8799,4890,75
123311687,123310624,123320041,9417,4891,75
123325111,123324048,123332495,8447,4892,75
123337611,123336549,123346281,9732,4893,75
123351379,123350316,123358128,7812,4894,75
123363354,123362075,123370104,8029,4895,75
123375222,123374160,123382605,8445,4896,75
123387723,123386660,123394474,7814,4897,75
123399701,123398421,123406135,7714,4898,75
123411193,123410131,123418576,8445,4899,75
123423697,123422634,123431396,8762,4900,75
123436622,123435343,123445293,9950,4901,75
123450303,123449240,123458536,9296,4902,75
123463634,123462572,123471334,8762,4903,75
123476405,123475343,123482839,7496,4904,75
123488065,123486786,123495764,8978,4905,75
123500831,123499768,123507581,7813,4906,75
123512703,123511640,123520719,9079,4907,75
123525729,123524666,123533148,8482,4908,75
123538289,123537226,123546643,9417,4909,75
123551653,123550590,123560972,10382,4910,75
123566185,123565122,123574856,9734,4911,75
123580082,123578803,123587465,8662,4912,75
123592566,123591503,123599000,7497,4913,75
123604141,123603078,123610575,7497,4914,75
123615661,123614599,123622412,7813,4915,75
123627421,123626359,123635157,8798,4916,75
123640383,123639104,123648082,8978,4917,75
123653183,123652120,123659932,7812,4918,75
123665014,123663951,123672713,8762,4919,75
123677816,123676754,123686169,9415,4920,75
123691179,123690116,123698282,8166,4921,75
123703375,123702313,123710442,8129,4922,75
123715521,123714458,123723875,9417,4923,75
123729102,123727822,123736169,8347,4924,75
123741268,123740205,123749284,9079,4925,75
123754412,123753349,123761161,7812,4926,75
123766258,123765195,123773324,8129,4927,75
123778551,123777271,123784985,7714,4928,75
123790101,123789038,123796852,7814,4929,75
123802078,123800799,123810094,9295,4930,75
123815182,123814119,123821932,7813,4931,75
123827068,123826005,123834769,8764,4932,75
123839894,123838831,123846644,7813,4933,75
123851763,123850700,123860118,9418,4934,75
123865197,123864134,123872264,8130,4935,75
123877360,123876297,123885714,9417,4936,75
123890724,123889661,123899093,9432,4937,75
123904164,123903101,123911548,8447,4938,75
123916775,123915495,123924159,8664,4939,75
123929387,123928106,123936453,8347,4940,75
123941679,123940400,123949379,8979,4941,75
123954606,123953326,123961040,7714,4942,75
123966266,123964987,123973333,8346,4943,75
123978469,123977406,123985218,7812,4944,75
123990347,123989284,123998047,8763,4945,75
124003164,124002101,124010548,8447,4946,75
124015637,124014574,124023337,8763,4947,75
124028394,124027331,124034827,7496,4948,75
124039906,124038843,124048577,9734,4949,75
124053803,124052524,124060552,8028,4950,75
124065779,124064499,124074449,9950,4951,75
124079553,124078489,124087253,8764,4952,75
124092312,124091250,124099695,8445,4953,75
124104705,124103642,124111808,8166,4954,75
124116818,124115755,124124872,9117,4955,75
124130099,124128819,124136849,8030,4956,75
124141920,124140857,124150591,9734,4957,75
124155661,124154598,124164015,9417,4958,75
124169142,124168079,124176208,8129,4959,75
124181434,124180155,124187867,7712,4960,75
124192948,124191885,124200965,9080,4961,75
124206081,124205018,124213464,8446,4962,75
124218581,124217518,124225332,7814,4963,75
124230444,124229381,124237193,7812,4964,75
124242295,124241232,124249045,7813,4965,75
124254113,124253050,124261496,8446,4966,75
124266609,124265546,124273992,8446,4967,75
124279098,124278036,124287768,9732,4968,75
124292871,124291808,124300570,8762,4969,75
124305666,124304603,124313683,9080,4970,75
124318693,124317630,124328667,11037,4971,75
124333896,124332833,124342251,9418,4972,75
124347260,124346198,124354679,8481,4973,75
124359688,124358626,124367424,8798,4974,75
124372434,124371371,124379537,8166,4975,75
124384602,124383539,124391985,8446,4976,75
124397097,124396034,124404797,8763,4977,75
124409807,124408745,124416457,7712,4978,75
124421546,124420484,124429899,9415,4979,75
124434985,124433922,124441419,7497,4980,75
124446646,124445367,124455000,9633,4981,75
124460084,124459022,124468754,9732,4982,75
124473859,124472797,124481559,8762,4983,75
124486636,124485574,124493069,7495,4984,75
124498125,124497062,124505825,8763,4985,75
124511052,124509772,124517485,7713,4986,75
124522574,124521511,124530928,9417,4987,75
124536025,124534962,124542459,7497,4988,75
124547542,124546479,124555896,9417,4989,75
124560906,124559843,124568823,8980,4990,75
124574050,124572770,124582067,9297,4991,75
124587191,124586128,124595208,9080,4992,75
124600310,124599248,124607060,7812,4993,75
124612287,124611007,124619987,8980,4994,75
124625091,124624029,124632158,8129,4995,75
124637246,124636183,124644946,8763,4996,75
124650025,124648962,124658695,9733,4997,75
124663922,124662642,124670673,8031,4998,75
124675901,124674621,124683601,8980,4999,75
124688705,124687642,124697059,9417,5000,75
124702445,124701083,124710859,9776,1,100
124716203,124714625,124724934,10309,2,100
124730253,124728892,124738668,9776,3,100
124744012,124742434,124752426,9992,4,100
124757770,124756192,124765234,9042,5,100
124770578,124769000,124777725,8725,6,100
124782936,124781574,124791667,10093,7,100
124797101,124795522,124803912,8390,8,100
124809039,124807678,124817670,9992,9,100
124823015,124821436,124830163,8727,10,100
124835503,124834141,124842968,8827,11,100
124848184,124846823,124856815,9992,12,100
124862248,124860670,124869713,9043,13,100
124875146,124873568,124882927,9359,14,100
124888361,124886782,124896457,9675,15,100
124901790,124900428,124910521,10093,16,100
124915923,124914561,124924337,9776,17,100
124929554,124928192,124938501,10309,18,100
124944022,124942444,124952752,10308,19,100
124958274,124956912,124966055,9143,20,100
124971272,124969911,124978952,9041,21,100
124984385,124982807,124990899,8092,22,100
124996215,124994853,125004945,10092,23,100
125010353,125008991,125017817,8826,24,100
125023148,125021787,125029662,7875,25,100
125034955,125033593,125041765,8172,26,100
125047199,125045621,125054664,9043,27,100
125059958,125058596,125068689,10093,28,100
125074211,125072633,125080725,8092,29,100
125086011,125084649,125093791,9142,30,100
125099008,125097646,125105739,8093,31,100
125111029,125109667,125118178,8511,32,100
125123395,125122034,125132026,9992,33,100
125137371,125136009,125146102,10093,34,100
125151624,125150263,125158772,8509,35,100
125164206,125162628,125171017,8389,36,100
125176234,125174873,125183598,8725,37,100
125188887,125187525,125196668,9143,38,100
125202102,125200524,125209567,9043,39,100
125214882,125213521,125222029,8508,40,100
125227464,125225885,125234929,9044,41,100
125240363,125238785,125248144,9359,42,100
125253577,125251999,125260092,8093,43,100
125265526,125263947,125272990,9043,44,100
125278313,125276951,125286728,9777,45,100
125292162,125290583,125300259,9676,46,100
125305576,125304214,125313673,9459,47,100
125318890,125317529,125326570,9041,48,100
125332004,125330426,125338519,8093,49,100
125343952,125342374,125352683,10309,50,100
125358206,125356627,125366619,9992,51,100
125372054,125370475,125380152,9677,52,100
125385585,125384007,125393367,9360,53,100
125398800,125397222,125407215,9993,54,100
125412542,125411181,125419690,8509,55,100
125425124,125423546,125432272,8726,56,100
125437615,125436254,125444130,7876,57,100
125449466,125448104,125456614,8510,58,100
125461831,125460469,125470774,10305,59,100
125476297,125474718,125484394,9676,60,100
125489610,125488249,125499305,11056,61,100
125504827,125503249,125519425,16176,62,100
125524948,125523370,125533362,9992,63,100
125538675,125537314,125545486,8172,64,100
125550919,125549341,125559017,9676,65,100
125564344,125562983,125572759,9776,66,100
125577977,125576615,125586925,10310,67,100
125592446,125590869,125599910,9041,68,100
125605127,125603766,125612492,8726,69,100
125617772,125616410,125624920,8510,70,100
125630354,125628776,125638769,9993,71,100
125644202,125642624,125652615,9991,72,100
125658049,125656471,125664860,8389,73,100
125670201,125668840,125677665,8825,74,100
125682955,125681593,125691686,10093,75,100
125697208,125695630,125704673,9043,76,100
125709891,125708529,125716623,8094,77,100
125722057,125720479,125730471,9992,78,100
125735688,125734327,125743686,9359,79,100
125749120,125747542,125756900,9358,80,100
125762333,125760755,125769797,9042,81,100
125775231,125773652,125782379,8727,82,100
125787813,125786234,125794328,8094,83,100
125799761,125798183,125808174,9991,84,100
125813474,125812112,125819989,7877,85,100
125825256,125823895,125833671,9776,86,100
125839105,125837527,125847835,10308,87,100
125853141,125851779,125860663,8884,88,100
125866096,125864518,125873877,9359,89,100
125879095,125877733,125885827,8094,90,100
125891260,125889682,125898069,8387,91,100
125903503,125901925,125910968,9043,92,100
125916402,125914823,125923550,8727,93,100
125928985,125927406,125937399,9993,94,100
125942832,125941254,125949347,8093,95,100
125954643,125953281,125963374,10093,96,100
125968895,125967318,125976676,9358,97,100
125981892,125980531,125990207,9676,98,100
125995642,125994063,126002790,8727,99,100
126008225,126006646,126016006,9360,100,100
126021528,126019950,126030259,10309,101,100
126035710,126034348,126043175,8827,102,100
126048697,126047119,126055845,8726,103,100
126061367,126059789,126070098,10309,104,100
126075578,126074216,126083359,9143,105,100
126088745,126087383,126095260,7877,106,100
126100777,126099204,126108242,9038,107,100
126113764,126112186,126121861,9675,108,100
126127262,126125901,126135044,9143,109,100
126140468,126139106,126149199,10093,110,100
126154810,126153232,126162275,9043,111,100
126167704,126166342,126175801,9459,112,100
126181323,126179745,126189421,9676,113,100
126194776,126193414,126202874,9460,114,100
126208290,126206928,126214805,7877,115,100
126220190,126218828,126228288,9460,116,100
126233809,126232232,126241273,9041,117,100
126246795,126245217,126255526,10309,118,100
126260991,126259630,126267506,7876,119,100
126273027,126271450,126279838,8388,120,100
126285360,126283782,126293140,9358,121,100
126298663,126297084,126307394,10310,122,100
126313006,126311427,126321420,9993,123,100
126326943,126325364,126335357,9993,124,100
126340731,126339370,126348829,9459,125,100
126354352,126352773,126362134,9361,126,100
126367656,126366078,126374804,8726,127,100
126380233,126378872,126388014,9142,128,100
126393537,126391958,126401951,9993,129,100
126407472,126406111,126414620,8509,130,100
126420143,126418564,126428241,9677,131,100
126433763,126432185,126440911,8726,132,100
126446430,126444856,126452945,8089,133,100
126458304,126456943,126465769,8826,134,100
126471292,126469930,126477806,7876,135,100
126483329,126481751,126492060,10309,136,100
126497671,126496093,126504481,8388,137,100
126510003,126508425,126516814,8389,138,100
126522198,126520836,126530613,9777,139,100
126536016,126534654,126544747,10093,140,100
126550358,126548780,126559089,10309,141,100
126564598,126563237,126572063,8826,142,100
126577419,126576057,126585517,9460,143,100
126591040,126589461,126597555,8094,144,100
126603077,126601499,126611175,9676,145,100
126616697,126615119,126623845,8726,146,100
126629368,126627789,126636515,8726,147,100
126642038,126640459,126649186,8727,148,100
126654709,126653131,126662490,9359,149,100
126668012,126666434,126674823,8389,150,100
126680206,126678844,126687986,9142,151,100
126693509,126691931,126701924,9993,152,100
126707335,126705973,126714483,8510,153,100
126720005,126718427,126728735,10308,154,100
126734347,126732768,126741158,8390,155,100
126746576,126745215,126754674,9459,156,100
126760197,126758619,126768928,10309,157,100
126774416,126773054,126780931,7877,158,100
126786333,126784971,126794113,9142,159,100
126799635,126798057,126806446,8389,160,100
126811969,126810391,126819117,8726,161,100
126824640,126823279,126833055,9776,162,100
126838579,126837000,126845727,8727,163,100
126851250,126849672,126858714,9042,164,100
126864093,126862732,126872824,10092,165,100
126878435,126876858,126885583,8725,166,100
126891107,126889528,126899838,10310,167,100
126905450,126903872,126912261,8389,168,100
126917784,126916206,126924595,8389,169,100
126930118,126928540,126937266,8726,170,100
126942789,126941211,126949304,8093,171,100
126954827,126953249,126962925,9676,172,100
126968449,126966870,126975259,8389,173,100
126980684,126979323,126987494,8171,174,100
126993016,126991438,126999530,8092,175,100
127005053,127003475,127013150,9675,176,100
127018674,127017312,127025189,7877,177,100
127030709,127029348,127038806,9458,178,100
127044165,127042803,127051629,8826,179,100
127056993,127055632,127064458,8826,180,100
127069981,127068403,127076792,8389,181,100
127082315,127080737,127088830,8093,182,100
127094223,127092862,127102954,10092,183,100
127108566,127106988,127115080,8092,184,100
127120603,127119025,127127414,8389,185,100
127132793,127131431,127139307,7876,186,100
127144669,127143308,127151817,8509,187,100
127157193,127155830,127164658,8828,188,100
127170060,127168698,127178157,9459,189,100
127183680,127182102,127191778,9676,190,100
127197159,127195798,127204624,8826,191,100
127209988,127208626,127216799,8173,192,100
127222322,127220744,127229787,9043,193,100
127235196,127233834,127242344,8510,194,100
127247868,127246289,127254383,8094,195,100
127259906,127258328,127267054,8726,196,100
127272577,127270999,127279091,8092,197,100
127284446,127283084,127293177,10093,198,100
127298790,127297211,127305600,8389,199,100
127310985,127309624,127317796,8172,200,100
127323319,127321741,127331099,9358,201,100
127336624,127335045,127343139,8094,202,100
127348663,127347084,127357077,9993,203,100
127362602,127361240,127371333,10093,204,100
127376946,127375367,127384094,8727,205,100
127389469,127388107,127396934,8827,206,100
127402458,127400879,127408973,8094,207,100
127414402,127413041,127421211,8170,208,100
127426608,127425246,127433419,8173,209,100
127438785,127437423,127445933,8510,210,100
127451456,127449878,127459870,9992,211,100
127465269,127463908,127472418,8510,212,100
127477941,127476363,127486671,10308,213,100
127492283,127490705,127500381,9676,214,100
127505904,127504326,127514635,10309,215,100
127520122,127518761,127528853,10092,216,100
127534465,127532887,127541276,8389,217,100
127546800,127545222,127553315,8093,218,100
127558693,127557332,127567424,10092,219,100
127573036,127571458,127581134,9676,220,100
127586655,127585293,127594753,9460,221,100
127600155,127598794,127608570,9776,222,100
127614093,127612515,127622508,9993,223,100
127627920,127626558,127634730,8172,224,100
127640254,127638676,127648351,9675,225,100
127653744,127652382,127662157,9775,226,100
127667519,127666158,127674034,7876,227,100
127679434,127678072,127686898,8826,228,100
127692423,127690844,127699234,8390,229,100
127704642,127703280,127711790,8510,230,100
127717314,127715952,127723828,7876,231,100
127729183,127727822,127735698,7876,232,100
127741108,127739747,127748573,8826,233,100
127753950,127752588,127762681,10093,234,100
127768147,127766785,127775296,8511,235,100
127780679,127779317,127788143,8826,236,100
127793548,127792187,127801013,8826,237,100
127806537,127804959,127813347,8388,238,100
127818704,127817343,127825219,7876,239,100
127830743,127829164,127837258,8094,240,100
127842781,127841203,127849296,8093,241,100
127854703,127853342,127861535,8193,242,100
127867058,127865480,127874840,9360,243,100
127880270,127878909,127889001,10092,244,100
127894613,127893035,127901762,8727,245,100
127907182,127905820,127913993,8173,246,100
127919351,127917990,127926500,8510,247,100
127931921,127930559,127939702,9143,248,100
127945226,127943648,127953640,9992,249,100
127958996,127957635,127965510,7875,250,100
127971034,127969455,127978498,9043,251,100
127983858,127982497,127990373,7876,252,100
127995897,127994319,128003995,9676,253,100
128009518,128007940,128016982,9042,254,100
128022504,128021143,128029314,8171,255,100
128034837,128033259,128042935,9676,256,100
128048458,128046880,128055923,9043,257,100
128061445,128060083,128069543,9460,258,100
128075068,128073488,128083798,10310,259,100
128089249,128087888,128097030,9142,260,100
128102459,128101098,128109607,8509,261,100
128115130,128113552,128123545,9993,262,100
128129068,128127490,128135877,8387,263,100
128141401,128140039,128147916,7877,264,100
128153344,128151983,128159859,7876,265,100
128165383,128163804,128173163,9359,266,100
128178577,128177215,128186357,9142,267,100
128191880,128190302,128199661,9359,268,100
128205184,128203606,128213282,9676,269,100
128218668,128217306,128227082,9776,270,100
128232470,128231109,128239281,8172,271,100
128244700,128243338,128252165,8827,272,100
128257688,128256110,128265786,9676,273,100
128271167,128269805,128279581,9776,274,100
128284938,128283577,128291453,7876,275,100
128296821,128295459,128304919,9460,276,100
128310443,128308864,128318224,9360,277,100
128323608,128322247,128331073,8826,278,100
128336596,128335018,128345011,9993,279,100
128350534,128348956,128359264,10308,280,100
128364876,128363298,128372974,9676,281,100
128378497,128376919,128385645,8726,282,100
128391025,128389663,128398805,9142,283,100
128404329,128402750,128413060,10310,284,100
128418673,128417094,128426454,9360,285,100
128431978,128430399,128439126,8727,286,100
128444650,128443071,128452432,9361,287,100
128457953,128456592,128465734,9142,288,100
128471257,128469679,128479671,9992,289,100
128485031,128483670,128493129,9459,290,100
128498652,128497291,128507382,10091,291,100
128512919,128511558,128519433,7875,292,100
128524863,128523501,128532011,8510,293,100
128537401,128536040,128544865,8825,294,100
128550388,128548810,128558803,9993,295,100
128564326,128562748,128571474,8726,296,100
128576997,128575419,128583807,8388,297,100
128589330,128587969,128597111,9142,298,100
128602477,128601116,128610892,9776,299,100
128616286,128614925,128622801,7876,300,100
128628197,128626836,128635660,8824,301,100
128641184,128639605,128647994,8389,302,100
128653517,128651939,128660982,9043,303,100
128666370,128665009,128673834,8825,304,100
128679357,128677779,128686505,8726,305,100
128692029,128690450,128698544,8094,306,100
128703924,128702563,128712339,9776,307,100
128717862,128716284,128725010,8726,308,100
128730374,128729012,128738155,9143,309,100
128743679,128742100,128752410,10310,310,100
128758022,128756444,128765170,8726,311,100
128770572,128769211,128778986,9775,312,100
128784510,128782931,128792925,9994,313,100
128798312,128796950,128804826,7876,314,100
128810349,128808771,128817497,8726,315,100
128823021,128821442,128830168,8726,316,100
128835571,128834209,128842719,8510,317,100
128848132,128846771,128854943,8172,318,100
128860342,128858980,128867490,8510,319,100
128873013,128871435,128881744,10309,320,100
128887356,128885778,128894821,9043,321,100
128900344,128898983,128906859,7876,322,100
128912382,128910804,128920478,9674,323,100
128926002,128924423,128932833,8410,324,100
128938200,128936838,128945981,9143,325,100
128951503,128949926,128959918,9992,326,100
128965441,128963863,128974172,10309,327,100
128979677,128978315,128986825,8510,328,100
128992190,128990828,128999971,9143,329,100
129005402,129004041,129011917,7876,330,100
129017439,129015862,129024586,8724,331,100
129030110,129028748,129037258,8510,332,100
129042782,129041420,129049297,7877,333,100
129054688,129053326,129062153,8827,334,100
129067557,129066196,129076288,10092,335,100
129081734,129080372,129089832,9460,336,100
129095355,129093777,129102820,9043,337,100
129108224,129106862,129116322,9460,338,100
129121845,129120267,129129310,9043,339,100
129134833,129133255,129143247,9992,340,100
129148771,129147192,129155919,8727,341,100
129161272,129159911,129170002,10091,342,100
129175614,129174036,129183712,9676,343,100
129189235,129187657,129197649,9992,344,100
129203173,129201594,129211904,10310,345,100
129217516,129215938,129226246,10308,346,100
129231858,129230280,129238373,8093,347,100
129243896,129242318,129250705,8387,348,100
129256228,129254650,129263693,9043,349,100
129269216,129267855,129276026,8171,350,100
129281549,129279971,129288064,8093,351,100
129293588,129292009,129300736,8727,352,100
129306134,129304773,129314865,10092,353,100
129320404,129319042,129328502,9460,354,100
129334025,129332447,129341172,8725,355,100
129346695,129345117,129353210,8093,356,100
129358564,129357203,129366662,9459,357,100
129372064,129370703,129378875,8172,358,100
129384293,129382931,129391103,8172,359,100
129396498,129395136,129403013,7877,360,100
129408537,129406959,129416951,9992,361,100
129422475,129420897,129430256,9359,362,100
129435782,129434202,129444196,9994,363,100
129449719,129448141,129457500,9359,364,100
129463023,129461445,129471121,9676,365,100
129476644,129475066,129483792,8726,366,100
129489316,129487737,129496464,8727,367,100
129501987,129500625,129508501,7876,368,100
129514024,129512446,129520539,8093,369,100
129526063,129524484,129534793,10309,370,100
129540276,129538915,129548057,9142,371,100
129553486,129552124,129560296,8172,372,100
129565700,129564338,129573165,8827,373,100
129578688,129577110,129585203,8093,374,100
129590727,129589148,129598825,9677,375,100
129604198,129602837,129610712,7875,376,100
129616237,129614874,129623384,8510,377,100
129628907,129627329,129636372,9043,378,100
129641896,129640534,129649993,9459,379,100
129655516,129653938,129662981,9043,380,100
129668382,129667021,129676797,9776,381,100
129682177,129680815,129690275,9460,382,100
129695686,129694325,129704417,10092,383,100
129710030,129708451,129718127,9676,384,100
129723527,129722166,129730675,8509,385,100
129736050,129734689,129743197,8508,386,100
129748576,129747215,129756989,9774,387,100
129762512,129760934,129770292,9358,388,100
129775815,129774237,129784230,9993,389,100
129789754,129788175,129797535,9360,390,100
129803058,129801480,129811473,9993,391,100
129816896,129815534,129824361,8827,392,100
129829741,129828380,129837206,8826,393,100
129842729,129841151,129851459,10308,394,100
129856912,129855551,129864060,8509,395,100
129869583,129868005,129876393,8388,396,100
129881916,129880338,129890331,9993,397,100
129895705,129894343,129902515,8172,398,100
129908039,129906460,129915504,9044,399,100
129921027,129919449,129927541,8092,400,100
129932963,129931601,129941694,10093,401,100
129947144,129945783,129954925,9142,402,100
129960448,129958870,129967258,8388,403,100
129972782,129971203,129979930,8727,404,100
129985453,129983875,129993866,9991,405,100
129999389,129998028,130007486,9458,406,100
130013010,130011431,130020475,9044,407,100
130025829,130024467,130034560,10093,408,100
130040028,130038666,130048443,9777,409,100
130053966,130052388,130061114,8726,410,100
130066519,130065159,130073034,7875,411,100
130078557,130076979,130086655,9676,412,100
130092178,130090600,130100276,9676,413,100
130105799,130104221,130114530,10309,414,100
130120018,130118657,130127166,8509,415,100
130132690,130131111,130139838,8727,416,100
130145362,130143783,130151877,8094,417,100
130157401,130155823,130163916,8093,418,100
130169439,130167861,130176587,8726,419,100
130181965,130180604,130189429,8825,420,100
130194788,130193426,130202253,8827,421,100
130207650,130206288,130216381,10093,422,100
130221994,130220415,130228826,8411,423,100
130234202,130232840,130240717,7877,424,100
130246240,130244662,130254992,10330,425,100
130260605,130259026,130268703,9677,426,100
130274226,130272648,130282324,9676,427,100
130287726,130286365,130295824,9459,428,100
130301232,130299871,130308380,8509,429,100
130313903,130312325,130321051,8726,430,100
130326453,130325091,130333600,8509,431,100
130339125,130337546,130345639,8093,432,100
130351033,130349672,130358497,8825,433,100
130364019,130362657,130370829,8172,434,100
130376353,130374774,130384767,9993,435,100
130390292,130388713,130397441,8728,436,100
130402966,130401387,130411381,9994,437,100
130416758,130415397,130424539,9142,438,100
130429916,130428554,130436431,7877,439,100
130441950,130440376,130450681,10305,440,100
130456293,130454715,130465023,10308,441,100
130470636,130469057,130478101,9044,442,100
130483625,130482263,130490139,7876,443,100
130495663,130494085,130502812,8727,444,100
130508210,130506849,130514725,7876,445,100
130520248,130518670,130528979,10309,446,100
130534592,130533013,130542057,9044,447,100
130547582,130546003,130555680,9677,448,100
130561038,130559677,130567848,8171,449,100
130573156,130571794,130583526,11732,450,100
130589138,130587560,130595949,8389,451,100
130601326,130599964,130609423,9459,452,100
130614945,130613368,130623676,10308,453,100
130629148,130627786,130636929,9143,454,100
130642452,130640874,130650233,9359,455,100
130655644,130654283,130663742,9459,456,100
130669266,130667688,130677363,9675,457,100
130682886,130681308,130689696,8388,458,100
130695220,130693641,130703950,10309,459,100
130709461,130708100,130717876,9776,460,100
130723399,130721821,130731179,9358,461,100
130736703,130735125,130744484,9359,462,100
130750008,130748430,130757789,9359,463,100
130763202,130761840,130769717,7877,464,100
130775148,130773786,130782296,8510,465,100
130787691,130786330,130794839,8509,466,100
130800363,130798785,130808460,9675,467,100
130813983,130812405,130822735,10330,468,100
130828348,130826769,130835496,8727,469,100
130840915,130839554,130849328,9774,470,100
130854852,130853274,130863267,9993,471,100
130868791,130867213,130875623,8410,472,100
130881147,130879568,130887978,8410,473,100
130893395,130892033,130899910,7877,474,100
130905434,130903856,130912244,8388,475,100
130917646,130916285,130924161,7876,476,100
130929684,130928106,130936832,8726,477,100
130942356,130940778,130948871,8093,478,100
130954232,130952870,130962984,10114,479,100
130968433,130967072,130975897,8825,480,100
130981421,130979843,130988886,9043,481,100
130994409,130992831,131003140,10309,482,100
131008752,131007174,131016533,9359,483,100
131022056,131020695,131030154,9459,484,100
131035678,131034100,131042510,8410,485,100
131047900,131046538,131056652,10114,486,100
131062264,131060686,131071015,10329,487,100
131076493,131075131,131083957,8826,488,100
131089327,131087966,131098079,10113,489,100
131103691,131102113,131111788,9675,490,100
131117310,131115733,131125724,9991,491,100
131131247,131129669,131139661,9992,492,100
131145063,131143702,131153160,9458,493,100
131158521,131157160,131165352,8192,494,100
131170875,131169297,131177389,8092,495,100
131182747,131181385,131189578,8193,496,100
131195101,131193523,131201616,8093,497,100
131207139,131205561,131215891,10330,498,100
131221353,131219991,131228185,8194,499,100
131233708,131232130,131240222,8092,500,100
131245627,131244266,131252142,7876,501,100
131257665,131256087,131264813,8726,502,100
131270175,131268814,131278589,9775,503,100
131283988,131282626,131292401,9775,504,100
131297924,131296346,131305705,9359,505,100
131311228,131309650,131318375,8725,506,100
131323898,131322320,131332312,9992,507,100
131337835,131336257,131346249,9992,508,100
131351771,131350410,131358918,8508,509,100
131364441,131362863,131372222,9359,510,100
131377745,131376167,131385843,9676,511,100
131391366,131389788,131399780,9992,512,100
131405303,131403725,131413401,9676,513,100
131418924,131417346,131426705,9359,514,100
131432061,131430700,131440791,10091,515,100
131446402,131444824,131455133,10309,516,100
131460746,131459167,131467261,8094,517,100
131472784,131471206,131481198,9992,518,100
131486549,131485188,131494013,8825,519,100
131499382,131498021,131508112,10091,520,100
131513724,131512146,131520871,8725,521,100
131526232,131524870,131534013,9143,522,100
131539405,131538043,131547502,9459,523,100
131553025,131551447,131560173,8726,524,100
131565554,131564193,131573968,9775,525,100
131579491,131577913,131586639,8726,526,100
131592037,131590676,131609969,19293,527,100
131615582,131614003,131629229,15226,528,100
131634761,131633400,131642226,8826,529,100
131647652,131646290,131654167,7877,530,100
131659690,131658112,131666204,8092,531,100
131671727,131670149,131679825,9676,532,100
131685348,131683770,131693761,9991,533,100
131699138,131697776,131706603,8827,534,100
131711998,131710636,131720729,10093,535,100
131726269,131724908,131734367,9459,536,100
131739774,131738412,131747239,8827,537,100
131752619,131751257,131760084,8827,538,100
131765608,131764029,131772123,8094,539,100
131777482,131776121,131785263,9142,540,100
131790786,131789208,131798884,9676,541,100
131804285,131802924,131811750,8826,542,100
131817274,131815695,131825055,9360,543,100
131830578,131829000,131838676,9676,544,100
131844199,131842621,131851980,9359,545,100
131857503,131855925,131864968,9043,546,100
131870385,131869023,131877216,8193,547,100
131882739,131881161,131890520,9359,548,100
131896044,131894465,131903192,8727,549,100
131908586,131907225,131915734,8509,550,100
131921258,131919679,131928068,8389,551,100
131933591,131932013,131941371,9358,552,100
131946894,131945316,131954042,8726,553,100
131959442,131958081,131966589,8508,554,100
131972113,131970534,131980211,9677,555,100
131985734,131984156,131994148,9992,556,100
131999671,131998093,132007452,9359,557,100
132012880,132011519,132021293,9774,558,100
132026817,132025238,132035231,9993,559,100
132040597,132039235,132047111,7876,560,100
132052634,132051056,132061365,10309,561,100
132066856,132065494,132073370,7876,562,100
132078893,132077315,132086674,9359,563,100
132092198,132090619,132098712,8093,564,100
132104087,132102725,132110602,7877,565,100
132116126,132114764,132124857,10093,566,100
132130468,132128890,132136983,8093,567,100
132142507,132140928,132150604,9676,568,100
132155971,132154610,132164068,9458,569,100
132169591,132168013,132176739,8726,570,100
132182262,132180684,132189410,8726,571,100
132194790,132193428,132202888,9460,572,100
132208411,132206833,132216825,9992,573,100
132222348,132220770,132230446,9676,574,100
132235800,132234439,132244213,9774,575,100
132249611,132248248,132256126,7878,576,100
132261487,132260125,132268002,7877,577,100
132273403,132272042,132280235,8193,578,100
132285624,132284263,132301509,17246,579,100
132306966,132305604,132314430,8826,580,100
132319953,132318375,132327101,8726,581,100
132332624,132331046,132339138,8092,582,100
132344551,132343190,132351699,8509,583,100
132357063,132355701,132364528,8827,584,100
132369937,132368575,132378034,9459,585,100
132383558,132381979,132392289,10310,586,100
132397901,132396323,132404712,8389,587,100
132410089,132408727,132417237,8510,588,100
132422760,132421182,132431490,10308,589,100
132437102,132435524,132443913,8389,590,100
132449435,132448074,132457849,9775,591,100
132463273,132461911,132472004,10093,592,100
132477501,132476140,132485282,9142,593,100
132490805,132489227,132498586,9359,594,100
132504110,132502531,132512840,10309,595,100
132518452,132516874,132526550,9676,596,100
132532069,132530495,132538584,8089,597,100
132544107,132542529,132550622,8093,598,100
132556146,132554567,132562956,8389,599,100
132568480,132566901,132575290,8389,600,100
132580813,132579235,132589543,10308,601,100
132595154,132593576,132603252,9676,602,100
132608673,132607311,132617404,10093,603,100
132623016,132621438,132631747,10309,604,100
132637359,132635781,132643874,8093,605,100
132649398,132647819,132657495,9676,606,100
132662871,132661509,132670336,8827,607,100
132675859,132674281,132683956,9675,608,100
132689479,132687901,132698210,10309,609,100
132703719,132702358,132711817,9459,610,100
132717174,132715812,132724322,8510,611,100
132729845,132728267,132736360,8093,612,100
132741880,132740305,132748690,8385,613,100
132754213,132752635,132762628,9993,614,100
132768039,132766678,132776453,9775,615,100
132781976,132780398,132788491,8093,616,100
132794014,132792436,132801162,8726,617,100
132806685,132805107,132813200,8093,618,100
132818723,132817145,132826187,9042,619,100
132831710,132830132,132840124,9992,620,100
132845647,132844069,132853745,9676,621,100
132859270,132857691,132866735,9044,622,100
132872258,132870680,132879723,9043,623,100
132885246,132883668,132893660,9992,624,100
132899016,132897654,132906480,8826,625,100
132911889,132910528,132919987,9459,626,100
132925510,132924149,132932658,8509,627,100
132938181,132936603,132945962,9359,628,100
132951345,132949983,132960076,10093,629,100
132965541,132964179,132972352,8173,630,100
132977875,132976297,132985339,9042,631,100
132990704,132989343,132998169,8826,632,100
133003564,133002203,133012316,10113,633,100
133017928,133016350,133026659,10309,634,100
133032271,133030693,133040051,9358,635,100
133045574,133043996,133053672,9676,636,100
133059195,133057617,133066027,8410,637,100
133071550,133069972,133078382,8410,638,100
133083905,133082327,133091053,8726,639,100
133096419,133095057,133105150,10093,640,100
133110762,133109184,133118226,9042,641,100
133123655,133122293,133130802,8509,642,100
133136320,133134746,133144101,9355,643,100
133149485,133148123,133157899,9776,644,100
133163423,133161844,133170888,9044,645,100
133176412,133174833,133183559,8726,646,100
133189082,133187504,133197834,10330,647,100
133203446,133201868,133211227,9359,648,100
133216751,133215172,133223898,8726,649,100
133229422,133227843,133237202,9359,650,100
133242725,133241147,133250505,9358,651,100
133255880,133254518,133262395,7877,652,100
133267918,133266340,133274433,8093,653,100
133279844,133278483,133286359,7876,654,100
133291748,133290386,133298262,7876,655,100
133303670,133302309,133312084,9775,656,100
133317509,133316148,133325923,9775,657,100
133331446,133329868,133337961,8093,658,100
133343485,133341906,133352236,10330,659,100
133357703,133356341,133364217,7876,660,100
133369738,133368162,133377519,9357,661,100
133383042,133381464,133390506,9042,662,100
133396029,133394451,133403809,9358,663,100
133409332,133407754,133417113,9359,664,100
133422636,133421058,133431388,10330,665,100
133436926,133435565,133444389,8824,666,100
133449772,133448411,133458186,9775,667,100
133463708,133462131,133470222,8091,668,100
133475745,133474167,133483843,9676,669,100
133489205,133487843,133497303,9460,670,100
133502672,133501312,133509186,7874,671,100
133514708,133513131,133521539,8408,672,100
133526949,133525587,133535047,9460,673,100
133540455,133539093,133546970,7877,674,100
133552494,133550915,133560591,9676,675,100
133566114,133564536,133572944,8408,676,100
133578326,133576964,133586423,9459,677,100
133591946,133590368,133599411,9043,678,100
133604833,133603471,133613247,9776,679,100
133618601,133617239,133626064,8825,680,100
133631587,133630009,133638734,8725,681,100
133644258,133642679,133652039,9360,682,100
133657563,133655984,133665344,9360,683,100
133670867,133669289,133678965,9676,684,100
133684488,133682910,133691003,8093,685,100
133696434,133695072,133703265,8193,686,100
133708788,133707210,133715303,8093,687,100
133720728,133719366,133727243,7877,688,100
133732648,133731286,133739479,8193,689,100
133744858,133743497,133751373,7876,690,100
133756896,133755318,133765648,10330,691,100
133771140,133769778,133778605,8827,692,100
133784011,133782650,133791791,9141,693,100
133797315,133795736,133805413,9677,694,100
133810792,133809431,133818890,9459,695,100
133824265,133822904,133832679,9775,696,100
133838045,133836684,133845510,8826,697,100
133851034,133849455,133858182,8727,698,100
133863705,133862127,133871170,9043,699,100
133876693,133875115,133883840,8725,700,100
133889365,133887786,133897779,9993,701,100
133903302,133901724,133911717,9993,702,100
133917240,133915879,133924705,8826,703,100
133930137,133928775,133938235,9460,704,100
133943628,133942267,133951726,9459,705,100
133957098,133955736,133965196,9460,706,100
133970719,133969141,133978499,9358,707,100
133983894,133982533,133991675,9142,708,100
133997057,133995696,134003888,8192,709,100
134009294,134007932,134015809,7877,710,100
134021198,134019837,134028978,9141,711,100
134034370,134033009,134041202,8193,712,100
134046726,134045364,134054506,9142,713,100
134059928,134058567,134067393,8826,714,100
134072917,134071338,134080382,9044,715,100
134085808,134084446,134094223,9777,716,100
134099604,134098243,134107385,9142,717,100
134112908,134111330,134121660,10330,718,100
134127272,134125694,134135370,9676,719,100
134140762,134139401,134147593,8192,720,100
134153021,134151660,134161435,9775,721,100
134166860,134165498,134175612,10114,722,100
134181224,134179646,134189005,9359,723,100
134194363,134193002,134201193,8191,724,100
134206716,134205138,134214181,9043,725,100
134219570,134218208,134227033,8825,726,100
134232557,134230979,134241288,10309,727,100
134246790,134245429,134255205,9776,728,100
134260728,134259150,134267875,8725,729,100
134273398,134272037,134281496,9459,730,100
134286906,134285543,134294054,8511,731,100
134299577,134297999,134307358,9359,732,100
134312772,134311411,134321524,10113,733,100
134327136,134325558,134333651,8093,734,100
134339036,134337674,134345551,7877,735,100
134351074,134349496,134357906,8410,736,100
134363429,134361851,134371210,9359,737,100
134376733,134375155,134385146,9991,738,100
134390575,134389214,134398356,9142,739,100
134403879,134402301,134411027,8726,740,100
134416408,134415047,134424504,9457,741,100
134430027,134428449,134437175,8726,742,100
134442699,134441120,134450480,9360,743,100
134456003,134454425,134462813,8388,744,100
134468333,134466972,134475798,8826,745,100
134481322,134479743,134488132,8389,746,100
134493529,134492168,134500677,8509,747,100
134506199,134504622,134513664,9042,748,100
134519032,134517670,134525547,7877,749,100
134531070,134529492,134537880,8388,750,100
134543297,134541936,134550444,8508,751,100
134555848,134554487,134563313,8826,752,100
134568691,134567330,134576472,9142,753,100
134581898,134580536,134588707,8171,754,100
134594231,134592652,134602646,9994,755,100
134608027,134606665,134615807,9142,756,100
134621330,134619752,134628795,9043,757,100
134634319,134632740,134642100,9360,758,100
134647454,134646093,134654919,8826,759,100
134660443,134658864,134669174,10310,760,100
134674786,134673208,134682884,9676,761,100
134688264,134686902,134696995,10093,762,100
134702607,134701029,134709755,8726,763,100
134715183,134713821,134722965,9144,764,100
134728334,134726973,134736430,9457,765,100
134741806,134740444,134748954,8510,766,100
134754478,134752899,134760993,8094,767,100
134766397,134765035,134775128,10093,768,100
134780524,134779162,134788890,9728,769,100
134794413,134792835,134802194,9359,770,100
134807717,134806139,134815814,9675,771,100
134821337,134819759,134828485,8726,772,100
134834009,134832431,134842739,10308,773,100
134848351,134846773,134856449,9676,774,100
134861972,134860394,134870070,9676,775,100
134875593,134874015,134882404,8389,776,100
134887928,134886349,134896026,9677,777,100
134901550,134899971,134908064,8093,778,100
134913588,134912009,134920102,8093,779,100
134925626,134924047,134933407,9360,780,100
134938772,134937411,134946237,8826,781,100
134951603,134950241,134958414,8173,782,100
134963793,134962432,134971574,9142,783,100
134977097,134975519,134985194,9675,784,100
134990576,134989214,134999307,10093,785,100
135004919,135003341,135012384,9043,786,100
135017758,135016396,135024272,7876,787,100
135029795,135028217,135037260,9043,788,100
135042783,135041205,135051198,9993,789,100
135056582,135055221,135063393,8172,790,100
135068916,135067338,135077330,9992,791,100
135082728,135081366,135090193,8827,792,100
135095715,135094352,135104445,10093,793,100
135109972,135108611,135117437,8826,794,100
135122961,135121383,135131375,9992,795,100
135136898,135135320,135144679,9359,796,100
135150203,135148625,135157667,9042,797,100
135163191,135161613,135170972,9359,798,100
135176495,135174917,135183958,9041,799,100
135189481,135187903,135196629,8726,800,100
135202152,135200574,135210883,10309,801,100
135216357,135214995,135225109,10114,802,100
135230722,135229143,135239136,9993,803,100
135244568,135243206,135251378,8172,804,100
135256901,135255323,135264999,9676,805,100
135270393,135269032,135278491,9459,806,100
135283861,135282500,135290375,7875,807,100
135295898,135294320,135302709,8389,808,100
135308232,135306654,135316013,9359,809,100
135321373,135320011,135328838,8827,810,100
135334253,135332891,135342984,10093,811,100
135348438,135347077,135355586,8509,812,100
135360962,135359600,135368743,9143,813,100
135374125,135372764,135381589,8825,814,100
135387107,135385534,135393917,8383,815,100
135399440,135397862,135408171,10309,816,100
135413566,135412205,135422248,10043,817,100
135427732,135426370,135435830,9460,818,100
135441206,135439844,135448354,8510,819,100
135453877,135452299,135461025,8726,820,100
135466546,135464971,135473061,8090,821,100
135478585,135477006,135486365,9359,822,100
135491887,135490310,135499984,9674,823,100
135505505,135504144,135512652,8508,824,100
135518051,135516689,135526149,9460,825,100
135531674,135530095,135538189,8094,826,100
135543551,135542190,135551966,9776,827,100
135557489,135555911,135565903,9992,828,100
135571305,135569943,135579718,9775,829,100
135585241,135583663,135591756,8093,830,100
135597178,135595816,135604643,8827,831,100
135610167,135608589,135617315,8726,832,100
135622838,135621260,135630618,9358,833,100
135636037,135634676,135643184,8508,834,100
135648582,135647221,135655096,7875,835,100
135660503,135659142,135667651,8509,836,100
135673054,135671693,135679569,7876,837,100
135685089,135683728,135691603,7875,838,100
135697127,135695548,135704275,8727,839,100
135709797,135708220,135717894,9674,840,100
135723417,135721839,135730882,9043,841,100
135736283,135734922,135743431,8509,842,100
135748954,135747376,135755786,8410,843,100
135761207,135759845,135767722,7877,844,100
135773245,135771667,135781997,10330,845,100
135787461,135786099,135794925,8826,846,100
135800321,135798960,135809052,10092,847,100
135814596,135813235,135822377,9142,848,100
135827900,135826322,135835681,9359,849,100
135841204,135839626,135848014,8388,850,100
135853538,135851959,135860370,8411,851,100
135865892,135864315,135873673,9358,852,100
135879075,135877713,135885906,8193,853,100
135891429,135889851,135898577,8726,854,100
135904102,135902739,135912516,9777,855,100
135918039,135916461,135926454,9993,856,100
135931977,135930399,135938809,8410,857,100
135944332,135942754,135951164,8410,858,100
135956687,135955109,135965100,9991,859,100
135970510,135969149,135978291,9142,860,100
135983815,135982237,135992546,10309,861,100
135998158,135996580,136005306,8726,862,100
136010829,136009251,136018610,9359,863,100
136024133,136022555,136031281,8726,864,100
136036707,136035346,136044805,9459,865,100
136050210,136048848,136058623,9775,866,100
136064003,136062640,136072417,9777,867,100
136077940,136076362,136085720,9358,868,100
136091243,136089665,136097757,8092,869,100
136103280,136101702,136111377,9675,870,100
136116900,136115322,136123414,8092,871,100
136128830,136127469,136135639,8170,872,100
136141162,136139584,136148626,9042,873,100
136154004,136152643,136161152,8509,874,100
136166675,136165097,136175427,10330,875,100
136181039,136179461,136188504,9043,876,100
136194028,136192449,136202126,9677,877,100
136207650,136206071,136216381,10310,878,100
136221994,136220415,136229775,9360,879,100
136235170,136233809,136242317,8508,880,100
136247840,136246262,136255304,9042,881,100
136260705,136259343,136268170,8827,882,100
136273692,136272330,136280207,7877,883,100
136285594,136284232,136293374,9142,884,100
136298897,136297319,136305706,8387,885,100
136311229,136309651,136319011,9360,886,100
136324535,136322956,136331998,9042,887,100
136337394,136336033,136345492,9459,888,100
136351016,136349437,136357531,8094,889,100
136363054,136361476,136371784,10308,890,100
136377273,136375912,136385053,9141,891,100
136390410,136389048,136398824,9776,892,100
136404347,136402769,136411495,8726,893,100
136416870,136415508,136424335,8827,894,100
136429858,136428280,136436373,8093,895,100
136441802,136440440,136448950,8510,896,100
136454342,136452980,136461152,8172,897,100
136466675,136465097,136473190,8093,898,100
136478714,136477135,136486178,9043,899,100
136491541,136490179,136499006,8827,900,100
136504529,136502951,136511044,8093,901,100
136516567,136514989,136525298,10309,902,100
136530911,136529332,136537425,8093,903,100
136542827,136541465,136550291,8826,904,100
136555814,136554236,136562962,8726,905,100
136568482,136566907,136576263,9356,906,100
136581691,136580330,136589788,9458,907,100
136595312,136593733,136603727,9994,908,100
136609250,136607672,136617981,10309,909,100
136623593,136622015,136631058,9043,910,100
136636582,136635220,136644680,9460,911,100
136650038,136648677,136658769,10092,912,100
136664381,136662803,136672162,9359,913,100
136677685,136676107,136684833,8726,914,100
136690356,136688778,136696870,8092,915,100
136702393,136700815,136711124,10309,916,100
136716736,136715158,136724201,9043,917,100
136729724,136728146,136737189,9043,918,100
136742596,136741235,136751347,10112,919,100
136756959,136755381,136765689,10308,920,100
136771301,136769723,136778112,8389,921,100
136783634,136782057,136790782,8725,922,100
136796306,136794728,136802821,8093,923,100
136808186,136806825,136814997,8172,924,100
136820372,136819011,136826887,7876,925,100
136832296,136830935,136840394,9459,926,100
136845917,136844339,136853065,8726,927,100
136858588,136857010,136867001,9991,928,100
136872524,136870946,136879039,8093,929,100
136884563,136882985,136891374,8389,930,100
136896803,136895442,136903951,8509,931,100
136909474,136907896,136915989,8093,932,100
136921512,136919934,136929294,9360,933,100
136934814,136933239,136941329,8090,934,100
136946744,136945382,136954526,9144,935,100
136960050,136958688,136967198,8510,936,100
136972722,136971143,136979237,8094,937,100
136984760,136983399,136993491,10092,938,100
136999103,136997525,137005913,8388,939,100
137011437,137009858,137018585,8727,940,100
137024108,137022530,137031573,9043,941,100
137037097,137035518,137044878,9360,942,100
137050273,137048912,137058688,9776,943,100
137064211,137062633,137072309,9676,944,100
137077832,137076254,137084347,8093,945,100
137089870,137088292,137097651,9359,946,100
137103175,137101596,137111590,9994,947,100
137117114,137115536,137124895,9359,948,100
137130418,137128840,137136933,8093,949,100
137142456,137140878,137148971,8093,950,100
137154367,137153005,137163098,10093,951,100
137168606,137167244,137176704,9460,952,100
137182228,137180866,137189039,8173,953,100
137194563,137192985,137201078,8093,954,100
137206601,137205023,137213411,8388,955,100
137218934,137217356,137227665,10309,956,100
137233277,137231699,137240109,8410,957,100
137245631,137244054,137253412,9358,958,100
137258935,137257574,137266400,8826,959,100
137271829,137270467,137279927,9460,960,100
137285451,137283873,137294182,10309,961,100
137299707,137298346,137308438,10092,962,100
137313833,137312472,137323149,10677,963,100
137328761,137327183,137335909,8726,964,100
137341432,137339854,137348243,8389,965,100
137353766,137352188,137361231,9043,966,100
137366628,137365267,137373143,7876,967,100
137378666,137377088,137385814,8726,968,100
137391336,137389759,137398801,9042,969,100
137404177,137402815,137410691,7876,970,100
137416059,137414697,137422891,8194,971,100
137428415,137426836,137434930,8094,972,100
137440454,137438875,137448235,9360,973,100
137453758,137452397,137461856,9459,974,100
137467380,137466018,137475478,9460,975,100
137480840,137479478,137487651,8173,976,100
137493175,137491596,137501906,10310,977,100
137507518,137505940,137515933,9993,978,100
137521457,137519878,137530188,10310,979,100
137535680,137534317,137542195,7878,980,100
137547583,137546221,137556335,10114,981,100
137561948,137560370,137570678,10308,982,100
137576290,137574712,137584071,9359,983,100
137589447,137588086,137596258,8172,984,100
137601781,137600203,137610512,10309,985,100
137616124,137614546,137622638,8092,986,100
137628161,137626583,137635309,8726,987,100
137640832,137639254,137647346,8092,988,100
137652870,137651291,137660018,8727,989,100
137665541,137663963,137672689,8726,990,100
137678212,137676634,137685022,8388,991,100
137690545,137688967,137698641,9674,992,100
137704007,137702646,137710818,8172,993,100
137716341,137714763,137723806,9043,994,100
137729330,137727751,137736139,8388,995,100
137741662,137740084,137748177,8093,996,100
137753565,137752204,137760079,7875,997,100
137765601,137764239,137772116,7877,998,100
137777496,137776134,137786227,10093,999,100
137791692,137790330,137798839,8509,1000,100
137804451,137802873,137812232,9359,1001,100
137817718,137816356,137824529,8173,1002,100
137830142,137828563,137837289,8726,1003,100
137842901,137841323,137849710,8387,1004,100
137855189,137853828,137862000,8172,1005,100
137867464,137866103,137874273,8170,1006,100
137879885,137878307,137888300,9993,1007,100
137893913,137892334,137901378,9044,1008,100
137906892,137905530,137914356,8826,1009,100
137919825,137918463,137927923,9460,1010,100
137933384,137932022,137942113,10091,1011,100
137947814,137946236,137956545,10309,1012,100
137962247,137960668,137968762,8094,1013,100
137974212,137972850,137982626,9776,1014,100
137988076,137986715,137995857,9142,1015,100
138001469,137999891,138008279,8388,1016,100
138013765,138012403,138022496,10093,1017,100
138028197,138026619,138036928,10309,1018,100
138042498,138041137,138049013,7876,1019,100
138054474,138053113,138063205,10092,1020,100
138068781,138067419,138077512,10093,1021,100
138083213,138081635,138090678,9043,1022,100
138096291,138094712,138105022,10310,1023,100
138110633,138109272,138117780,8508,1024,100
138123232,138121870,138130697,8827,1025,100
138136309,138134731,138145039,10308,1026,100
138150594,138149232,138158691,9459,1027,100
138164302,138162725,138171767,9042,1028,100
138177379,138175801,138184844,9043,1029,100
138190358,138188996,138197822,8826,1030,100
138203434,138201856,138210899,9043,1031,100
138216511,138214933,138223658,8725,1032,100
138229201,138227840,138237932,10092,1033,100
138243633,138242055,138251731,9676,1034,100
138257260,138255899,138263774,7875,1035,100
138269386,138267808,138277484,9676,1036,100
138283096,138281518,138291511,9993,1037,100
138296994,138295632,138305408,9776,1038,100
138311020,138309442,138318168,8726,1039,100
138323706,138322344,138330221,7877,1040,100
138335709,138334347,138343806,9459,1041,100
138349419,138347840,138356567,8727,1042,100
138362054,138360692,138368864,8172,1043,100
138374476,138372898,138383206,10308,1044,100
138388906,138387329,138395717,8388,1045,100
138401329,138399751,138409425,9674,1046,100
138415037,138413459,138423135,9676,1047,100
138428747,138427169,138436211,9042,1048,100
138441662,138440300,138448810,8510,1049,100
138454422,138452844,138461231,8387,1050,100
138466781,138465419,138473612,8193,1051,100
138479076,138477714,138486223,8509,1052,100
138491687,138490325,138499468,9143,1053,100
138505080,138503502,138512545,9043,1054,100
138518015,138516653,138526113,9460,1055,100
138531653,138530291,138538167,7876,1056,100
138543779,138542201,138551243,9042,1057,100
138556785,138555423,138564250,8827,1058,100
138569710,138568348,138576858,8510,1059,100
138582470,138580892,138590884,9992,1060,100
138596496,138594918,138604276,9358,1061,100
138609743,138608382,138617208,8826,1062,100
138622820,138621242,138629651,8409,1063,100
138635199,138633837,138641713,7876,1064,100
138647325,138645747,138654473,8726,1065,100
138660086,138658507,138668184,9677,1066,100
138673667,138672305,138680815,8510,1067,100
138686427,138684849,138692942,8093,1068,100
138698478,138697116,138704993,7877,1069,100
138710463,138709101,138717294,8193,1070,100
138722736,138721374,138730833,9459,1071,100
138736445,138734867,138743593,8726,1072,100
138749205,138747627,138755720,8093,1073,100
138761332,138759754,138770063,10309,1074,100
138775639,138774278,138783104,8826,1075,100
138788717,138787138,138796499,9361,1076,100
138802112,138800533,138808922,8389,1077,100
138814437,138813076,138821584,8508,1078,100
138827037,138825675,138834185,8510,1079,100
138839731,138838370,138848462,10092,1080,100
138854044,138852683,138862141,9458,1081,100
138867678,138866317,138874193,7876,1082,100
138879669,138878307,138886479,8172,1083,100
138892091,138890513,138900821,10308,1084,100
138906522,138904944,138914303,9359,1085,100
138919768,138918407,138927866,9459,1086,100
138933403,138932041,138941184,9143,1087,100
138946637,138945275,138954734,9459,1088,100
138960346,138958768,138967493,8725,1089,100
138972936,138971575,138981033,9458,1090,100
138986494,138985133,138993641,8508,1091,100
138999158,138997796,139005969,8173,1092,100
139011582,139010003,139019363,9360,1093,100
139024975,139023397,139033389,9992,1094,100
139039001,139037423,139046782,9359,1095,100
139052305,139050944,139061036,10092,1096,100
139066610,139065248,139073420,8172,1097,100
139078932,139077570,139086713,9143,1098,100
139092218,139090856,139099682,8826,1099,100
139105295,139103716,139114047,10331,1100,100
139119623,139118261,139126138,7877,1101,100
139131595,139130234,139139693,9459,1102,100
139145305,139143727,139154036,10309,1103,100
139159567,139158205,139166715,8510,1104,100
139172158,139170797,139178673,7876,1105,100
139184286,139182707,139192700,9993,1106,100
139198313,139196734,139205461,8727,1107,100
139210904,139209543,139219635,10092,1108,100
139225336,139223758,139232801,9043,1109,100
139238267,139236905,139245415,8510,1110,100
139250925,139249564,139259023,9459,1111,100
139264636,139263058,139272099,9041,1112,100
139277711,139276133,139285492,9359,1113,100
139290939,139289577,139299353,9776,1114,100
139304965,139303387,139313379,9992,1115,100
139318866,139317505,139325381,7876,1116,100
139330993,139329415,139337507,8092,1117,100
139342986,139341625,139351400,9775,1118,100
139356847,139355484,139363994,8510,1119,100
139369606,139368028,139378336,10308,1120,100
139384037,139382459,139392451,9992,1121,100
139397976,139396615,139406074,9459,1122,100
139411541,139410179,139420272,10093,1123,100
139425972,139424394,139434703,10309,1124,100
139440404,139438826,139448501,9675,1125,100
139454113,139452535,139461578,9043,1126,100
139467046,139465685,139473857,8172,1127,100
139479470,139477891,139488201,10310,1128,100
139493903,139492324,139502318,9994,1129,100
139507763,139506401,139516177,9776,1130,100
139521789,139520211,139529252,9041,1131,100
139534729,139533368,139542193,8825,1132,100
139547806,139546227,139554615,8388,1133,100
139560228,139558649,139567376,8727,1134,100
139572989,139571410,139579798,8388,1135,100
139585411,139583832,139593191,9359,1136,100
139598686,139597324,139605497,8173,1137,100
139611108,139609531,139619839,10308,1138,100
139625432,139624070,139632897,8827,1139,100
139638385,139637023,139646483,9460,1140,100
139651931,139650570,139659078,8508,1141,100
139664690,139663112,139673420,10308,1142,100
139678983,139677621,139687714,10093,1143,100
139693416,139691837,139700881,9044,1144,100
139706350,139704989,139714764,9775,1145,100
139720258,139718897,139727406,8509,1146,100
139732859,139731498,139739374,7876,1147,100
139744986,139743408,139753083,9675,1148,100
139758695,139757117,139766159,9042,1149,100
139771771,139770193,139778602,8409,1150,100
139784213,139782635,139791361,8726,1151,100
139796811,139795450,139804909,9459,1152,100
139810521,139808943,139817035,8092,1153,100
139822497,139821136,139830278,9142,1154,100
139835745,139834384,139842556,8172,1155,100
139848168,139846590,139856899,10309,1156,100
139862600,139861022,139871331,10309,1157,100
139876917,139875556,139883432,7876,1158,100
139889044,139887466,139896192,8726,1159,100
139901642,139900281,139910057,9776,1160,100
139915548,139914187,139924279,10092,1161,100
139929859,139928498,139936374,7876,1162,100
139941986,139940408,139948501,8093,1163,100
139953989,139952627,139962086,9459,1164,100
139967698,139966120,139975163,9043,1165,100
139980776,139979197,139989507,10310,1166,100
139995036,139993675,140002184,8509,1167,100
140007667,140006305,140015764,9459,1168,100
140021376,140019798,140028524,8726,1169,100
140034070,140032708,140041851,9143,1170,100
140047305,140045944,140055403,9459,1171,100
140060870,140059508,140068650,9142,1172,100
140074263,140072685,140082361,9676,1173,100
140087876,140086514,140096290,9776,1174,100
140101902,140100324,140109682,9358,1175,100
140115294,140113716,140122758,9042,1176,100
140128201,140126839,140135349,8510,1177,100
140140812,140139450,140148277,8827,1178,100
140153763,140152402,140160574,8172,1179,100
140166080,140164719,140173228,8509,1180,100
140178755,140177394,140185270,7876,1181,100
140190882,140189304,140199296,9992,1182,100
140204908,140203330,140212373,9043,1183,100
140217917,140216556,140225065,8509,1184,100
140230555,140229193,140237702,8509,1185,100
140243197,140241836,140250662,8826,1186,100
140256132,140254771,140263597,8826,1187,100
140269094,140267732,140277824,10092,1188,100
140283525,140281947,140290673,8726,1189,100
140296286,140294707,140303096,8389,1190,100
140308561,140307200,140316975,9775,1191,100
140322450,140321089,140329598,8509,1192,100
140335057,140333696,140343788,10092,1193,100
140349398,140348036,140356863,8827,1194,100
140362476,140360897,140368991,8094,1195,100
140374603,140373025,140381751,8726,1196,100
140387363,140385785,140394511,8726,1197,100
140400124,140398545,140406638,8093,1198,100
140412251,140410672,140419061,8389,1199,100
140424549,140423187,140432647,9460,1200,100
140438129,140436768,140446226,9458,1201,100
140451692,140450331,140459157,8826,1202,100
140464686,140463325,140472783,9458,1203,100
140478396,140476818,140485545,8727,1204,100
140491158,140489579,140499256,9677,1205,100
140504753,140503391,140512850,9459,1206,100
140518462,140516884,140526876,9992,1207,100
140532488,140530910,140540269,9359,1208,100
140545711,140544350,140552858,8508,1209,100
140558372,140557011,140566469,9458,1210,100
140572081,140570503,140579545,9042,1211,100
140585158,140583579,140592938,9359,1212,100
140598424,140597063,140607155,10092,1213,100
140612705,140611343,140620169,8826,1214,100
140625676,140624315,140634407,10092,1215,100
140639984,140638622,140647766,9144,1216,100
140653288,140651926,140662019,10093,1217,100
140667720,140666142,140676135,9993,1218,100
140681748,140680170,140689846,9676,1219,100
140695320,140693959,140703102,9143,1220,100
140708716,140707137,140716181,9044,1221,100
140721795,140720216,140728310,8094,1222,100
140733922,140732345,140740732,8387,1223,100
140746346,140744767,140752861,8094,1224,100
140758474,140756896,140766255,9359,1225,100
140771868,140770289,140778383,8094,1226,100
140783865,140782504,140791646,9142,1227,100
140797258,140795681,140805355,9674,1228,100
140810881,140809520,140817396,7876,1229,100
140822912,140821550,140830692,9142,1230,100
140836304,140834726,140843114,8388,1231,100
140848628,140847267,140856410,9143,1232,100
140862023,140860444,140870121,9677,1233,100
140875589,140874227,140884004,9777,1234,100
140889532,140888170,140896680,8510,1235,100
140902292,140900714,140908807,8093,1236,100
140914327,140912966,140920841,7875,1237,100
140926389,140925028,140935120,10092,1238,100
140940822,140939243,140947633,8390,1239,100
140953246,140951667,140959760,8093,1240,100
140965372,140963794,140973153,9359,1241,100
140978765,140977187,140986230,9043,1242,100
140991843,140990264,140999623,9359,1243,100
141005235,141003657,141012067,8410,1244,100
141017680,141016101,141024195,8094,1245,100
141029679,141028317,141036827,8510,1246,100
141042440,141040861,141050854,9993,1247,100
141056347,141054986,141063495,8509,1248,100
141069107,141067529,141077859,10330,1249,100
141083469,141082107,141091249,9142,1250,100
141096861,141095283,141104642,9359,1251,100
141110255,141108676,141118352,9676,1252,100
141123834,141122472,141130981,8509,1253,100
141136593,141135015,141143424,8409,1254,100
141149036,141147458,141157767,10309,1255,100
141163468,141161890,141170616,8726,1256,100
141176229,141174650,141183040,8390,1257,100
141188505,141187143,141196603,9460,1258,100
141202217,141200638,141208732,8094,1259,100
141214215,141212854,141222946,10092,1260,100
141228503,141227141,141236600,9459,1261,100
141242213,141240634,141250311,9677,1262,100
141255799,141254437,141264214,9777,1263,100
141269726,141268364,141278141,9777,1264,100
141283658,141282297,141290806,8509,1265,100
141296297,141294935,141303129,8194,1266,100
141308741,141307163,141316839,9676,1267,100
141322452,141320873,141331182,10309,1268,100
141336883,141335305,141344981,9676,1269,100
141350593,141349015,141357740,8725,1270,100
141363201,141361840,141369715,7875,1271,100
141375179,141373818,141383910,10092,1272,100
141389470,141388109,141395984,7875,1273,100
141401596,141400018,141409694,9676,1274,100
141415167,141413805,141422632,8827,1275,100
141428131,141426770,141434961,8191,1276,100
141440476,141439114,141447941,8827,1277,100
141453553,141451975,141461967,9992,1278,100
141467478,141466117,141474310,8193,1279,100
141479778,141478416,141487242,8826,1280,100
141492855,141491276,141500320,9044,1281,100
141505933,141504354,141512448,8094,1282,100
141517984,141516622,141526398,9776,1283,100
141532011,141530432,141540742,10310,1284,100
141546443,141544865,141553908,9043,1285,100
141559434,141558072,141568165,10093,1286,100
141573696,141572334,141580506,8172,1287,100
141585998,141584637,141594412,9775,1288,100
141599930,141598568,141608681,10113,1289,100
141614279,141612918,141620794,7876,1290,100
141626407,141624828,141634821,9993,1291,100
141640433,141638855,141647265,8410,1292,100
141652877,141651299,141659709,8410,1293,100
141665322,141663743,141672786,9043,1294,100
141678315,141676954,141686730,9776,1295,100
141692342,141690764,141699490,8726,1296,100
141705102,141703524,141713832,10308,1297,100
141719417,141718056,141727514,9458,1298,100
141733049,141731687,141741146,9459,1299,100
141746758,141745180,141753273,8093,1300,100
141758885,141757307,141765399,8092,1301,100
141771011,141769433,141778791,9358,1302,100
141784403,141782825,141790918,8093,1303,100
141796381,141795019,141804796,9777,1304,100
141810251,141808890,141816765,7875,1305,100
141822377,141820799,141830475,9676,1306,100
141836087,141834509,141844185,9676,1307,100
141849797,141848219,141856628,8409,1308,100
141862241,141860662,141870993,10331,1309,100
141876694,141875116,141884792,9676,1310,100
141890404,141888826,141897869,9043,1311,100
141903481,141901903,141909996,8093,1312,100
141915472,141914111,141923253,9142,1313,100
141928865,141927287,141936013,8726,1314,100
141941544,141940183,141948058,7875,1315,100
141953670,141952092,141961768,9676,1316,100
141967381,141965802,141974846,9044,1317,100
141980458,141978880,141987606,8726,1318,100
141993095,141991734,142000559,8825,1319,100
142006171,142004593,142013953,9360,1320,100
142019406,142018044,142028157,10113,1321,100
142033858,142032280,142042271,9991,1322,100
142047753,142046392,142056483,10091,1323,100
142062042,142060680,142070140,9460,1324,100
142075752,142074174,142084503,10329,1325,100
142090204,142088626,142096718,8092,1326,100
142102330,142100752,142109479,8727,1327,100
142115091,142113513,142122872,9359,1328,100
142128397,142127036,142135861,8825,1329,100
142141473,142139895,142148938,9043,1330,100
142154551,142152972,142161360,8388,1331,100
142166972,142165394,142175387,9993,1332,100
142180920,142179560,142189017,9457,1333,100
142194567,142193205,142201714,8509,1334,100
142207204,142205843,142213719,7876,1335,100
142219209,142217848,142226989,9141,1336,100
142232601,142231023,142240699,9676,1337,100
142246166,142244804,142254580,9776,1338,100
142260193,142258614,142267341,8727,1339,100
142272953,142271375,142281683,10308,1340,100
142287384,142285806,142295799,9993,1341,100
142301411,142299833,142308559,8726,1342,100
142314020,142312658,142321167,8509,1343,100
142326779,142325201,142334877,9676,1344,100
142340351,142338990,142347161,8171,1345,100
142352773,142351195,142359921,8726,1346,100
142365533,142363955,142373630,9675,1347,100
142379117,142377756,142386581,8825,1348,100
142392194,142390615,142400609,9994,1349,100
142406221,142404643,142413032,8389,1350,100
142418644,142417066,142425791,8725,1351,100
142431278,142429916,142439692,9776,1352,100
142445172,142443810,142453903,10093,1353,100
142459604,142458026,142466415,8389,1354,100
142471936,142470574,142479083,8509,1355,100
142484695,142483117,142492477,9360,1356,100
142498090,142496511,142505238,8727,1357,100
142510705,142509344,142518803,9459,1358,100
142524416,142522837,142531881,9044,1359,100
142537492,142535915,142544640,8725,1360,100
142550190,142548829,142557022,8193,1361,100
142562634,142561056,142570099,9043,1362,100
142575562,142574201,142582076,7875,1363,100
142587533,142586172,142595314,9142,1364,100
142600756,142599395,142608220,8825,1365,100
142613755,142612393,142621853,9460,1366,100
142627343,142625982,142634174,8192,1367,100
142639786,142638208,142646301,8093,1368,100
142651913,142650335,142659695,9360,1369,100
142665307,142663729,142672771,9042,1370,100
142678383,142676805,142687135,10330,1371,100
142692697,142691335,142699212,7877,1372,100
142704673,142703312,142711483,8171,1373,100
142717096,142715517,142725193,9676,1374,100
142730667,142729305,142738448,9143,1375,100
142743995,142742634,142751777,9143,1376,100
142757238,142755877,142765336,9459,1377,100
142770795,142769434,142778577,9143,1378,100
142784050,142782688,142791831,9143,1379,100
142797443,142795865,142805541,9676,1380,100
142811154,142809575,142817668,8093,1381,100
142823281,142821702,142831379,9677,1382,100
142836865,142835504,142844647,9143,1383,100
142850260,142848681,142857725,9044,1384,100
142863185,142861823,142870332,8509,1385,100
142875944,142874366,142883409,9043,1386,100
142888911,142887550,142897009,9459,1387,100
142902457,142901096,142910554,9458,1388,100
142916095,142914734,142923876,9142,1389,100
142929489,142927910,142936638,8728,1390,100
142942103,142940741,142949885,9144,1391,100
142955497,142953919,142962307,8388,1392,100
142967919,142966341,142974730,8389,1393,100
142980176,142978815,142987324,8509,1394,100
142992832,142991470,142999643,8173,1395,100
143005097,143003735,143011908,8173,1396,100
143017520,143015942,143024984,9042,1397,100
143030597,143029018,143037407,8389,1398,100
143043019,143041441,143049829,8388,1399,100
143055442,143053863,143062907,9044,1400,100
143068389,143067028,143075198,8170,1401,100
143080665,143079303,143088128,8825,1402,100
143093612,143092250,143101393,9143,1403,100
143106907,143105546,143113422,7876,1404,100
143118948,143117586,143127700,10114,1405,100
143133401,143131823,143140866,9043,1406,100
143146479,143144900,143153943,9043,1407,100
143159489,143158128,143166638,8510,1408,100
143172115,143170753,143178630,7877,1409,100
143184242,143182664,143190756,8092,1410,100
143196369,143194791,143203517,8726,1411,100
143209048,143207687,143216196,8509,1412,100
143221691,143220329,143229156,8827,1413,100
143234679,143233318,143241490,8172,1414,100
143247103,143245524,143253914,8390,1415,100
143259527,143257948,143267942,9994,1416,100
143273554,143271976,143280365,8389,1417,100
143285977,143284399,143292787,8388,1418,100
143298332,143296970,143305797,8827,1419,100
143311346,143309985,143318156,8171,1420,100
143323641,143322280,143331422,9142,1421,100
143336899,143335538,143344047,8509,1422,100
143349661,143348082,143358075,9993,1423,100
143363605,143362243,143370120,7877,1424,100
143375561,143374199,143383659,9460,1425,100
143389271,143387693,143396080,8387,1426,100
143401693,143400114,143409790,9676,1427,100
143415268,143413906,143422416,8510,1428,100
143427922,143426561,143434436,7875,1429,100
143440048,143438470,143447513,9043,1430,100
143453125,143451547,143459936,8389,1431,100
143465548,143463970,143472359,8389,1432,100
143477850,143476488,143484661,8173,1433,100
143490201,143488840,143497349,8509,1434,100
143502843,143501482,143510307,8825,1435,100
143515919,143514341,143523066,8725,1436,100
143528510,143527149,143535024,7875,1437,100
143540637,143539058,143547151,8093,1438,100
143552763,143551185,143561177,9992,1439,100
143566697,143565336,143573212,7876,1440,100
143578681,143577319,143586779,9460,1441,100
143592238,143590876,143600335,9459,1442,100
143605801,143604440,143612949,8509,1443,100
143618493,143617131,143625007,7876,1444,100
143630619,143629041,143637767,8726,1445,100
143643379,143641801,143652110,10309,1446,100
143657810,143656232,143664621,8389,1447,100
143670232,143668655,143677043,8388,1448,100
143682656,143681077,143690119,9042,1449,100
143695642,143694281,143703739,9458,1450,100
143709352,143707773,143716499,8726,1451,100
143722031,143720670,143730129,9459,1452,100
143735570,143734209,143742085,7876,1453,100
143747549,143746187,143755331,9144,1454,100
143760943,143759365,143769674,10309,1455,100
143775375,143773797,143782523,8726,1456,100
143788136,143786557,143795601,9044,1457,100
143801213,143799635,143808994,9359,1458,100
143814518,143813157,143822615,9458,1459,100
143828227,143826649,143836008,9359,1460,100
143841620,143840042,143850350,10308,1461,100
143856052,143854473,143864467,9994,1462,100
143870016,143868654,143877481,8827,1463,100
143882946,143881585,143890094,8509,1464,100
143895641,143894279,143904056,9777,1465,100
143909668,143908090,143917765,9675,1466,100
143923377,143921799,143930209,8410,1467,100
143935822,143934244,143942337,8093,1468,100
143947796,143946434,143954944,8510,1469,100
143960556,143958978,143968338,9360,1470,100
143973951,143972373,143982682,10309,1471,100
143988228,143986866,143995376,8510,1472,100
144000988,143999410,144009085,9675,1473,100
144014697,144013119,144022478,9359,1474,100
144027973,144026612,144036386,9774,1475,100
144041931,144040570,144049079,8509,1476,100
144054572,144053210,144062352,9142,1477,100
144067807,144066446,144075905,9459,1478,100
144081442,144080080,144089856,9776,1479,100
144095324,144093963,144102789,8826,1480,100
144108268,144106907,144115415,8508,1481,100
144121027,144119449,144128807,9358,1482,100
144134300,144132939,144142082,9143,1483,100
144147591,144146228,144155055,8827,1484,100
144160605,144159243,144168702,9459,1485,100
144174226,144172864,144182640,9776,1486,100
144188253,144186674,144194768,8094,1487,100
144200269,144198908,144208049,9141,1488,100
144213511,144212149,144221292,9143,1489,100
144226839,144225478,144235252,9774,1490,100
144240797,144239435,144247944,8509,1491,100
144253556,144251978,144260704,8726,1492,100
144266205,144264844,144273985,9141,1493,100
144279494,144278132,144286009,7877,1494,100
144291621,144290043,144298432,8389,1495,100
144304045,144302466,144310855,8389,1496,100
144316467,144314889,144324564,9675,1497,100
144330071,144328709,144337219,8510,1498,100
144342832,144341253,144351247,9994,1499,100
144356859,144355281,144363374,8093,1500,100
144368986,144367408,144376450,9042,1501,100
144382063,144380484,144390161,9677,1502,100
144395773,144394195,144402584,8389,1503,100
144408196,144406618,144414710,8092,1504,100
144420323,144418744,144429054,10310,1505,100
144434754,144433176,144443484,10308,1506,100
144449015,144447654,144457744,10090,1507,100
144463309,144461948,144470774,8826,1508,100
144476262,144474901,144484042,9141,1509,100
144489482,144488121,144496292,8171,1510,100
144501904,144500326,144508419,8093,1511,100
144513882,144512520,144520396,7876,1512,100
144525901,144524539,144534632,10093,1513,100
144540333,144538755,144548430,9675,1514,100
144553898,144552537,144560413,7876,1515,100
144565864,144564502,144572378,7876,1516,100
144577991,144576412,144585771,9359,1517,100
144591320,144589958,144598785,8827,1518,100
144604398,144602819,144612179,9360,1519,100
144617727,144616366,144625824,9458,1520,100
144631436,144629858,144638247,8389,1521,100
144643859,144642281,144650373,8092,1522,100
144655827,144654466,144662638,8172,1523,100
144668149,144666788,144676564,9776,1524,100
144682176,144680598,144690906,10308,1525,100
144696518,144695157,144704299,9142,1526,100
144709911,144708333,144716426,8093,1527,100
144721914,144720553,144728428,7875,1528,100
144734040,144732462,144741187,8725,1529,100
144746800,144745221,144753315,8094,1530,100
144758927,144757349,144766709,9360,1531,100
144772322,144770743,144780418,9675,1532,100
144786030,144784452,144793811,9359,1533,100
144799424,144797845,144807521,9676,1534,100
144813132,144811555,144821229,9674,1535,100
144826722,144825360,144835137,9777,1536,100
144840750,144839171,144849164,9993,1537,100
144854630,144853269,144863045,9776,1538,100
144868571,144867209,144876986,9777,1539,100
144882598,144881020,144889409,8389,1540,100
144895021,144893443,144902486,9043,1541,100
144908001,144906640,144915149,8509,1542,100
144920635,144919274,144927445,8171,1543,100
144933057,144931479,144940522,9043,1544,100
144946057,144944695,144954472,9777,1545,100
144959978,144958617,144967126,8509,1546,100
144972737,144971160,144980202,9042,1547,100
144985652,144984291,144992800,8509,1548,100
144998346,144996984,145005178,8194,1549,100
145010790,145009212,145018571,9359,1550,100
145024015,145022654,145032746,10092,1551,100
145038298,145036935,145047050,10115,1552,100
145052592,145051231,145060057,8826,1553,100
145065573,145064211,145074304,10093,1554,100
145079839,145078478,145086988,8510,1555,100
145092601,145091022,145100066,9044,1556,100
145105679,145104101,145113461,9360,1557,100
145119073,145117495,145125884,8389,1558,100
145131346,145129985,145137861,7876,1559,100
145143311,145141949,145151093,9144,1560,100
145156706,145155127,145164803,9676,1561,100
145170415,145168837,145176929,8092,1562,100
145182542,145180963,145189056,8093,1563,100
145194537,145193175,145201052,7877,1564,100
145206664,145205086,145214761,9675,1565,100
145220373,145218795,145228788,9993,1566,100
145234400,145232822,145241231,8409,1567,100
145246844,145245265,145254942,9677,1568,100
145260436,145259076,145268850,9774,1569,100
145274376,145273014,145283107,10093,1570,100
145288809,145287230,145295323,8093,1571,100
145300856,145299495,145309271,9776,1572,100
145314883,145313305,145321692,8387,1573,100
145327087,145325726,145336404,10678,1574,100
145341945,145340584,145350676,10092,1575,100
145356245,145354884,145362759,7875,1576,100
145368265,145366904,145375076,8172,1577,100
145380530,145379169,145388627,9458,1578,100
145394173,145392812,145400984,8172,1579,100
145406596,145405018,145415011,9993,1580,100
145420492,145419130,145428907,9777,1581,100
145434519,145432941,145442300,9359,1582,100
145447912,145446334,145455059,8725,1583,100
145460671,145459093,145467819,8726,1584,100
145473310,145471949,145480142,8193,1585,100
145485667,145484305,145494082,9777,1586,100
145499694,145498116,145506208,8092,1587,100
145511668,145510306,145518816,8510,1588,100
145524326,145522964,145532423,9459,1589,100
145538036,145536457,145546450,9993,1590,100
145552062,145550484,145560160,9676,1591,100
145565686,145564324,145573784,9460,1592,100
145579396,145577818,145586207,8389,1593,100
145591821,145590242,145598632,8390,1594,100
145604245,145602666,145612658,9992,1595,100
145618270,145616692,145626051,9359,1596,100
145631663,145630085,145640078,9993,1597,100
145645691,145644112,145653472,9360,1598,100
145658963,145657602,145666743,9141,1599,100
145672355,145670777,145679186,8409,1600,100
145684673,145683312,145691188,7876,1601,100
145696801,145695223,145704266,9043,1602,100
145709878,145708300,145716709,8409,1603,100
145722198,145720837,145730929,10092,1604,100
145736472,145735111,145743936,8825,1605,100
145749548,145747971,145757645,9674,1606,100
145763117,145761756,145769631,7875,1607,100
145775243,145773665,145783657,9992,1608,100
145789270,145787692,145796735,9043,1609,100
145802348,145800770,145808862,8092,1610,100
145814475,145812897,145821285,8388,1611,100
145826898,145825320,145834995,9675,1612,100
145840451,145839089,145846966,7877,1613,100
145852433,145851071,145858948,7877,1614,100
145864437,145863075,145872535,9460,1615,100
145878148,145876570,145884663,8093,1616,100
145890276,145888698,145896790,8092,1617,100
145902255,145900893,145909720,8827,1618,100
145915333,145913755,145924085,10330,1619,100
145929660,145928298,145936175,7877,1620,100
145941642,145940280,145948790,8510,1621,100
145954403,145952825,145963155,10330,1622,100
145968856,145967278,145976003,8725,1623,100
145981616,145980038,145990367,10329,1624,100
145995910,145994549,146004661,10112,1625,100
146010364,146008785,146016879,8094,1626,100
146022492,146020914,146030273,9359,1627,100
146035812,146034450,146042960,8510,1628,100
146048491,146047130,146056905,9775,1629,100
146062518,146060940,146069033,8093,1630,100
146074549,146073187,146083301,10114,1631,100
146088903,146087542,146097001,9459,1632,100
146102538,146101177,146109053,7876,1633,100
146114665,146113088,146122762,9674,1634,100
146128257,146126896,146134772,7876,1635,100
146140385,146138807,146148799,9992,1636,100
146154413,146152834,146163165,10331,1637,100
146168717,146167355,146175232,7877,1638,100
146180693,146179332,146188791,9459,1639,100
146194405,146192826,146201553,8727,1640,100
146207166,146205588,146215897,10309,1641,100
146221431,146220070,146229529,9459,1642,100
146235143,146233564,146241657,8093,1643,100
146247100,146245738,146254564,8826,1644,100
146260178,146258599,146268592,9993,1645,100
146274086,146272725,146280600,7875,1646,100
146286082,146284720,146294497,9777,1647,100
146300111,146298532,146307575,9043,1648,100
146313188,146311610,146320336,8726,1649,100
146325949,146324371,146333096,8725,1650,100
146338709,146337131,146345224,8093,1651,100
146350837,146349259,146358617,9358,1652,100
146364160,146362798,146370675,7877,1653,100
146376288,146374710,146384702,9992,1654,100
146390315,146388737,146396830,8093,1655,100
146402443,146400865,146409908,9043,1656,100
146415422,146414061,146422886,8825,1657,100
146428328,146426967,146435476,8509,1658,100
146440920,146439558,146448702,9144,1659,100
146454194,146452832,146462607,9775,1660,100
146468077,146466715,146474591,7876,1661,100
146480205,146478626,146488302,9676,1662,100
146493915,146492337,146501379,9042,1663,100
146506910,146505549,146514692,9143,1664,100
146520198,146518836,146526712,7876,1665,100
146532326,146530747,146540741,9994,1666,100
146546264,146544902,146553728,8826,1667,100
146559199,146557838,146567614,9776,1668,100
146573227,146571649,146581325,9676,1669,100
146586939,146585360,146593750,8390,1670,100
146599363,146597785,146606511,8726,1671,100
146612124,146610546,146620876,10330,1672,100
146626467,146625105,146633298,8193,1673,100
146638767,146637406,146647182,9776,1674,100
146652633,146651272,146659781,8509,1675,100
146665224,146663862,146673639,9777,1676,100
146679253,146677674,146687034,9360,1677,100
146692647,146691069,146700112,9043,1678,100
146705725,146704147,146712240,8093,1679,100
146717853,146716275,146724367,8092,1680,100
146729980,146728402,146738731,10329,1681,100
146744271,146742910,146751102,8192,1682,100
146756563,146755202,146765294,10092,1683,100
146770898,146769537,146777709,8172,1684,100
146783323,146781744,146790472,8728,1685,100
146796085,146794507,146803866,9359,1686,100
146809416,146808054,146816881,8827,1687,100
146822494,146820916,146829958,9042,1688,100
146835500,146834139,146842015,7876,1689,100
146847628,146846050,146855726,9676,1690,100
146861339,146859761,146870070,10309,1691,100
146875772,146874194,146882604,8410,1692,100
146888095,146886734,146894925,8191,1693,100
146900538,146898960,146908319,9359,1694,100
146913933,146912354,146921081,8727,1695,100
146926694,146925116,146933842,8726,1696,100
146939455,146937877,146946285,8408,1697,100
146951899,146950320,146958731,8411,1698,100
146964344,146962766,146970859,8093,1699,100
146976321,146974959,146983469,8510,1700,100
146989083,146987504,146995893,8389,1701,100
147001506,146999928,147008971,9043,1702,100
147014479,147013117,147022259,9142,1703,100
147027804,147026442,147034615,8173,1704,100
147040229,147038650,147048643,9993,1705,100
147054257,147052678,147062670,9992,1706,100
147068138,147066776,147074949,8173,1707,100
147080458,147079096,147089210,10114,1708,100
147094771,147093409,147103501,10092,1709,100
147109063,147107701,147116845,9144,1710,100
147122317,147120956,147129782,8826,1711,100
147135394,147133817,147142542,8725,1712,100
147148051,147146689,147156465,9776,1713,100
147162078,147160500,147170830,10330,1714,100
147176419,147175057,147183884,8827,1715,100
147189497,147187919,147197912,9993,1716,100
147203434,147202073,147211215,9142,1717,100
147216674,147215312,147225425,10113,1718,100
147230963,147229602,147239061,9459,1719,100
147244675,147243096,147251823,8727,1720,100
147257436,147255858,147264267,8409,1721,100
147269809,147268447,147276323,7876,1722,100
147281936,147280358,147288451,8093,1723,100
147293977,147292616,147300491,7875,1724,100
147306001,147304640,147314415,9775,1725,100
147319928,147318567,147327075,8508,1726,100
147332688,147331110,147339836,8726,1727,100
147345302,147343940,147352113,8173,1728,100
147357621,147356260,147365402,9142,1729,100
147371015,147369437,147379745,10308,1730,100
147385303,147383942,147393400,9458,1731,100
147399013,147397435,147407744,10309,1732,100
147413446,147411868,147420594,8726,1733,100
147426208,147424629,147434305,9676,1734,100
147439918,147438340,147447383,9043,1735,100
147452997,147451418,147459808,8390,1736,100
147465421,147463843,147474172,10329,1737,100
147479874,147478295,147486685,8390,1738,100
147492140,147490778,147498655,7877,1739,100
147504108,147502747,147512205,9458,1740,100
147517711,147516350,147525492,9142,1741,100
147530947,147529585,147539678,10093,1742,100
147545379,147543801,147551893,8092,1743,100
147557363,147556002,147565777,9775,1744,100
147571391,147569812,147579805,9993,1745,100
147585418,147583840,147592248,8408,1746,100
147597861,147596283,147606275,9992,1747,100
147611888,147610310,147618402,8092,1748,100
147624015,147622437,147632746,10309,1749,100
147638342,147636980,147645490,8510,1750,100
147650988,147649627,147658769,9142,1751,100
147664382,147662804,147671529,8725,1752,100
147677142,147675564,147683657,8093,1753,100
147689271,147687692,147698002,10310,1754,100
147703704,147702126,147710515,8389,1755,100
147716129,147714550,147724860,10310,1756,100
147730562,147728983,147737373,8390,1757,100
147742986,147741408,147750767,9359,1758,100
147756271,147754910,147763418,8508,1759,100
147769031,147767453,147775546,8093,1760,100
147781074,147779713,147787589,7876,1761,100
147793202,147791624,147800667,9043,1762,100
147806176,147804815,147814589,9774,1763,100
147820202,147818624,147827349,8725,1764,100
147832873,147831511,147841287,9776,1765,100
147846900,147845322,147855631,10309,1766,100
147861332,147859754,147869114,9360,1767,100
147874728,147873149,147881538,8389,1768,100
147887050,147885689,147894198,8509,1769,100
147899682,147898321,147907779,9458,1770,100
147913241,147911879,147921972,10093,1771,100
147927673,147926095,147935771,9676,1772,100
147941384,147939806,147950115,10309,1773,100
147955816,147954238,147962330,8092,1774,100
147967944,147966365,147976042,9677,1775,100
147981576,147980215,147990307,10092,1776,100
147996009,147994431,148003790,9359,1777,100
148009317,148007956,148015832,7876,1778,100
148021445,148019867,148027959,8092,1779,100
148033428,148032066,148041841,9775,1780,100
148047453,148045875,148055234,9359,1781,100
148060783,148059421,148068563,9142,1782,100
148074022,148072660,148081169,8509,1783,100
148086783,148085204,148094564,9360,1784,100
148100177,148098599,148106692,8093,1785,100
148112223,148110862,148120320,9458,1786,100
148125815,148124454,148133912,9458,1787,100
148139525,148137947,148146990,9043,1788,100
148152505,148151143,148159020,7877,1789,100
148164633,148163055,148171444,8389,1790,100
148177057,148175479,148185155,9676,1791,100
148190679,148189318,148199410,10092,1792,100
148205111,148203533,148212576,9043,1793,100
148218188,148216611,148225336,8725,1794,100
148230826,148229464,148238291,8827,1795,100
148243904,148242326,148250715,8389,1796,100
148256328,148254750,148263793,9043,1797,100
148269323,148267961,148277738,9777,1798,100
148283203,148281841,148291617,9776,1799,100
148297146,148295784,148303661,7877,1800,100
148309127,148307766,148317858,10092,1801,100
148323560,148321981,148332291,10310,1802,100
148337993,148336415,148345774,9359,1803,100
148351388,148349809,148357903,8094,1804,100
148363516,148361938,148371296,9358,1805,100
148376774,148375413,148383922,8509,1806,100
148389380,148388018,148396191,8173,1807,100
148401803,148400226,148408614,8388,1808,100
148414138,148412777,148421286,8509,1809,100
148426899,148425321,148434997,9676,1810,100
148440480,148439118,148448578,9460,1811,100
148454191,148452613,148462606,9993,1812,100
148468096,148466735,148476827,10092,1813,100
148482366,148481005,148490463,9458,1814,100
148496011,148494650,148502821,8171,1815,100
148508352,148506991,148515816,8825,1816,100
148521360,148519998,148529774,9776,1817,100
148535240,148533879,148543338,9459,1818,100
148548951,148547373,148556732,9359,1819,100
148562255,148560894,148569065,8171,1820,100
148574461,148573100,148583460,10360,1821,100
148589162,148587584,148596310,8726,1822,100
148601923,148600345,148608438,8093,1823,100
148614051,148612473,148621198,8725,1824,100
148626736,148625375,148633884,8509,1825,100
148639497,148637919,148648227,10308,1826,100
148653930,148652351,148662345,9994,1827,100
148667958,148666380,148675422,9042,1828,100
148680879,148679518,148688661,9143,1829,100
148694274,148692696,148702371,9675,1830,100
148707984,148706406,148714793,8387,1831,100
148720243,148718882,148727707,8825,1832,100
148733321,148731742,148740785,9043,1833,100
148746266,148744904,148753730,8826,1834,100
148759344,148757765,148766809,9044,1835,100
148772252,148770890,148779063,8173,1836,100
148784612,148783250,148791127,7877,1837,100
148796740,148795162,148803551,8389,1838,100
148809164,148807586,148815678,8092,1839,100
148821123,148819761,148829853,10092,1840,100
148835555,148833977,148843336,9359,1841,100
148848950,148847371,148855761,8390,1842,100
148861374,148859796,148869155,9359,1843,100
148874652,148873291,148882749,9458,1844,100
148888363,148886784,148896144,9360,1845,100
148901685,148900322,148908200,7878,1846,100
148913813,148912235,148920328,8093,1847,100
148925941,148924363,148932455,8092,1848,100
148937920,148936557,148946651,10094,1849,100
148952352,148950774,148958866,8092,1850,100
148964480,148962901,148971944,9043,1851,100
148977443,148976081,148984907,8826,1852,100
148990451,148989089,148997599,8510,1853,100
149003212,149001634,149011310,9676,1854,100
149016757,149015396,149024854,9458,1855,100
149030467,149028889,149037615,8726,1856,100
149043105,149041744,149051520,9776,1857,100
149057133,149055555,149064281,8726,1858,100
149069894,149068316,149077676,9360,1859,100
149083202,149081840,149091932,10092,1860,100
149097510,149096149,149104658,8509,1861,100
149110115,149108753,149116629,7876,1862,100
149122166,149120804,149128681,7877,1863,100
149134293,149132715,149141757,9042,1864,100
149147223,149145861,149154034,8173,1865,100
149159495,149158133,149166306,8173,1866,100
149171919,149170341,149178730,8389,1867,100
149184204,149182842,149191985,9143,1868,100
149197598,149196020,149205696,9676,1869,100
149211235,149209873,149218045,8172,1870,100
149223658,149222080,149231122,9042,1871,100
149236599,149235238,149244064,8826,1872,100
149249595,149248233,149257692,9459,1873,100
149263140,149261778,149271238,9460,1874,100
149276851,149275273,149283999,8726,1875,100
149289612,149288034,149297077,9043,1876,100
149302540,149301179,149309688,8509,1877,100
149315158,149313797,149322622,8825,1878,100
149328152,149326790,149335300,8510,1879,100
149340828,149339466,149348291,8825,1880,100
149353806,149352445,149362537,10092,1881,100
149368239,149366661,149376021,9360,1882,100
149381468,149380106,149389883,9777,1883,100
149395337,149393976,149403119,9143,1884,100
149408732,149407154,149416512,9358,1885,100
149422016,149420655,149430431,9776,1886,100
149436044,149434466,149444141,9675,1887,100
149449754,149448176,149456901,8725,1888,100
149462514,149460936,149469324,8388,1889,100
149474937,149473359,149483035,9676,1890,100
149488561,149487200,149495076,7876,1891,100
149500690,149499111,149509421,10310,1892,100
149514999,149513638,149522464,8826,1893,100
149527994,149526632,149535459,8827,1894,100
149541072,149539494,149549169,9675,1895,100
149554782,149553204,149562880,9676,1896,100
149568493,149566915,149575303,8388,1897,100
149580916,149579338,149588063,8725,1898,100
149593676,149592097,149600190,8093,1899,100
149605672,149604310,149612187,7877,1900,100
149617670,149616308,149625135,8827,1901,100
149630748,149629170,149637896,8726,1902,100
149643398,149642036,149650863,8827,1903,100
149656476,149654898,149665207,10309,1904,100
149670910,149669331,149678691,9360,1905,100
149684193,149682832,149691658,8826,1906,100
149697173,149695812,149705587,9775,1907,100
149711201,149709622,149718981,9359,1908,100
149724464,149723102,149731612,8510,1909,100
149737226,149735647,149743741,8094,1910,100
149749268,149747907,149756416,8509,1911,100
149762029,149760451,149770442,9991,1912,100
149775915,149774554,149784013,9459,1913,100
149789625,149788048,149798039,9991,1914,100
149803555,149802193,149810366,8173,1915,100
149815852,149814490,149823633,9143,1916,100
149829246,149827668,149835761,8093,1917,100
149841233,149839871,149848043,8172,1918,100
149853656,149852078,149862071,9993,1919,100
149867561,149866200,149875342,9142,1920,100
149880891,149879529,149888672,9143,1921,100
149894285,149892707,149901433,8726,1922,100
149906973,149905612,149915388,9776,1923,100
149920852,149919491,149929583,10092,1924,100
149935137,149933776,149942918,9142,1925,100
149948445,149947083,149955255,8172,1926,100
149960699,149959338,149968479,9141,1927,100
149974093,149972514,149981558,9044,1928,100
149987172,149985593,149994954,9361,1929,100
150000404,149999043,150008818,9775,1930,100
150014301,150012939,150022083,9144,1931,100
150027547,150026186,150035011,8825,1932,100
150040624,150039046,150047139,8093,1933,100
150052752,150051174,150059267,8093,1934,100
150064755,150063393,150071903,8510,1935,100
150077383,150076022,150083898,7876,1936,100
150089512,150087933,150096977,9044,1937,100
150102590,150101012,150111005,9993,1938,100
150116546,150115185,150123060,7875,1939,100
150128673,150127095,150135821,8726,1940,100
150141346,150139985,150150077,10092,1941,100
150155649,150154287,150162460,8173,1942,100
150168073,150166495,150174882,8387,1943,100
150180350,150178989,150187814,8825,1944,100
150193341,150191980,150201754,9774,1945,100
150207220,150205859,150215634,9775,1946,100
150221248,150219669,150229663,9994,1947,100
150235276,150233698,150244028,10330,1948,100
150249730,150248152,150256878,8726,1949,100
150262492,150260913,150270272,9359,1950,100
150275885,150274307,150282400,8093,1951,100
150288014,150286435,150295795,9360,1952,100
150301409,150299830,150309189,9359,1953,100
150314802,150313224,150322267,9043,1954,100
150327880,150326302,150334395,8093,1955,100
150340008,150338430,150347788,9358,1956,100
150353401,150351823,150361816,9993,1957,100
150367429,150365851,150375843,9992,1958,100
150381456,150379878,150388605,8727,1959,100
150394100,150392739,150402198,9459,1960,100
150407811,150406233,150416226,9993,1961,100
150421840,150420261,150428670,8409,1962,100
150434283,150432705,150443014,10309,1963,100
150448557,150447196,150455367,8171,1964,100
150460863,150459501,150467378,7877,1965,100
150472822,150471461,150479970,8509,1966,100
150485477,150484116,150492626,8510,1967,100
150498239,150496661,150505050,8389,1968,100
150510664,150509085,150519395,10310,1969,100
150525098,150523519,150531612,8093,1970,100
150537226,150535647,150545007,9360,1971,100
150550502,150549140,150558917,9777,1972,100
150564530,150562952,150572312,9360,1973,100
150577764,150576402,150584279,7877,1974,100
150589892,150588314,150598306,9992,1975,100
150603919,150602341,150610730,8389,1976,100
150616342,150614765,150624756,9991,1977,100
150630369,150628791,150637518,8727,1978,100
150643011,150641650,150650476,8826,1979,100
150656025,150654663,150663172,8509,1980,100
150668785,150667207,150675933,8726,1981,100
150681431,150680070,150689845,9775,1982,100
150695390,150694028,150702537,8509,1983,100
150708028,150706666,150715492,8826,1984,100
150721020,150719658,150729433,9775,1985,100
150735046,150733468,150743776,10308,1986,100
150749477,150747899,150756941,9042,1987,100
150762554,150760976,150769365,8389,1988,100
150774845,150773484,150782310,8826,1989,100
150787924,150786345,150794734,8389,1990,100
150800221,150798859,150808001,9142,1991,100
150813442,150812080,150821222,9142,1992,100
150826702,150825340,150834800,9460,1993,100
150840414,150838835,150847225,8390,1994,100
150852838,150851260,150861253,9993,1995,100
150866779,150865418,150875193,9775,1996,100
150880736,150879374,150888201,8827,1997,100
150893814,150892236,150902544,10308,1998,100
150908246,150906668,150914761,8093,1999,100
150920374,150918796,150928471,9675,2000,100
150933961,150932600,150942692,10092,2001,100
150948270,150946908,150956052,9144,2002,100
150961666,150960088,150970080,9992,2003,100
150975543,150974181,150983640,9459,2004,100
150989107,150987746,150995916,8170,2005,100
151001529,150999951,151009310,9359,2006,100
151014839,151013477,151021354,7877,2007,100
151026902,151025540,151035633,10093,2008,100
151041336,151039757,151048484,8727,2009,100
151053944,151052582,151062042,9460,2010,100
151067656,151066078,151075437,9359,2011,100
151080951,151079590,151089049,9459,2012,100
151094571,151093210,151102986,9776,2013,100
151108599,151107021,151116379,9358,2014,100
151121830,151120469,151130243,9774,2015,100
151135745,151134384,151143209,8825,2016,100
151148822,151147244,151157553,10309,2017,100
151163256,151161677,151171671,9994,2018,100
151177285,151175706,151183800,8094,2019,100
151189271,151187909,151197686,9777,2020,100
151203299,151201721,151210447,8726,2021,100
151215973,151214611,151222783,8172,2022,100
151228396,151226818,151235861,9043,2023,100
151241474,151239896,151249255,9359,2024,100
151254868,151253290,151262016,8726,2025,100
151267629,151266051,151275409,9358,2026,100
151281023,151279445,151287537,8092,2027,100
151293150,151291572,151299961,8389,2028,100
151305575,151303997,151312385,8388,2029,100
151317781,151316420,151324565,8145,2030,100
151330092,151328731,151337240,8509,2031,100
151342724,151341363,151349535,8172,2032,100
151355147,151353570,151362294,8724,2033,100
151367807,151366445,151375905,9460,2034,100
151381436,151380074,151390167,10093,2035,100
151395869,151394291,151402384,8093,2036,100
151407865,151406503,151414380,7877,2037,100
151419993,151418415,151426804,8389,2038,100
151432307,151430946,151440405,9459,2039,100
151446018,151444440,151454116,9676,2040,100
151459729,151458152,151468143,9991,2041,100
151473689,151472328,151480499,8171,2042,100
151485985,151484623,151493765,9142,2043,100
151499209,151497847,151506357,8510,2044,100
151511971,151510393,151519435,9042,2045,100
151525049,151523471,151533146,9675,2046,100
151538614,151537252,151545129,7877,2047,100
151550744,151549165,151559495,10330,2048,100
151565075,151563714,151572855,9141,2049,100
151578468,151576890,151585933,9043,2050,100
151591546,151589968,151606144,16176,2051,100
151611847,151610269,151618995,8726,2052,100
151624391,151623030,151634234,11204,2053,100
151639771,151638410,151648502,10092,2054,100
151654205,151652626,151661986,9360,2055,100
151667430,151666068,151674261,8193,2056,100
151679874,151678296,151687022,8726,2057,100
151692515,151691154,151700929,9775,2058,100
151706476,151705115,151714889,9774,2059,100
151720350,151718989,151729081,10092,2060,100
151734783,151733205,151742565,9360,2061,100
151748179,151746601,151754990,8389,2062,100
151760447,151759085,151768228,9143,2063,100
151773750,151772388,151781214,8826,2064,100
151786828,151785250,151795558,10308,2065,100
151801260,151799682,151808409,8727,2066,100
151814022,151812444,151822753,10309,2067,100
151828455,151826877,151836237,9360,2068,100
151841732,151840370,151850146,9776,2069,100
151855759,151854181,151863223,9042,2070,100
151868689,151867328,151875204,7876,2071,100
151880742,151879381,151889473,10092,2072,100
151895176,151893598,151902640,9042,2073,100
151908101,151906739,151914616,7877,2074,100
151920117,151918755,151927899,9144,2075,100
151933514,151931935,151940325,8390,2076,100
151945787,151944426,151954518,10092,2077,100
151960221,151958643,151968003,9360,2078,100
151973469,151972108,151980279,8171,2079,100
151985754,151984393,151992269,7876,2080,100
151997722,151996360,152005820,9460,2081,100
152011281,152009920,152019696,9776,2082,100
152025310,152023731,152032121,8390,2083,100
152037735,152036157,152045516,9359,2084,100
152051044,152049682,152059458,9776,2085,100
152064948,152063587,152071759,8172,2086,100
152077373,152075794,152083888,8094,2087,100
152089501,152087923,152096016,8093,2088,100
152101630,152100051,152110361,10310,2089,100
152115908,152114547,152124006,9459,2090,100
152129551,152128190,152137964,9774,2091,100
152143577,152141999,152151992,9993,2092,100
152157521,152156160,152166251,10091,2093,100
152171953,152170375,152178468,8093,2094,100
152183964,152182602,152192695,10093,2095,100
152198398,152196819,152206813,9994,2096,100
152212427,152210848,152220209,9361,2097,100
152225711,152224350,152234442,10092,2098,100
152240145,152238566,152248876,10310,2099,100
152254416,152253055,152262830,9775,2100,100
152268443,152266865,152276225,9360,2101,100
152281840,152280261,152289622,9361,2102,100
152295154,152293792,152302934,9142,2103,100
152308548,152306969,152316963,9994,2104,100
152322576,152320998,152331307,10309,2105,100
152336792,152335431,152346362,10931,2106,100
152352064,152350486,152360479,9993,2107,100
152366027,152364666,152374758,10092,2108,100
152380460,152378882,152386975,8093,2109,100
152392431,152391070,152399578,8508,2110,100
152405128,152403767,152412276,8509,2111,100
152417722,152416360,152425503,9143,2112,100
152430993,152429631,152439408,9777,2113,100
152445021,152443443,152452169,8726,2114,100
152457784,152456205,152466199,9994,2115,100
152471812,152470234,152479277,9043,2116,100
152484891,152483313,152492039,8726,2117,100
152497490,152496129,152504005,7876,2118,100
152509496,152508134,152516307,8173,2119,100
152521810,152520449,152530223,9774,2120,100
152535838,152534259,152543935,9676,2121,100
152549548,152547970,152556695,8725,2122,100
152562308,152560730,152570090,9360,2123,100
152575543,152574181,152582058,7877,2124,100
152587592,152586231,152595690,9459,2125,100
152601304,152599726,152608115,8389,2126,100
152613728,152612150,152620876,8726,2127,100
152626490,152624911,152633638,8727,2128,100
152639100,152637739,152647514,9775,2129,100
152653127,152651549,152659958,8409,2130,100
152665425,152664063,152674156,10093,2131,100
152679858,152678280,152687323,9043,2132,100
152692938,152691359,152701352,9993,2133,100
152706965,152705387,152715379,9992,2134,100
152720925,152719563,152727734,8171,2135,100
152733348,152731769,152740495,8726,2136,100
152745946,152744585,152754044,9459,2137,100
152759585,152758224,152766396,8172,2138,100
152771793,152770432,152781447,11015,2139,100
152787149,152785571,152795880,10309,2140,100
152801429,152800068,152809527,9459,2141,100
152815142,152813563,152822606,9043,2142,100
152828133,152826772,152834943,8171,2143,100
152840556,152838978,152847071,8093,2144,100
152852543,152851181,152860641,9460,2145,100
152866254,152864676,152873065,8389,2146,100
152878522,152877160,152885036,7876,2147,100
152890539,152889178,152897687,8509,2148,100
152903185,152901824,152909995,8171,2149,100
152915490,152914128,152922954,8826,2150,100
152928567,152926989,152937298,10309,2151,100
152943001,152941422,152951415,9993,2152,100
152957029,152955451,152963838,8387,2153,100
152969452,152967874,152976600,8726,2154,100
152982078,152980716,152988592,7876,2155,100
152994205,152992627,153001354,8727,2156,100
153006858,153005496,153015272,9776,2157,100
153020743,153019381,153027554,8173,2158,100
153033061,153031700,153040843,9143,2159,100
153046305,153044943,153054086,9143,2160,100
153059700,153058121,153067482,9361,2161,100
153073096,153071518,153079611,8093,2162,100
153085135,153083773,153091650,7877,2163,100
153097122,153095760,153104586,8826,2164,100
153110117,153108755,153116928,8173,2165,100
153122540,153120963,153130322,9359,2166,100
153135831,153134469,153143929,9460,2167,100
153149544,153147965,153156355,8390,2168,100
153161970,153160391,153170385,9994,2169,100
153175859,153174498,153183640,9142,2170,100
153189114,153187752,153197845,10093,2171,100
153203392,153202030,153210201,8171,2172,100
153215815,153214237,153223280,9043,2173,100
153228770,153227408,153237185,9777,2174,100
153242798,153241220,153250896,9676,2175,100
153256511,153254932,153264293,9361,2176,100
153269782,153268421,153277564,9143,2177,100
153283075,153281714,153290539,8825,2178,100
153296153,153294574,153304568,9994,2179,100
153310066,153308705,153316580,7875,2180,100
153322049,153320688,153328860,8172,2181,100
153334474,153332896,153341939,9043,2182,100
153347396,153346034,153354544,8510,2183,100
153360009,153358647,153368106,9459,2184,100
153373566,153372204,153380397,8193,2185,100
153386011,153384433,153394426,9993,2186,100
153400041,153398462,153407505,9043,2187,100
153412975,153411613,153421706,10093,2188,100
153427408,153425830,153435188,9358,2189,100
153440696,153439334,153449111,9777,2190,100
153454724,153453146,153463455,10309,2191,100
153469158,153467579,153476623,9044,2192,100
153482167,153480806,153489316,8510,2193,100
153494761,153493399,153502858,9459,2194,100
153508321,153506959,153514835,7876,2195,100
153520450,153518871,153527915,9044,2196,100
153533404,153532043,153540552,8509,2197,100
153546066,153544704,153554481,9777,2198,100
153560095,153558517,153567243,8726,2199,100
153572857,153571279,153580006,8727,2200,100
153585620,153584042,153592430,8388,2201,100
153597911,153596549,153605693,9144,2202,100
153611307,153609729,153618455,8726,2203,100
153624004,153622643,153632735,10092,2204,100
153638437,153636858,153647168,10310,2205,100
153652870,153651292,153661284,9992,2206,100
153666897,153665319,153673411,8092,2207,100
153678907,153677545,153686370,8825,2208,100
153691983,153690405,153700398,9993,2209,100
153705863,153704502,153714594,10092,2210,100
153720191,153718830,153728921,10091,2211,100
153734624,153733045,153743037,9992,2212,100
153748575,153747214,153755722,8508,2213,100
153761336,153759757,153770067,10310,2214,100
153775769,153774191,153783233,9042,2215,100
153788846,153787268,153796309,9041,2216,100
153801922,153800344,153809387,9043,2217,100
153814849,153813488,153821364,7876,2218,100
153826977,153825399,153834441,9042,2219,100
153840055,153838476,153846569,8093,2220,100
153852183,153850605,153859964,9359,2221,100
153865435,153864073,153872246,8173,2222,100
153877788,153876427,153884303,7876,2223,100
153889917,153888339,153898648,10309,2224,100
153904351,153902772,153912449,9677,2225,100
153917953,153916592,153926684,10092,2226,100
153932385,153930808,153941115,10307,2227,100
153946661,153945299,153953472,8173,2228,100
153959086,153957507,153967501,9994,2229,100
153973114,153971536,153979924,8388,2230,100
153985392,153984031,153993807,9776,2231,100
153999422,153997843,154007836,9993,2232,100
154013450,154011872,154021547,9675,2233,100
154027028,154025666,154035126,9460,2234,100
154040589,154039228,154048369,9141,2235,100
154053814,154052452,154060962,8510,2236,100
154066575,154064997,154073090,8093,2237,100
154078558,154077196,154085072,7876,2238,100
154090607,154089246,154097122,7876,2239,100
154102610,154101248,154109419,8171,2240,100
154115032,154113454,154123446,9992,2241,100
154129059,154127481,154137474,9993,2242,100
154143020,154141659,154151117,9458,2243,100
154156730,154155152,154165143,9991,2244,100
154170686,154169325,154179100,9775,2245,100
154184644,154183283,154192424,9141,2246,100
154197878,154196516,154204393,7877,2247,100
154210006,154208428,154218419,9991,2248,100
154223910,154222548,154232640,10092,2249,100
154238174,154236812,154246589,9777,2250,100
154252202,154250624,154260933,10309,2251,100
154266466,154265104,154273931,8827,2252,100
154279389,154278028,154286537,8509,2253,100
154292150,154290572,154299298,8726,2254,100
154304911,154303333,154311426,8093,2255,100
154317041,154315462,154323556,8094,2256,100
154329096,154327735,154336244,8509,2257,100
154341857,154340279,154348372,8093,2258,100
154353985,154352407,154361765,9358,2259,100
154367221,154365860,154373736,7876,2260,100
154379349,154377771,154387447,9676,2261,100
154392910,154391549,154399742,8193,2262,100
154405266,154403904,154412414,8510,2263,100
154418029,154416450,154425810,9360,2264,100
154431424,154429846,154437939,8093,2265,100
154443403,154442041,154450551,8510,2266,100
154456164,154454586,154463945,9359,2267,100
154469470,154468108,154475985,7877,2268,100
154481499,154480138,154489597,9459,2269,100
154495211,154493633,154502676,9043,2270,100
154508289,154506711,154516704,9993,2271,100
154522237,154520876,154530019,9143,2272,100
154535509,154534147,154543607,9460,2273,100
154549098,154547736,154556246,8510,2274,100
154561860,154560282,154569958,9676,2275,100
154575419,154574058,154582883,8825,2276,100
154588381,154587019,154596163,9144,2277,100
154601777,154600199,154608292,8093,2278,100
154613906,154612328,154622321,9993,2279,100
154627792,154626430,154636207,9777,2280,100
154641733,154640372,154649514,9142,2281,100
154655128,154653550,154663226,9676,2282,100
154668839,154667261,154676936,9675,2283,100
154682549,154680971,154691279,10308,2284,100
154696882,154695521,154705613,10092,2285,100
154711151,154709789,154719566,9777,2286,100
154725180,154723602,154733595,9993,2287,100
154739207,154737630,154746988,9358,2288,100
154752602,154751024,154759117,8093,2289,100
154764732,154763153,154772197,9044,2290,100
154777704,154776343,154784218,7875,2291,100
154789698,154788336,154797479,9143,2292,100
154803093,154801514,154810557,9043,2293,100
154816107,154814745,154823254,8509,2294,100
154828868,154827290,154837599,10309,2295,100
154843142,154841781,154851240,9459,2296,100
154856710,154855348,154865441,10093,2297,100
154871143,154869565,154879558,9993,2298,100
154885068,154883706,154892216,8510,2299,100
154897715,154896354,154904546,8192,2300,100
154910019,154908657,154916534,7877,2301,100
154921987,154920626,154930717,10091,2302,100
154936266,154934905,154943414,8509,2303,100
154949026,154947449,154957777,10328,2304,100
154963345,154961983,154970155,8172,2305,100
154975697,154974335,154982212,7877,2306,100
154987827,154986248,154995608,9360,2307,100
155001141,154999780,155007656,7876,2308,100
155013098,155011737,155021513,9776,2309,100
155027126,155025548,155034907,9359,2310,100
155040521,155038943,155048302,9359,2311,100
155053803,155052442,155062555,10113,2312,100
155068103,155066741,155076518,9777,2313,100
155082132,155080554,155089597,9043,2314,100
155095210,155093632,155103308,9676,2315,100
155108923,155107344,155116388,9044,2316,100
155122001,155120423,155129783,9360,2317,100
155135396,155133818,155142228,8410,2318,100
155147689,155146328,155154837,8509,2319,100
155160384,155159022,155167193,8171,2320,100
155172807,155171228,155181220,9992,2321,100
155186834,155185255,155194614,9359,2322,100
155200228,155198650,155208979,10329,2323,100
155214681,155213103,155222146,9043,2324,100
155227759,155226182,155234591,8409,2325,100
155240116,155238755,155248530,9775,2326,100
155254044,155252683,155262141,9458,2327,100
155267755,155266176,155275536,9360,2328,100
155281003,155279642,155289101,9459,2329,100
155294646,155293285,155301161,7876,2330,100
155306636,155305274,155313447,8173,2331,100
155319060,155317482,155325892,8410,2332,100
155331346,155329985,155337860,7875,2333,100
155343318,155341956,155352070,10114,2334,100
155357645,155356284,155364160,7876,2335,100
155369617,155368256,155376427,8171,2336,100
155381940,155380578,155390038,9460,2337,100
155395531,155394170,155402046,7876,2338,100
155407527,155406166,155414992,8826,2339,100
155420478,155419116,155427289,8173,2340,100
155432834,155431472,155439349,7877,2341,100
155444962,155443384,155452427,9043,2342,100
155457897,155456535,155466312,9777,2343,100
155471840,155470478,155479305,8827,2344,100
155484919,155483341,155492699,9358,2345,100
155498191,155496830,155506606,9776,2346,100
155512220,155510642,155520318,9676,2347,100
155525788,155524427,155533252,8825,2348,100
155538865,155537287,155546330,9043,2349,100
155551943,155550365,155559090,8725,2350,100
155564704,155563126,155572486,9360,2351,100
155577999,155576638,155585147,8509,2352,100
155590762,155589183,155597911,8728,2353,100
155603525,155601947,155610040,8093,2354,100
155615563,155614202,155623027,8825,2355,100
155628542,155627181,155636323,9142,2356,100
155641785,155640423,155648616,8193,2357,100
155654100,155652739,155661564,8825,2358,100
155667052,155665691,155675465,9774,2359,100
155681078,155679500,155689492,9992,2360,100
155695009,155693648,155702157,8509,2361,100
155707609,155706247,155716022,9775,2362,100
155721555,155720193,155729020,8827,2363,100
155734632,155733055,155743362,10307,2364,100
155748894,155747533,155757624,10091,2365,100
155763240,155761879,155770704,8825,2366,100
155776184,155774823,155783332,8509,2367,100
155788945,155787367,155796726,9359,2368,100
155802220,155800858,155810972,10114,2369,100
155816573,155815212,155824037,8825,2370,100
155829650,155828072,155838381,10309,2371,100
155843949,155842588,155851414,8826,2372,100
155857027,155855449,155863837,8388,2373,100
155869381,155868020,155876846,8826,2374,100
155882316,155880955,155890730,9775,2375,100
155896211,155894849,155903022,8173,2376,100
155908564,155907203,155916979,9776,2377,100
155922592,155921014,155929402,8388,2378,100
155935015,155933437,155941529,8092,2379,100
155946997,155945635,155954145,8510,2380,100
155959759,155958181,155966907,8726,2381,100
155972378,155971017,155979842,8825,2382,100
155985326,155983964,155991841,7877,2383,100
155997454,155995876,156004264,8388,2384,100
156009877,156008300,156016392,8092,2385,100
156022005,156020427,156028815,8388,2386,100
156034296,156032934,156043027,10093,2387,100
156048567,156047206,156056665,9459,2388,100
156062192,156060830,156070289,9459,2389,100
156075903,156074324,156083050,8726,2390,100
156088501,156087140,156096916,9776,2391,100
156102529,156100951,156109044,8093,2392,100
156114658,156113080,156121172,8092,2393,100
156126785,156125207,156133596,8389,2394,100
156139102,156137740,156145913,8173,2395,100
156151528,156149949,156158992,9043,2396,100
156164606,156163028,156171754,8726,2397,100
156177271,156175910,156184736,8826,2398,100
156190350,156188772,156197815,9043,2399,100
156203317,156201955,156212048,10093,2400,100
156217634,156216273,156226049,9776,2401,100
156231662,156230084,156238176,8092,2402,100
156243789,156242211,156251570,9359,2403,100
156257184,156255606,156265282,9676,2404,100
156270808,156269447,156278273,8826,2405,100
156283736,156282374,156291200,8826,2406,100
156296814,156295236,156303329,8093,2407,100
156308943,156307365,156317356,9991,2408,100
156322824,156321462,156331554,10092,2409,100
156337101,156335740,156343615,7875,2410,100
156349228,156347650,156355743,8093,2411,100
156361216,156359854,156369629,9775,2412,100
156375156,156373794,156382304,8510,2413,100
156387798,156386437,156396213,9776,2414,100
156401826,156400248,156409923,9675,2415,100
156415537,156413959,156424268,10309,2416,100
156429971,156428392,156437753,9361,2417,100
156443366,156441788,156451781,9993,2418,100
156457315,156455953,156465413,9460,2419,100
156471027,156469449,156478807,9358,2420,100
156484420,156482842,156492518,9676,2421,100
156498132,156496554,156505913,9359,2422,100
156511527,156509948,156518042,8094,2423,100
156523584,156522223,156530099,7876,2424,100
156535615,156534254,156543079,8825,2425,100
156548692,156547114,156555207,8093,2426,100
156560820,156559242,156569551,10309,2427,100
156575253,156573676,156583984,10308,2428,100
156589572,156588211,156596721,8510,2429,100
156602335,156600757,156611066,10309,2430,100
156616770,156615191,156624552,9361,2431,100
156629999,156628638,156636514,7876,2432,100
156642128,156640550,156650225,9675,2433,100
156655839,156654261,156662353,8092,2434,100
156667814,156666452,156674329,7877,2435,100
156679942,156678364,156687406,9042,2436,100
156692905,156691544,156700686,9142,2437,100
156706300,156704722,156715051,10329,2438,100
156720595,156719233,156728693,9460,2439,100
156734306,156732728,156741771,9043,2440,100
156747384,156745806,156754848,9042,2441,100
156760391,156759029,156767540,8511,2442,100
156772988,156771626,156781403,9777,2443,100
156787017,156785438,156795115,9677,2444,100
156800729,156799151,156808194,9043,2445,100
156813807,156812229,156821588,9359,2446,100
156827202,156825624,156834983,9359,2447,100
156840597,156839019,156849349,10330,2448,100
156854898,156853536,156862680,9144,2449,100
156868294,156866716,156874809,8093,2450,100
156880335,156878974,156888433,9459,2451,100
156893876,156892514,156902291,9777,2452,100
156907741,156906380,156914256,7876,2453,100
156919869,156918291,156927967,9676,2454,100
156933581,156932003,156940096,8093,2455,100
156945637,156944275,156953418,9143,2456,100
156959031,156957453,156966180,8727,2457,100
156971794,156970216,156979258,9042,2458,100
156984721,156983359,156991868,8509,2459,100
156997332,156995971,157004142,8171,2460,100
157009755,157008177,157018507,10330,2461,100
157024209,157022631,157032624,9993,2462,100
157038238,157036660,157046652,9992,2463,100
157052266,157050688,157060048,9360,2464,100
157065662,157064084,157073759,9675,2465,100
157079255,157077894,157087036,9142,2466,100
157092497,157091135,157099307,8172,2467,100
157104921,157103343,157112702,9359,2468,100
157118199,157116838,157125030,8192,2469,100
157130499,157129137,157137014,7877,2470,100
157142629,157141050,157151043,9993,2471,100
157156657,157155079,157163468,8389,2472,100
157168927,157167565,157176392,8827,2473,100
157182006,157180428,157188817,8389,2474,100
157194431,157192853,157201896,9043,2475,100
157207389,157206027,157214854,8827,2476,100
157220379,157219018,157227844,8826,2477,100
157233459,157231880,157240924,9044,2478,100
157246539,157244960,157254321,9361,2479,100
157259783,157258422,157266593,8171,2480,100
157272055,157270693,157280152,9459,2481,100
157285613,157284251,157294344,10093,2482,100
157300046,157298468,157308144,9676,2483,100
157313757,157312179,157320905,8726,2484,100
157326518,157324940,157334615,9675,2485,100
157340148,157338787,157348562,9775,2486,100
157354176,157352597,157361956,9359,2487,100
157367440,157366078,157374588,8510,2488,100
157380201,157378623,157387033,8410,2489,100
157392482,157391120,157401213,10093,2490,100
157406811,157405449,157415542,10093,2491,100
157421081,157419719,157428862,9143,2492,100
157434475,157432897,157440990,8093,2493,100
157446603,157445025,157454700,9675,2494,100
157460235,157458874,157467383,8509,2495,100
157472874,157471512,157481605,10093,2496,100
157487308,157485729,157494140,8411,2497,100
157499753,157498175,157507534,9359,2498,100
157513147,157511569,157520611,9042,2499,100
157526098,157524736,157532909,8173,2500,100
157538376,157537014,157544890,7876,2501,100
157550424,157549063,157557889,8826,2502,100
157563437,157562075,157570902,8827,2503,100
157576515,157574937,157583346,8409,2504,100
157588959,157587381,157597711,10330,2505,100
157603413,157601835,157611828,9993,2506,100
157617297,157615936,157624762,8826,2507,100
157630291,157628930,157638073,9143,2508,100
157643606,157642245,157650754,8509,2509,100
157656248,157654886,157663080,8194,2510,100
157668549,157667187,157675064,7877,2511,100
157680678,157679100,157688143,9043,2512,100
157693756,157692178,157701854,9676,2513,100
157707467,157705889,157715565,9676,2514,100
157721178,157719600,157728643,9043,2515,100
157734131,157732770,157741912,9142,2516,100
157747525,157745947,157755306,9359,2517,100
157760764,157759403,157767279,7876,2518,100
157772892,157771314,157780672,9358,2519,100
157786285,157784707,157793750,9043,2520,100
157799224,157797863,157807321,9458,2521,100
157812934,157811356,157819449,8093,2522,100
157824980,157823619,157833394,9775,2523,100
157838935,157837574,157847666,10092,2524,100
157853368,157851790,157861149,9359,2525,100
157866698,157865336,157873530,8194,2526,100
157878994,157877631,157886142,8511,2527,100
157891682,157890320,157898197,7877,2528,100
157903746,157902384,157911843,9459,2529,100
157917456,157915878,157925553,9675,2530,100
157931168,157929589,157938633,9044,2531,100
157944247,157942669,157952344,9675,2532,100
157957884,157956523,157965982,9459,2533,100
157971498,157970136,157978012,7876,2534,100
157983492,157982130,157991273,9143,2535,100
157996886,157995308,158005301,9993,2536,100
158010811,158009450,158019226,9776,2537,100
158024772,158023411,158031603,8192,2538,100
158037062,158035701,158045814,10113,2539,100
158051516,158049938,158058030,8092,2540,100
158063514,158062152,158070323,8171,2541,100
158075837,158074475,158082668,8193,2542,100
158088176,158086814,158096591,9777,2543,100
158102139,158100778,158110870,10092,2544,100
158116356,158114994,158125270,10276,2545,100
158130972,158129394,158138753,9359,2546,100
158144368,158142789,158152466,9677,2547,100
158158006,158156644,158165154,8510,2548,100
158170767,158169189,158177282,8093,2549,100
158182729,158181368,158189877,8509,2550,100
158195491,158193913,158203589,9676,2551,100
158209060,158207699,158217157,9458,2552,100
158222691,158221330,158230472,9142,2553,100
158235926,158234564,158243706,9142,2554,100
158249227,158247866,158257325,9459,2555,100
158262938,158261360,158271669,10309,2556,100
158277232,158275870,158284696,8826,2557,100
158290309,158288731,158297140,8409,2558,100
158302617,158301255,158309132,7877,2559,100
158314586,158313224,158323338,10114,2560,100
158328872,158327511,158337287,9776,2561,100
158342777,158341416,158350558,9142,2562,100
158356034,158354673,158363815,9142,2563,100
158369429,158367851,158377844,9993,2564,100
158383458,158381880,158391240,9360,2565,100
158396854,158395276,158405605,10329,2566,100
158411307,158409729,158419405,9676,2567,100
158425019,158423441,158433117,9676,2568,100
158438731,158437153,158445879,8726,2569,100
158451493,158449915,158459274,9359,2570,100
158464888,158463310,158473640,10330,2571,100
158479344,158477765,158486493,8728,2572,100
158491982,158490620,158498814,8194,2573,100
158504336,158502974,158512434,9460,2574,100
158518048,158516470,158526800,10330,2575,100
158532352,158530991,158539163,8172,2576,100
158544778,158543199,158552243,9044,2577,100
158557857,158556279,158565004,8725,2578,100
158570619,158569040,158577134,8094,2579,100
158582596,158581234,158590378,9144,2580,100
158595992,158594414,158604090,9676,2581,100
158609570,158608209,158617034,8825,2582,100
158622568,158621206,158630666,9460,2583,100
158636280,158634702,158644694,9992,2584,100
158650164,158648802,158658579,9777,2585,100
158664078,158662717,158670593,7876,2586,100
158676112,158674750,158682627,7877,2587,100
158688241,158686663,158696023,9360,2588,100
158701637,158700059,158709735,9676,2589,100
158715349,158713771,158723763,9992,2590,100
158729378,158727799,158736525,8726,2591,100
158742138,158740560,158749285,8725,2592,100
158754900,158753321,158762681,9360,2593,100
158768295,158766717,158775443,8726,2594,100
158780971,158779610,158789386,9776,2595,100
158795000,158793422,158801515,8093,2596,100
158807129,158805551,158813940,8389,2597,100
158819554,158817976,158827652,9676,2598,100
158833115,158831754,158841213,9459,2599,100
158846827,158845249,158854925,9676,2600,100
158860399,158859038,158866913,7875,2601,100
158872527,158870949,158880940,9991,2602,100
158886386,158885025,158893196,8171,2603,100
158898810,158897232,158905959,8727,2604,100
158911427,158910066,158919208,9142,2605,100
158924653,158923291,158932435,9144,2606,100
158938049,158936471,158945830,9359,2607,100
158951444,158949866,158959858,9992,2608,100
158965472,158963894,158973253,9359,2609,100
158978720,158977358,158985551,8193,2610,100
158991031,158989670,158999129,9459,2611,100
159004744,159003165,159011259,8094,2612,100
159016874,159015295,159024022,8727,2613,100
159029636,159028058,159037416,9358,2614,100
159043030,159041452,159051782,10330,2615,100
159057370,159056008,159065150,9142,2616,100
159070764,159069186,159078228,9042,2617,100
159083733,159082372,159091514,9142,2618,100
159096976,159095614,159103807,8193,2619,100
159109325,159107963,159116473,8510,2620,100
159121962,159120600,159128476,7876,2621,100
159134091,159132512,159142505,9993,2622,100
159148119,159146541,159155266,8725,2623,100
159160880,159159302,159169610,10308,2624,100
159175208,159173846,159183306,9460,2625,100
159188920,159187342,159197672,10330,2626,100
159203219,159201858,159210367,8509,2627,100
159215981,159214403,159223446,9043,2628,100
159229061,159227482,159235576,8094,2629,100
159241101,159239739,159248566,8827,2630,100
159254180,159252602,159260694,8092,2631,100
159266308,159264730,159274406,9676,2632,100
159279944,159278582,159286775,8193,2633,100
159292266,159290905,159300681,9776,2634,100
159306296,159304717,159315048,10331,2635,100
159320600,159319239,159328065,8826,2636,100
159333565,159332203,159340397,8194,2637,100
159346011,159344433,159353475,9042,2638,100
159359089,159357511,159367841,10330,2639,100
159373544,159371966,159380691,8725,2640,100
159386306,159384727,159395058,10331,2641,100
159400762,159399183,159409177,9994,2642,100
159414644,159413282,159421793,8511,2643,100
159427258,159425897,159435356,9459,2644,100
159440822,159439460,159448287,8827,2645,100
159453901,159452323,159461682,9359,2646,100
159467208,159465847,159474018,8171,2647,100
159479633,159478054,159486148,8094,2648,100
159491763,159490184,159500178,9994,2649,100
159505793,159504214,159514524,10310,2650,100
159520227,159518649,159526742,8093,2651,100
159532283,159530922,159538798,7876,2652,100
159544318,159542956,159550833,7877,2653,100
159556447,159554869,159564229,9360,2654,100
159569843,159568265,159577941,9676,2655,100
159583396,159582035,159591811,9776,2656,100
159597305,159595943,159605086,9143,2657,100
159610589,159609227,159619320,10093,2658,100
159625023,159623445,159632488,9043,2659,100
159638102,159636524,159645250,8726,2660,100
159650789,159649427,159657938,8511,2661,100
159663552,159661974,159671650,9676,2662,100
159677264,159675686,159685994,10308,2663,100
159691550,159690188,159698064,7876,2664,100
159703678,159702100,159711458,9358,2665,100
159717073,159715494,159725171,9677,2666,100
159730785,159729207,159738883,9676,2667,100
159744413,159743052,159751561,8509,2668,100
159757175,159755597,159765590,9993,2669,100
159771061,159769700,159778842,9142,2670,100
159784457,159782878,159792239,9361,2671,100
159797691,159796330,159804502,8172,2672,100
159810116,159808538,159818531,9993,2673,100
159824144,159822567,159831609,9042,2674,100
159837223,159835645,159845953,10308,2675,100
159851656,159850078,159859121,9043,2676,100
159864735,159863157,159871250,8093,2677,100
159876779,159875417,159883926,8509,2678,100
159889412,159888050,159895927,7877,2679,100
159901461,159900100,159910192,10092,2680,100
159915895,159914317,159922410,8093,2681,100
159927947,159926585,159934757,8172,2682,100
159940371,159938793,159947519,8726,2683,100
159953134,159951555,159959649,8094,2684,100
159965097,159963736,159971611,7875,2685,100
159977152,159975790,159983962,8172,2686,100
159989577,159987998,159997991,9993,2687,100
160003605,160002027,160011703,9676,2688,100
160017318,160015740,160025100,9360,2689,100
160030589,160029227,160039320,10093,2690,100
160045024,160043446,160051835,8389,2691,100
160057450,160055872,160065864,9992,2692,100
160071331,160069970,160079746,9776,2693,100
160085275,160083913,160093057,9144,2694,100
160098548,160097186,160107279,10093,2695,100
160112984,160111405,160121399,9994,2696,100
160127014,160125436,160135744,10308,2697,100
160141448,160139870,160148258,8388,2698,100
160153744,160152382,160162158,9776,2699,100
160167649,160166288,160174460,8172,2700,100
160180075,160178497,160186907,8410,2701,100
160192350,160190989,160199815,8826,2702,100
160205430,160203852,160213212,9360,2703,100
160218736,160217375,160226835,9460,2704,100
160232451,160230872,160240866,9994,2705,100
160246407,160245045,160253218,8173,2706,100
160258833,160257255,160265980,8725,2707,100
160271479,160270117,160278944,8827,2708,100
160284560,160282981,160292659,9678,2709,100
160298129,160296768,160306860,10092,2710,100
160312563,160310986,160320029,9043,2711,100
160325643,160324066,160334058,9992,2712,100
160339558,160338197,160346707,8510,2713,100
160352192,160350830,160360607,9777,2714,100
160366135,160364774,160374550,9776,2715,100
160380086,160378724,160387235,8511,2716,100
160392764,160391403,160399912,8509,2717,100
160405462,160404101,160413559,9458,2718,100
160419173,160417596,160426639,9043,2719,100
160432118,160430756,160440217,9461,2720,100
160445832,160444254,160453614,9360,2721,100
160459158,160457797,160467910,10113,2722,100
160473465,160472104,160480275,8171,2723,100
160485673,160484312,160494990,10678,2724,100
160500694,160499116,160509109,9993,2725,100
160514726,160513147,160522191,9044,2726,100
160527807,160526229,160534323,8094,2727,100
160539817,160538456,160546966,8510,2728,100
160552421,160551059,160559570,8511,2729,100
160565185,160563607,160572333,8726,2730,100
160577849,160576488,160585947,9459,2731,100
160591562,160589984,160598078,8094,2732,100
160603693,160602115,160610842,8727,2733,100
160616317,160614956,160623783,8827,2734,100
160629276,160627915,160635792,7877,2735,100
160641408,160639830,160649189,9359,2736,100
160654638,160653276,160662420,9144,2737,100
160667909,160666548,160674741,8193,2738,100
160680211,160678849,160688626,9777,2739,100
160694106,160692744,160700621,7877,2740,100
160706236,160704658,160714335,9677,2741,100
160719951,160718372,160728050,9678,2742,100
160733585,160732223,160740101,7878,2743,100
160745716,160744138,160753498,9360,2744,100
160758949,160757588,160767681,10093,2745,100
160773281,160771920,160779796,7876,2746,100
160785411,160783833,160792243,8410,2747,100
160797858,160796280,160805639,9359,2748,100
160811254,160809676,160819352,9676,2749,100
160824968,160823389,160832750,9361,2750,100
160838365,160836787,160846780,9993,2751,100
160852394,160850817,160860492,9675,2752,100
160866107,160864529,160873889,9360,2753,100
160879504,160877926,160886969,9043,2754,100
160892502,160891140,160901234,10094,2755,100
160906819,160905457,160913630,8173,2756,100
160919245,160917667,160926709,9042,2757,100
160932324,160930746,160940106,9360,2758,100
160945619,160944258,160954034,9776,2759,100
160959550,160958189,160966699,8510,2760,100
160972147,160970785,160980879,10094,2761,100
160986443,160985081,160994225,9144,2762,100
160999719,160998357,161006550,8193,2763,100
161012093,161010732,161018925,8193,2764,100
161024540,161022962,161033292,10330,2765,100
161038996,161037418,161046145,8727,2766,100
161051761,161050182,161058910,8728,2767,100
161064414,161063052,161072829,9777,2768,100
161078445,161076866,161085909,9043,2769,100
161091524,161089946,161098990,9044,2770,100
161104606,161103027,161112071,9044,2771,100
161117591,161116230,161124107,7877,2772,100
161129628,161128265,161136777,8512,2773,100
161142392,161140814,161149857,9043,2774,100
161155336,161153975,161163751,9776,2775,100
161169366,161167788,161176515,8727,2776,100
161182043,161180681,161188875,8194,2777,100
161194415,161193054,161203167,10113,2778,100
161208871,161207293,161216020,8727,2779,100
161221635,161220057,161229100,9043,2780,100
161234716,161233137,161242498,9361,2781,100
161247981,161246619,161256712,10093,2782,100
161262418,161260839,161268934,8095,2783,100
161274476,161273116,161281309,8193,2784,100
161286924,161285346,161295022,9676,2785,100
161300637,161299059,161307153,8094,2786,100
161312768,161311190,161319284,8094,2787,100
161324900,161323321,161333315,9994,2788,100
161338823,161337461,161347555,10094,2789,100
161353260,161351681,161362012,10331,2790,100
161367572,161366209,161376304,10095,2791,100
161382008,161380430,161390423,9993,2792,100
161396039,161394461,161404137,9676,2793,100
161409649,161408288,161417115,8827,2794,100
161422731,161421152,161429880,8728,2795,100
161435496,161433917,161443595,9678,2796,100
161449108,161447747,161455919,8172,2797,100
161461534,161459956,161469633,9677,2798,100
161475248,161473670,161483980,10310,2799,100
161489684,161488106,161498416,10310,2800,100
161504120,161502542,161512851,10309,2801,100
161518468,161517107,161525934,8827,2802,100
161531407,161530045,161538871,8826,2803,100
161544324,161542962,161553055,10093,2804,100
161558611,161557249,161567026,9777,2805,100
161572562,161571201,161581293,10092,2806,100
161586996,161585419,161593808,8389,2807,100
161599208,161597846,161611079,13233,2808,100
161616783,161615205,161623299,8094,2809,100
161628784,161627422,161635932,8510,2810,100
161641547,161639969,161649013,9044,2811,100
161654495,161653134,161661961,8827,2812,100
161667577,161665998,161675675,9677,2813,100
161681291,161679712,161689706,9994,2814,100
161695225,161693863,161702374,8511,2815,100
161707898,161706536,161716630,10094,2816,100
161722335,161720756,161729166,8410,2817,100
161734782,161733203,161741615,8412,2818,100
161747230,161745652,161755645,9993,2819,100
161761261,161759683,161768410,8727,2820,100
161774026,161772448,161781492,9044,2821,100
161787108,161785530,161795207,9677,2822,100
161800822,161799244,161807970,8726,2823,100
161813498,161812136,161821913,9777,2824,100
161827528,161825950,161835943,9993,2825,100
161841397,161840036,161849811,9775,2826,100
161855426,161853848,161864179,10331,2827,100
161869883,161868305,161877348,9043,2828,100
161882962,161881385,161890744,9359,2829,100
161896359,161894781,161904774,9993,2830,100
161910389,161908811,161918171,9360,2831,100
161923663,161922301,161930811,8510,2832,100
161936426,161934848,161944525,9677,2833,100
161950141,161948562,161957923,9361,2834,100
161963413,161962052,161970561,8509,2835,100
161976175,161974598,161983324,8726,2836,100
161988939,161987361,161995454,8093,2837,100
162000956,161999594,162008105,8511,2838,100
162013721,162012142,162020553,8411,2839,100
162026011,162024650,162034426,9776,2840,100
162040041,162038463,162048794,10331,2841,100
162054405,162053044,162063157,10113,2842,100
162068705,162067343,162075854,8511,2843,100
162081302,162079941,162087817,7876,2844,100
162093432,162091854,162101214,9360,2845,100
162106830,162105251,162114928,9677,2846,100
162120400,162119039,162126914,7875,2847,100
162132448,162131086,162139281,8195,2848,100
162144742,162143381,162153156,9775,2849,100
162158603,162157241,162166702,9461,2850,100
162172238,162170877,162180337,9460,2851,100
162185953,162184375,162193735,9360,2852,100
162199196,162197835,162205712,7877,2853,100
162211328,162209750,162218160,8410,2854,100
162223776,162222197,162231557,9360,2855,100
162237090,162235728,162244555,8827,2856,100
162250171,162248593,162258585,9992,2857,100
162264091,162262730,162270902,8172,2858,100
162276517,162274939,162284932,9993,2859,100
162290547,162288969,162297062,8093,2860,100
162302609,162301248,162309125,7877,2861,100
162314642,162313280,162323374,10094,2862,100
162328923,162327561,162337338,9777,2863,100
162342794,162341432,162351209,9777,2864,100
162356826,162355247,162363658,8411,2865,100
162369192,162367831,162376658,8827,2866,100
162382169,162380808,162390267,9459,2867,100
162395883,162394305,162404614,10309,2868,100
162410103,162408741,162419990,11249,2869,100
162425694,162424116,162432505,8389,2870,100
162438120,162436542,162444952,8410,2871,100
162450567,162448989,162458032,9043,2872,100
162463556,162462195,162470388,8193,2873,100
162475847,162474485,162482996,8511,2874,100
162488612,162487034,162495423,8389,2875,100
162500934,162499572,162509687,10115,2876,100
162515390,162513813,162522856,9043,2877,100
162528473,162526894,162535622,8728,2878,100
162541163,162539801,162549895,10094,2879,100
162555470,162554108,162561985,7877,2880,100
162567600,162566022,162574748,8726,2881,100
162580220,162578858,162588635,9777,2882,100
162594082,162592720,162602181,9461,2883,100
162607642,162606281,162615424,9143,2884,100
162620871,162619509,162629286,9777,2885,100
162634776,162633415,162643191,9776,2886,100
162648653,162647292,162655168,7876,2887,100
162660623,162659261,162668722,9461,2888,100
162674338,162672759,162681486,8727,2889,100
162687102,162685524,162695834,10310,2890,100
162701539,162699960,162709321,9361,2891,100
162714936,162713358,162722401,9043,2892,100
162728016,162726438,162734826,8388,2893,100
162740340,162738979,162748438,9459,2894,100
162753929,162752568,162760739,8171,2895,100
162766355,162764777,162774769,9992,2896,100
162780385,162778807,162788166,9359,2897,100
162793701,162792340,162802115,9775,2898,100
162807729,162806152,162814562,8410,2899,100
162820178,162818600,162828593,9993,2900,100
162834210,162832631,162841359,8728,2901,100
162846975,162845397,162853490,8093,2902,100
162859037,162857675,162867134,9459,2903,100
162872749,162871171,162881164,9993,2904,100
162886781,162885202,162895196,9994,2905,100
162900812,162899233,162907328,8095,2906,100
162912850,162911489,162919661,8172,2907,100
162925276,162923698,162932108,8410,2908,100
162937723,162936145,162944555,8410,2909,100
162950170,162948592,162958585,9993,2910,100
162964132,162962771,162970648,7877,2911,100
162976263,162974685,162983095,8410,2912,100
162988631,162987269,162995147,7878,2913,100
163000617,162999255,163008082,8827,2914,100
163013697,163012119,163020845,8726,2915,100
163026344,163024983,163032859,7876,2916,100
163038474,163036896,163047205,10309,2917,100
163052770,163051409,163061185,9776,2918,100
163066636,163065274,163075050,9776,2919,100
163080500,163079139,163089231,10092,2920,100
163094935,163093357,163102401,9044,2921,100
163107889,163106528,163114405,7877,2922,100
163120022,163118443,163128754,10311,2923,100
163134287,163132926,163142702,9776,2924,100
163148317,163146739,163156416,9677,2925,100
163162033,163160454,163168845,8391,2926,100
163174462,163172883,163182244,9361,2927,100
163187737,163186375,163194886,8511,2928,100
163200502,163198924,163208916,9992,2929,100
163214428,163213067,163222527,9460,2930,100
163228142,163226564,163235290,8726,2931,100
163240905,163239327,163247420,8093,2932,100
163252949,163251587,163261047,9460,2933,100
163266663,163265084,163273179,8095,2934,100
163278707,163277345,163285855,8510,2935,100
163291472,163289893,163298621,8728,2936,100
163304100,163302739,163312197,9458,2937,100
163317812,163316234,163325910,9676,2938,100
163331411,163330050,163339826,9776,2939,100
163345441,163343863,163352907,9044,2940,100
163358405,163357044,163365217,8173,2941,100
163370832,163369254,163377663,8409,2942,100
163383278,163381700,163391060,9360,2943,100
163396588,163395227,163405003,9776,2944,100
163410510,163409149,163417025,7876,2945,100
163422515,163421153,163430296,9143,2946,100
163435836,163434475,163442985,8510,2947,100
163448470,163447109,163456252,9143,2948,100
163461868,163460290,163468384,8094,2949,100
163474000,163472422,163481465,9043,2950,100
163486924,163485562,163493440,7878,2951,100
163499057,163497478,163507810,10332,2952,100
163513514,163511936,163521296,9360,2953,100
163526802,163525440,163535217,9777,2954,100
163540765,163539404,163549496,10092,2955,100
163555201,163553622,163563933,10311,2956,100
163569506,163568145,163577604,9459,2957,100
163583072,163581711,163589884,8173,2958,100
163595431,163594069,163603212,9143,2959,100
163608751,163607390,163616532,9142,2960,100
163622148,163620570,163628960,8390,2961,100
163634576,163632997,163642675,9678,2962,100
163648291,163646713,163655756,9043,2963,100
163661372,163659794,163667888,8094,2964,100
163673504,163671926,163682236,10310,2965,100
163687782,163686421,163695881,9460,2966,100
163701497,163699919,163708645,8726,2967,100
163714262,163712683,163720778,8095,2968,100
163726313,163724951,163734727,9776,2969,100
163740344,163738765,163746859,8094,2970,100
163752474,163750896,163758990,8094,2971,100
163764606,163763028,163773338,10310,2972,100
163778876,163777515,163786658,9143,2973,100
163792273,163790696,163799422,8726,2974,100
163804921,163803560,163812702,9142,2975,100
163818319,163816740,163826100,9360,2976,100
163831617,163830256,163839715,9459,2977,100
163845331,163843753,163852480,8727,2978,100
163857971,163856610,163864486,7876,2979,100
163869999,163868638,163877780,9142,2980,100
163883280,163881919,163890744,8825,2981,100
163896359,163894781,163904774,9993,2982,100
163910389,163908811,163919121,10310,2983,100
163924825,163923247,163933557,10310,2984,100
163939262,163937683,163947677,9994,2985,100
163953292,163951714,163960440,8726,2986,100
163966055,163964477,163973836,9359,2987,100
163979352,163977990,163988083,10093,2988,100
163993620,163992259,164000135,7876,2989,100
164005639,164004278,164013421,9143,2990,100
164019036,164017458,164027451,9993,2991,100
164033067,164031488,164039582,8094,2992,100
164045197,164043619,164052346,8727,2993,100
164057961,164056383,164065426,9043,2994,100
164070883,164069522,164077693,8171,2995,100
164083309,164081730,164091724,9994,2996,100
164097339,164095761,164104804,9043,2997,100
164110420,164108841,164118835,9994,2998,100
164124296,164122935,164133028,10093,2999,100
164138626,164137265,164145775,8510,3000,100
164151390,164149812,164158201,8389,3001,100
164163816,164162238,164171915,9677,3002,100
164177530,164175952,164184678,8726,3003,100
164190138,164188777,164198552,9775,3004,100
164204167,164202589,164210978,8389,3005,100
164216593,164215015,164225007,9992,3006,100
164230622,164229044,164237433,8389,3007,100
164243048,164241470,164249859,8389,3008,100
164255347,164253985,164262496,8511,3009,100
164268111,164266533,164275892,9359,3010,100
164281379,164280018,164288845,8827,3011,100
164294461,164292882,164302876,9994,3012,100
164308491,164306913,164317223,10310,3013,100
164322928,164321349,164330710,9361,3014,100
164336217,164334856,164344949,10093,3015,100
164350491,164349129,164357957,8828,3016,100
164363411,164362050,164370876,8826,3017,100
164376491,164374913,164384590,9677,3018,100
164390073,164388711,164398487,9776,3019,100
164404102,164402524,164412517,9993,3020,100
164418132,164416554,164426546,9992,3021,100
164432035,164430673,164438551,7878,3022,100
164444166,164442588,164451315,8727,3023,100
164456783,164455421,164463594,8173,3024,100
164469062,164467701,164477161,9460,3025,100
164482697,164481336,164490795,9459,3026,100
164496411,164494832,164503559,8727,3027,100
164509049,164507687,164517147,9460,3028,100
164522761,164521184,164529572,8388,3029,100
164535187,164533609,164543919,10310,3030,100
164549623,164548045,164557087,9042,3031,100
164562702,164561124,164570484,9360,3032,100
164576099,164574521,164584196,9675,3033,100
164589689,164588328,164597470,9142,3034,100
164602973,164601612,164611387,9775,3035,100
164616903,164615541,164625002,9461,3036,100
164630617,164629039,164637765,8726,3037,100
164643250,164641889,164651348,9459,3038,100
164656964,164655386,164664746,9360,3039,100
164670361,164668783,164677510,8727,3040,100
164682976,164681614,164689491,7877,3041,100
164694995,164693633,164703727,10094,3042,100
164709294,164707933,164716760,8827,3043,100
164722375,164720797,164730472,9675,3044,100
164736088,164734510,164742898,8388,3045,100
164748363,164747001,164756145,9144,3046,100
164761673,164760311,164768822,8511,3047,100
164774439,164772860,164781250,8390,3048,100
164786766,164785404,164794231,8827,3049,100
164799777,164798416,164807558,9142,3050,100
164813174,164811595,164821905,10310,3051,100
164827610,164826031,164835075,9044,3052,100
164840691,164839112,164847839,8727,3053,100
164853454,164851876,164861553,9677,3054,100
164867168,164865590,164873684,8094,3055,100
164879299,164877721,164887397,9676,3056,100
164893013,164891434,164900795,9361,3057,100
164906410,164904832,164914509,9677,3058,100
164919955,164918594,164926766,8172,3059,100
164932232,164930871,164939043,8172,3060,100
164944514,164943152,164951663,8511,3061,100
164957172,164955810,164963983,8173,3062,100
164969440,164968078,164977539,9461,3063,100
164983154,164981576,164989965,8389,3064,100
164995580,164994002,165004311,10309,3065,100
165010015,165008437,165018112,9675,3066,100
165023660,165022299,165030175,7876,3067,100
165035792,165034213,165044524,10311,3068,100
165050077,165048715,165056592,7877,3069,100
165062099,165060737,165069248,8511,3070,100
165074863,165073285,165082011,8726,3071,100
165087626,165086048,165096357,10309,3072,100
165101897,165100536,165109679,9143,3073,100
165115294,165113716,165123076,9360,3074,100
165128610,165127248,165137025,9777,3075,100
165142489,165141128,165150588,9460,3076,100
165156203,165154625,165164300,9675,3077,100
165169788,165168426,165178519,10093,3078,100
165184074,165182712,165190590,7878,3079,100
165196205,165194627,165203669,9042,3080,100
165209284,165207706,165216432,8726,3081,100
165222047,165220469,165230462,9993,3082,100
165235927,165234565,165243076,8511,3083,100
165248691,165247113,165256473,9360,3084,100
165262000,165260638,165270732,10094,3085,100
165276436,165274858,165285168,10310,3086,100
165290752,165289391,165297563,8172,3087,100
165303179,165301600,165310961,9361,3088,100
165316468,165315106,165324250,9144,3089,100
165329865,165328287,165337331,9044,3090,100
165342818,165341456,165351550,10094,3091,100
165357255,165355676,165365353,9677,3092,100
165370968,165369390,165379383,9993,3093,100
165384928,165383566,165392710,9144,3094,100
165398326,165396747,165407058,10311,3095,100
165412633,165411272,165419782,8510,3096,100
165425397,165423819,165433179,9360,3097,100
165438794,165437216,165445942,8726,3098,100
165451434,165450072,165459849,9777,3099,100
165465465,165463886,165472613,8727,3100,100
165478229,165476651,165486327,9676,3101,100
165491818,165490456,165499283,8827,3102,100
165504733,165503371,165513148,9777,3103,100
165518642,165517281,165527057,9776,3104,100
165532672,165531094,165539820,8726,3105,100
165545349,165543988,165553764,9776,3106,100
165559379,165557801,165566845,9044,3107,100
165572461,165570882,165580243,9361,3108,100
165585858,165584280,165593324,9044,3109,100
165598939,165597361,165605455,8094,3110,100
165611070,165609492,165619169,9677,3111,100
165624683,165623321,165631832,8511,3112,100
165637360,165635999,165645141,9142,3113,100
165650594,165649232,165657405,8173,3114,100
165663020,165661442,165669536,8094,3115,100
165674995,165673633,165682460,8827,3116,100
165687955,165686594,165696686,10092,3117,100
165702267,165700905,165710998,10093,3118,100
165716539,165715177,165724637,9460,3119,100
165730127,165728765,165736938,8173,3120,100
165742553,165740975,165750018,9043,3121,100
165755567,165754206,165762378,8172,3122,100
165767994,165766415,165775460,9045,3123,100
165781009,165779648,165787820,8172,3124,100
165793435,165791857,165800584,8727,3125,100
165806030,165804669,165813812,9143,3126,100
165819299,165817937,165826764,8827,3127,100
165832279,165830917,165840376,9459,3128,100
165845858,165844496,165853957,9461,3129,100
165859573,165857994,165866384,8390,3130,100
165871923,165870561,165879389,8828,3131,100
165884937,165883575,165893352,9777,3132,100
165898967,165897389,165906432,9043,3133,100
165911884,165910522,165919665,9143,3134,100
165925192,165923830,165932974,9144,3135,100
165938469,165937107,165945280,8173,3136,100
165950895,165949317,165959310,9993,3137,100
165964824,165963463,165972606,9143,3138,100
165978221,165976643,165985370,8727,3139,100
165990986,165989407,165997797,8390,3140,100
166003255,166001894,166011037,9143,3141,100
166016553,166015192,166024018,8826,3142,100
166029634,166028056,166037416,9360,3143,100
166043032,166041454,166050498,9044,3144,100
166056113,166054535,166062628,8093,3145,100
166068243,166066665,166076657,9992,3146,100
166082273,166080695,166089739,9044,3147,100
166095354,166093776,166103453,9677,3148,100
166109068,166107490,166117482,9992,3149,100
166123012,166121651,166130161,8510,3150,100
166135641,166134280,166143739,9459,3151,100
166149354,166147776,166157452,9676,3152,100
166162925,166161563,166171657,10094,3153,100
166177362,166175783,166185461,9678,3154,100
166190968,166189607,166197779,8172,3155,100
166203269,166201908,166210080,8172,3156,100
166215578,166214217,166223676,9459,3157,100
166229156,166227795,166235672,7877,3158,100
166241151,166239789,166247666,7877,3159,100
166253142,166251780,166259953,8173,3160,100
166265568,166263990,166272716,8726,3161,100
166278332,166276754,166286748,9994,3162,100
166292274,166290912,166301005,10093,3163,100
166306586,166305224,166314367,9143,3164,100
166319984,166318405,166328400,9995,3165,100
166333850,166332488,166340660,8172,3166,100
166346276,166344698,166353087,8389,3167,100
166358575,166357214,166365090,7876,3168,100
166370567,166369205,166379299,10094,3169,100
166385005,166383426,166391521,8095,3170,100
166397136,166395558,166405866,10308,3171,100
166411570,166409992,166418085,8093,3172,100
166423605,166422244,166432335,10091,3173,100
166437951,166436590,166445416,8826,3174,100
166450891,166449529,166458990,9461,3175,100
166464445,166463084,166472544,9460,3176,100
166478159,166476581,166486257,9676,3177,100
166491871,166490294,166499337,9043,3178,100
166504952,166503374,166512101,8727,3179,100
166517717,166516138,166525499,9361,3180,100
166531114,166529536,166538578,9042,3181,100
166544044,166542683,166550855,8172,3182,100
166556470,166554892,166564252,9360,3183,100
166569779,166568418,166577877,9459,3184,100
166583416,166582055,166590565,8510,3185,100
166596181,166594603,166602992,8389,3186,100
166608518,166607157,166615033,7876,3187,100
166620648,166619070,166629380,10310,3188,100
166635084,166633506,166642549,9043,3189,100
166648164,166646586,166654975,8389,3190,100
166660591,166659012,166667402,8390,3191,100
166673018,166671439,166680483,9044,3192,100
166686098,166684520,166692909,8389,3193,100
166698524,166696946,166706623,9677,3194,100
166712239,166710661,166719050,8389,3195,100
166724575,166723213,166733307,10094,3196,100
166738889,166737528,166747621,10093,3197,100
166753325,166751747,166762057,10310,3198,100
166767761,166766183,166776176,9993,3199,100
166781658,166780296,166789440,9144,3200,100
166795055,166793477,166803152,9675,3201,100
166808694,166807333,166815505,8172,3202,100
166821121,166819542,166828269,8727,3203,100
166833885,166832306,166842617,10311,3204,100
166848320,166846743,166857052,10309,3205,100
166862756,166861178,166871171,9993,3206,100
166876709,166875347,166885441,10094,3207,100
166891025,166889664,166899440,9776,3208,100
166905056,166903477,166912838,9361,3209,100
166918453,166916875,166925917,9042,3210,100
166931446,166930085,166939860,9775,3211,100
166945401,166944040,166952549,8509,3212,100
166958164,166956586,166966579,9993,3213,100
166972194,166970616,166980925,10309,3214,100
166986532,166985170,166994313,9143,3215,100
166999928,166998350,167007076,8726,3216,100
167012690,167011113,167021105,9992,3217,100
167026722,167025143,167035137,9994,3218,100
167040752,167039174,167047268,8094,3219,100
167052788,167051426,167060253,8827,3220,100
167065868,167064290,167073650,9360,3221,100
167079265,167077687,167086414,8727,3222,100
167092029,167090451,167099177,8726,3223,100
167104677,167103316,167113409,10093,3224,100
167118946,167117585,167126095,8510,3225,100
167131575,167130214,167139357,9143,3226,100
167144973,167143394,167152438,9044,3227,100
167157979,167156618,167166393,9775,3228,100
167171900,167170539,167178711,8172,3229,100
167184326,167182748,167192107,9359,3230,100
167197578,167196216,167204389,8173,3231,100
167210003,167208426,167218734,10308,3232,100
167224438,167222860,167230953,8093,3233,100
167236469,167235107,167243617,8510,3234,100
167249096,167247735,167257511,9776,3235,100
167262987,167261626,167271719,10093,3236,100
167277423,167275845,167285521,9676,3237,100
167291136,167289558,167297947,8389,3238,100
167303562,167301984,167310373,8389,3239,100
167315899,167314538,167323681,9143,3240,100
167329170,167327808,167337268,9460,3241,100
167342733,167341371,167350514,9143,3242,100
167355983,167354622,167362795,8173,3243,100
167368261,167366900,167374776,7876,3244,100
167380392,167378813,167388491,9678,3245,100
167394106,167392528,167401570,9042,3246,100
167407186,167405608,167415284,9676,3247,100
167420757,167419396,167427906,8510,3248,100
167433521,167431943,167440332,8389,3249,100
167445947,167444369,167454700,10331,3250,100
167460404,167458826,167467870,9044,3251,100
167473337,167471976,167481118,9142,3252,100
167486590,167485229,167493738,8509,3253,100
167499199,167497837,167506981,9144,3254,100
167512530,167511169,167520945,9776,3255,100
167526561,167524982,167533392,8410,3256,100
167539007,167537429,167547739,10310,3257,100
167553444,167551865,167561226,9361,3258,100
167566841,167565263,167573357,8094,3259,100
167578972,167577394,167587071,9677,3260,100
167592569,167591208,167601301,10093,3261,100
167607005,167605427,167613521,8094,3262,100
167619137,167617558,167625653,8095,3263,100
167631103,167629741,167638885,9144,3264,100
167644404,167643042,167651236,8194,3265,100
167656776,167655414,167664242,8828,3266,100
167669753,167668392,167676565,8173,3267,100
167682181,167680603,167690934,10331,3268,100
167696485,167695123,167705238,10115,3269,100
167710942,167709364,167719357,9993,3270,100
167724846,167723484,167733261,9777,3271,100
167738876,167737298,167746658,9360,3272,100
167752116,167750755,167758632,7877,3273,100
167764247,167762669,167770762,8093,3274,100
167776377,167774799,167784160,9361,3275,100
167789776,167788198,167798508,10310,3276,100
167804057,167802696,167811840,9144,3277,100
167817456,167815878,167825238,9360,3278,100
167830855,167829276,167838637,9361,3279,100
167844149,167842787,167852903,10116,3280,100
167858508,167857146,167865025,7879,3281,100
167870642,167869064,167879057,9993,3282,100
167884673,167883095,167892455,9360,3283,100
167897979,167896617,167906078,9461,3284,100
167911607,167910246,167919072,8826,3285,100
167924593,167923232,167933346,10114,3286,100
167939051,167937473,167947804,10331,3287,100
167953340,167951979,167962094,10115,3288,100
167967647,167966285,167974796,8511,3289,100
167980325,167978963,167987791,8828,3290,100
167993407,167991829,168001190,9361,3291,100
168006681,168005320,168015434,10114,3292,100
168021044,168019683,168029142,9459,3293,100
168034625,168033263,168041141,7878,3294,100
168046598,168045236,168053430,8194,3295,100
168058877,168057516,168067630,10114,3296,100
168073207,168071845,168080355,8510,3297,100
168085972,168084393,168092488,8095,3298,100
168098000,168096639,168105466,8827,3299,100
168110981,168109620,168119080,9460,3300,100
168124697,168123118,168133113,9995,3301,100
168138662,168137300,168145178,7878,3302,100
168150694,168149332,168158477,9145,3303,100
168164093,168162515,168171876,9361,3304,100
168177420,168176058,168185519,9461,3305,100
168191135,168189557,168199550,9993,3306,100
168205023,168203661,168211856,8195,3307,100
168217473,168215894,168224939,9045,3308,100
168230555,168228977,168238971,9994,3309,100
168244588,168243010,168251736,8726,3310,100
168257354,168255775,168264820,9045,3311,100
168270436,168268858,168277585,8727,3312,100
168283115,168281754,168290265,8511,3313,100
168295712,168294350,168302228,7878,3314,100
168307845,168306267,168315627,9360,3315,100
168321244,168319665,168327760,8095,3316,100
168333378,168331799,168341477,9678,3317,100
168347019,168345657,168354801,9144,3318,100
168360268,168358906,168366784,7878,3319,100
168372400,168370822,168380182,9360,3320,100
168385798,168384220,168393580,9360,3321,100
168399057,168397696,168407810,10114,3322,100
168413346,168411984,168421128,9144,3323,100
168426626,168425264,168435358,10094,3324,100
168441063,168439485,168449162,9677,3325,100
168454627,168453265,168462725,9460,3326,100
168468231,168466870,168474747,7877,3327,100
168480216,168478855,168487682,8827,3328,100
168493299,168491720,168501715,9995,3329,100
168507331,168505753,168515747,9994,3330,100
168521363,168519785,168529777,9992,3331,100
168535393,168533815,168543808,9993,3332,100
168549426,168547847,168556575,8728,3333,100
168562191,168560613,168569339,8726,3334,100
168574955,168573377,168581472,8095,3335,100
168586936,168585574,168594085,8511,3336,100
168599702,168598124,168606852,8728,3337,100
168612469,168610891,168621222,10331,3338,100
168626800,168625438,168635216,9778,3339,100
168640832,168639254,168647348,8094,3340,100
168652967,168651387,168659483,8096,3341,100
168664974,168663612,168673389,9777,3342,100
168678840,168677478,168687256,9778,3343,100
168692873,168691295,168700972,9677,3344,100
168706590,168705011,168713106,8095,3345,100
168718631,168717270,168725463,8193,3346,100
168731080,168729502,168738863,9361,3347,100
168744330,168742969,168751142,8173,3348,100
168756760,168755181,168765176,9995,3349,100
168770793,168769215,168778892,9677,3350,100
168784508,168782930,168791974,9044,3351,100
168797511,168796149,168806243,10094,3352,100
168811830,168810468,168818663,8195,3353,100
168824173,168822811,168831006,8195,3354,100
168836623,168835045,168845376,10331,3355,100
168850949,168849587,168859365,9778,3356,100
168864981,168863403,168872764,9361,3357,100
168878272,168876911,168887004,10093,3358,100
168892709,168891131,168900175,9044,3359,100
168905699,168904338,168913481,9143,3360,100
168919099,168917520,168926249,8729,3361,100
168931867,168930288,168938384,8096,3362,100
168944001,168942423,168952733,10310,3363,100
168958322,168956960,168964839,7879,3364,100
168970455,168968877,168978238,9361,3365,100
168983774,168982412,168991240,8828,3366,100
168996707,168995346,169005439,10093,3367,100
169011017,169009656,169018483,8827,3368,100
169023974,169022613,169030489,7876,3369,100
169035980,169034619,169044712,10093,3370,100
169050285,169048924,169059016,10092,3371,100
169064582,169063219,169072680,9461,3372,100
169078298,169076719,169086081,9362,3373,100
169091550,169090189,169098065,7876,3374,100
169103596,169102234,169112328,10094,3375,100
169117942,169116580,169126674,10094,3376,100
169132379,169130801,169141111,10310,3377,100
169146671,169145310,169155402,10092,3378,100
169161107,169159529,169169522,9993,3379,100
169175030,169173669,169182813,9144,3380,100
169188274,169186913,169194790,7877,3381,100
169200277,169198916,169206792,7876,3382,100
169212241,169210880,169220657,9777,3383,100
169226156,169224794,169232671,7877,3384,100
169238220,169236858,169246318,9460,3385,100
169251935,169250356,169258450,8094,3386,100
169263972,169262611,169271437,8826,3387,100
169277054,169275476,169284836,9360,3388,100
169290312,169288951,169298411,9460,3389,100
169303912,169302551,169312010,9459,3390,100
169317627,169316048,169326358,10310,3391,100
169332063,169330485,169340162,9677,3392,100
169345640,169344278,169352452,8174,3393,100
169358070,169356491,169365852,9361,3394,100
169371381,169370020,169379163,9143,3395,100
169384780,169383201,169392563,9362,3396,100
169398179,169396601,169406911,10310,3397,100
169412616,169411038,169420082,9044,3398,100
169425698,169424120,169433479,9359,3399,100
169439095,169437517,169446245,8728,3400,100
169451862,169450284,169459961,9677,3401,100
169465577,169463999,169473676,9677,3402,100
169479191,169477829,169485707,7878,3403,100
169491323,169489745,169497839,8094,3404,100
169503382,169502021,169511797,9776,3405,100
169517414,169515836,169526147,10311,3406,100
169531686,169530325,169539469,9144,3407,100
169545085,169543507,169551601,8094,3408,100
169557218,169555640,169564029,8389,3409,100
169569646,169568068,169576457,8389,3410,100
169581969,169580607,169589118,8511,3411,100
169594606,169593245,169603337,10092,3412,100
169609043,169607464,169616826,9362,3413,100
169622332,169620971,169630114,9143,3414,100
169635730,169634152,169642880,8728,3415,100
169648416,169647054,169655228,8174,3416,100
169660712,169659350,169668810,9460,3417,100
169674427,169672849,169680943,8094,3418,100
169686443,169685081,169692959,7878,3419,100
169698576,169696997,169706991,9994,3420,100
169712449,169711088,169719598,8510,3421,100
169725214,169723636,169733313,9677,3422,100
169738782,169737420,169747513,10093,3423,100
169753218,169751640,169760367,8727,3424,100
169765983,169764405,169772500,8095,3425,100
169778116,169776538,169785582,9044,3426,100
169791199,169789621,169799298,9677,3427,100
169804792,169803431,169812891,9460,3428,100
169818507,169816929,169827240,10311,3429,100
169832776,169831415,169840242,8827,3430,100
169845858,169844280,169852374,8094,3431,100
169857910,169856548,169865692,9144,3432,100
169871185,169869824,169878650,8826,3433,100
169884165,169882803,169890680,7877,3434,100
169896296,169894719,169904712,9993,3435,100
169910329,169908751,169917141,8390,3436,100
169922601,169921239,169930384,9145,3437,100
169935862,169934500,169942672,8172,3438,100
169948289,169946711,169956388,9677,3439,100
169961889,169960527,169968722,8195,3440,100
169974338,169972760,169982437,9677,3441,100
169988054,169986476,169994866,8390,3442,100
170000370,169999009,170007836,8827,3443,100
170013453,170011875,170021551,9676,3444,100
170027020,170025658,170035752,10094,3445,100
170041310,170039949,170050041,10092,3446,100
170055747,170054169,170062264,8095,3447,100
170067777,170066415,170075242,8827,3448,100
170080754,170079392,170089169,9777,3449,100
170094785,170093207,170101597,8390,3450,100
170107111,170105750,170114576,8826,3451,100
170120192,170118614,170127341,8727,3452,100
170132957,170131379,170139473,8094,3453,100
170144943,170143581,170151459,7878,3454,100
170157076,170155498,170165808,10310,3455,100
170171344,170169982,170179443,9461,3456,100
170184890,170183528,170191702,8174,3457,100
170197169,170195807,170205267,9460,3458,100
170210885,170209306,170217402,8096,3459,100
170222936,170221574,170230402,8828,3460,100
170235870,170234508,170244286,9778,3461,100
170249811,170248450,170258227,9777,3462,100
170263692,170262331,170271791,9460,3463,100
170277292,170275931,170284103,8172,3464,100
170289719,170288141,170297818,9677,3465,100
170303434,170301856,170311849,9993,3466,100
170317466,170315888,170324278,8390,3467,100
170329895,170328317,170338628,10311,3468,100
170344335,170342756,170351801,9045,3469,100
170357417,170355839,170364567,8728,3470,100
170370049,170368688,170376861,8173,3471,100
170382400,170381039,170390816,9777,3472,100
170396269,170394908,170403417,8509,3473,100
170408926,170407565,170415737,8172,3474,100
170421222,170419860,170429320,9460,3475,100
170434851,170433490,170441367,7877,3476,100
170446983,170445405,170455082,9677,3477,100
170460698,170459120,170467848,8728,3478,100
170473464,170471886,170481246,9360,3479,100
170486791,170485430,170493939,8509,3480,100
170499556,170497978,170506366,8388,3481,100
170511982,170510404,170518794,8390,3482,100
170524295,170522933,170532078,9145,3483,100
170537536,170536175,170545952,9777,3484,100
170551568,170549990,170559350,9360,3485,100
170564851,170563490,170572950,9460,3486,100
170578566,170576988,170585082,8094,3487,100
170590698,170589120,170598163,9043,3488,100
170603779,170602201,170611560,9359,3489,100
170617177,170615598,170624643,9045,3490,100
170630098,170628736,170636613,7877,3491,100
170642230,170640652,170649696,9044,3492,100
170655185,170653824,170661997,8173,3493,100
170667613,170666035,170676029,9994,3494,100
170681576,170680215,170689991,9776,3495,100
170695608,170694030,170703390,9360,3496,100
170708940,170707578,170716088,8510,3497,100
170721614,170720252,170729396,9144,3498,100
170735012,170733434,170742794,9360,3499,100
170748305,170746943,170755116,8173,3500,100
170760732,170759154,170767248,8094,3501,100
170772774,170771413,170781190,9777,3502,100
170786653,170785291,170793169,7878,3503,100
170798785,170797207,170805301,8094,3504,100
170810799,170809437,170817315,7878,3505,100
170822931,170821353,170830714,9361,3506,100
170836330,170834752,170843142,8390,3507,100
170848597,170847235,170856379,9144,3508,100
170861824,170860463,170868974,8511,3509,100
170874442,170873080,170881908,8828,3510,100
170887357,170885996,170893873,7877,3511,100
170899333,170897972,170907115,9143,3512,100
170912602,170911241,170919414,8173,3513,100
170925031,170923452,170932497,9045,3514,100
170937969,170936607,170946068,9461,3515,100
170951685,170950107,170958200,8093,3516,100
170963726,170962365,170971192,8827,3517,100
170976809,170975231,170983958,8727,3518,100
170989575,170987997,170996387,8390,3519,100
171001934,171000573,171010686,10113,3520,100
171016391,171014813,171023856,9043,3521,100
171029473,171027895,171036285,8390,3522,100
171041902,171040324,171050318,9994,3523,100
171055936,171054357,171062748,8391,3524,100
171068226,171066864,171076324,9460,3525,100
171081942,171080363,171089724,9361,3526,100
171095194,171093832,171102660,8828,3527,100
171108277,171106698,171116692,9994,3528,100
171122231,171120870,171130647,9777,3529,100
171136264,171134686,171144679,9993,3530,100
171150132,171148770,171156649,7879,3531,100
171162266,171160687,171170998,10311,3532,100
171176703,171175126,171185119,9993,3533,100
171190650,171189288,171198433,9145,3534,100
171204050,171202472,171212149,9677,3535,100
171217647,171216286,171224162,7876,3536,100
171229693,171228331,171238425,10094,3537,100
171244130,171242552,171250645,8093,3538,100
171256168,171254806,171263633,8827,3539,100
171269249,171267671,171278002,10331,3540,100
171283707,171282129,171291172,9043,3541,100
171296623,171295261,171304406,9145,3542,100
171309895,171308533,171318310,9777,3543,100
171323858,171322496,171331957,9461,3544,100
171337574,171335996,171344407,8411,3545,100
171349865,171348504,171357648,9144,3546,100
171363265,171361686,171370730,9044,3547,100
171376347,171374769,171382864,8095,3548,100
171388481,171386902,171396580,9678,3549,100
171402047,171400686,171408879,8193,3550,100
171414495,171412918,171422594,9676,3551,100
171428211,171426633,171434726,8093,3552,100
171440190,171438829,171448921,10092,3553,100
171454626,171453048,171461438,8390,3554,100
171466966,171465605,171473778,8173,3555,100
171479395,171477816,171487494,9678,3556,100
171492962,171491600,171501061,9461,3557,100
171506679,171505100,171513491,8391,3558,100
171519108,171517530,171526574,9044,3559,100
171532191,171530613,171539656,9043,3560,100
171545272,171543694,171554004,10310,3561,100
171559709,171558131,171566859,8728,3562,100
171572476,171570898,171579942,9044,3563,100
171585559,171583981,171594291,10310,3564,100
171599997,171598418,171608096,9678,3565,100
171613713,171612135,171627827,15692,3566,100
171633532,171631954,171640048,8094,3567,100
171645515,171644154,171653298,9144,3568,100
171658743,171657382,171666525,9143,3569,100
171672042,171670681,171679825,9144,3570,100
171685442,171683864,171694196,10332,3571,100
171699761,171698399,171708515,10116,3572,100
171714220,171712642,171722318,9676,3573,100
171727812,171726450,171734329,7879,3574,100
171739858,171738496,171747006,8510,3575,100
171752622,171751044,171759455,8411,3576,100
171764907,171763546,171771423,7877,3577,100
171777041,171775462,171783556,8094,3578,100
171789050,171787688,171796199,8511,3579,100
171801652,171800290,171808800,8510,3580,100
171814415,171812838,171822198,9360,3581,100
171827815,171826236,171834648,8412,3582,100
171840265,171838687,171847414,8727,3583,100
171853031,171851453,171861447,9994,3584,100
171866934,171865572,171875688,10116,3585,100
171881394,171879815,171890126,10311,3586,100
171895832,171894254,171902664,8410,3587,100
171908131,171906769,171916230,9461,3588,100
171921716,171920355,171928527,8172,3589,100
171934144,171932566,171941294,8728,3590,100
171946761,171945399,171954861,9462,3591,100
171960324,171958962,171969076,10114,3592,100
171974782,171973204,171981615,8411,3593,100
171987233,171985654,171995332,9678,3594,100
172000949,171999371,172009365,9994,3595,100
172014983,172013404,172021816,8412,3596,100
172027433,172025855,172035215,9360,3597,100
172040683,172039321,172047832,8511,3598,100
172053300,172051938,172060766,8828,3599,100
172066382,172064804,172074798,9994,3600,100
172080414,172078836,172088197,9361,3601,100
172093673,172092311,172101454,9143,3602,100
172107071,172105493,172114537,9044,3603,100
172120044,172118683,172128143,9460,3604,100
172133759,172132181,172140275,8094,3605,100
172145891,172144313,172153989,9676,3606,100
172159513,172158152,172166029,7877,3607,100
172171646,172170067,172178162,8095,3608,100
172183778,172182200,172190590,8390,3609,100
172196206,172194628,172202722,8094,3610,100
172208224,172206863,172215372,8509,3611,100
172220989,172219411,172228138,8727,3612,100
172233755,172232177,172241221,9044,3613,100
172246837,172245259,172255253,9994,3614,100
172260715,172259353,172268496,9143,3615,100
172274113,172272534,172282845,10311,3616,100
172288551,172286972,172295384,8412,3617,100
172300846,172299485,172308311,8826,3618,100
172313761,172312400,172320277,7877,3619,100
172325768,172324407,172333233,8826,3620,100
172338728,172337367,172347460,10093,3621,100
172353166,172351588,172361898,10310,3622,100
172367604,172366025,172374120,8095,3623,100
172379618,172378257,172387716,9459,3624,100
172393199,172391838,172401297,9459,3625,100
172406914,172405336,172415329,9993,3626,100
172420875,172419513,172428973,9460,3627,100
172434452,172433091,172441602,8511,3628,100
172447107,172445746,172455523,9777,3629,100
172461139,172459561,172467951,8390,3630,100
172473461,172472100,172480611,8511,3631,100
172486107,172484746,172494206,9460,3632,100
172499728,172498366,172506878,8512,3633,100
172512409,172511047,172519221,8174,3634,100
172524696,172523335,172533429,10094,3635,100
172539134,172537556,172545946,8390,3636,100
172551562,172549984,172558078,8094,3637,100
172563696,172562117,172572428,10311,3638,100
172578134,172576555,172585600,9045,3639,100
172591135,172589774,172599550,9776,3640,100
172605168,172603589,172612951,9362,3641,100
172618568,172616990,172625380,8390,3642,100
172630839,172629478,172638937,9459,3643,100
172644555,172642976,172652338,9362,3644,100
172657808,172656445,172665907,9462,3645,100
172671525,172669946,172678991,9045,3646,100
172684518,172683156,172693249,10093,3647,100
172698866,172697504,172705383,7879,3648,100
172711000,172709422,172719733,10311,3649,100
172725286,172723924,172732097,8173,3650,100
172737607,172736246,172745072,8826,3651,100
172750618,172749256,172757768,8512,3652,100
172763245,172761884,172770056,8172,3653,100
172775673,172774095,172784406,10311,3654,100
172789952,172788590,172797735,9145,3655,100
172803189,172801827,172810971,9144,3656,100
172816587,172815009,172825320,10311,3657,100
172831027,172829448,172837839,8391,3658,100
172843457,172841878,172852190,10312,3659,100
172857894,172856317,172866626,10309,3660,100
172872163,172870802,172878975,8173,3661,100
172884592,172883014,172892691,9677,3662,100
172898309,172896730,172905774,9044,3663,100
172911390,172909812,172917905,8093,3664,100
172923386,172922025,172931484,9459,3665,100
172937102,172935523,172945835,10312,3666,100
172951540,172949962,172958351,8389,3667,100
172963969,172962390,172971751,9361,3668,100
172977368,172975790,172985467,9677,3669,100
172990979,172989617,172999395,9778,3670,100
173004858,173003496,173012957,9461,3671,100
173018415,173017054,173025881,8827,3672,100
173031497,173029919,173040229,10310,3673,100
173045935,173044357,173053717,9360,3674,100
173059334,173057756,173065850,8094,3675,100
173071386,173070024,173077901,7877,3676,100
173083448,173082087,173091547,9460,3677,100
173097165,173095586,173105264,9678,3678,100
173110881,173109303,173119295,9992,3679,100
173124749,173123387,173131561,8174,3680,100
173137177,173135599,173145276,9677,3681,100
173150779,173149417,173157590,8173,3682,100
173163120,173161758,173169930,8172,3683,100
173175383,173174021,173183799,9778,3684,100
173189246,173187885,173196058,8173,3685,100
173201519,173200157,173210250,10093,3686,100
173215798,173214436,173223264,8828,3687,100
173228730,173227369,173237462,10093,3688,100
173243167,173241589,173249684,8095,3689,100
173255302,173253723,173262113,8390,3690,100
173267626,173266264,173274437,8173,3691,100
173279970,173278608,173286487,7879,3692,100
173292104,173290526,173299886,9360,3693,100
173305502,173303924,173312651,8727,3694,100
173318196,173316835,173327882,11047,3695,100
173333499,173332138,173340311,8173,3696,100
173345795,173344433,173353895,9462,3697,100
173359511,173357933,173366978,9045,3698,100
173372595,173371017,173379112,8095,3699,100
173384618,173383256,173391768,8512,3700,100
173397256,173395895,173405040,9145,3701,100
173410493,173409132,173418909,9777,3702,100
173424431,173423070,173433164,10094,3703,100
173438870,173437292,173446653,9361,3704,100
173452270,173450692,173460687,9995,3705,100
173466304,173464726,173474087,9361,3706,100
173479533,173478172,173487633,9461,3707,100
173493250,173491672,173501349,9677,3708,100
173506881,173505519,173514663,9144,3709,100
173520280,173518702,173528380,9678,3710,100
173533831,173532469,173541298,8829,3711,100
173546915,173545336,173554066,8730,3712,100
173559683,173558105,173566495,8390,3713,100
173571969,173570607,173578486,7879,3714,100
173584012,173582650,173591162,8512,3715,100
173596684,173595322,173603834,8512,3716,100
173609451,173607873,173616918,9045,3717,100
173622535,173620957,173630002,9045,3718,100
173635530,173634168,173643947,9779,3719,100
173649563,173647985,173658295,10310,3720,100
173664001,173662423,173672100,9677,3721,100
173677567,173676205,173685984,9779,3722,100
173691600,173690022,173698117,8095,3723,100
173703576,173702215,173711360,9145,3724,100
173716977,173715399,173725710,10311,3725,100
173731318,173729957,173738131,8174,3726,100
173743627,173742266,173752043,9777,3727,100
173757514,173756153,173764665,8512,3728,100
173770281,173768703,173778697,9994,3729,100
173784219,173782858,173791370,8512,3730,100
173796859,173795499,173805275,9776,3731,100
173810890,173809313,173819623,10310,3732,100
173825328,173823750,173831844,8094,3733,100
173837461,173835883,173844928,9045,3734,100
173850373,173849012,173858156,9144,3735,100
173863671,173862310,173870483,8173,3736,100
173876100,173874522,173883883,9361,3737,100
173889342,173887981,173896809,8828,3738,100
173902426,173900847,173910210,9363,3739,100
173915828,173914249,173924245,9996,3740,100
173929711,173928349,173938444,10095,3741,100
173944149,173942571,173952882,10311,3742,100
173958428,173957066,173965894,8828,3743,100
173971396,173970035,173980128,10093,3744,100
173985833,173984255,173993616,9361,3745,100
173999077,173997715,174006543,8828,3746,100
174012160,174010581,174018973,8392,3747,100
174024591,174023012,174031403,8391,3748,100
174036894,174035533,174043412,7879,3749,100
174048930,174047568,174056714,9146,3750,100
174062204,174060842,174069671,8829,3751,100
174075216,174073855,174082367,8512,3752,100
174087985,174086406,174094797,8391,3753,100
174100413,174098835,174108829,9994,3754,100
174114445,174112867,174122862,9995,3755,100
174128323,174126962,174136423,9461,3756,100
174142040,174140462,174150139,9677,3757,100
174155755,174154177,174164488,10311,3758,100
174170193,174168615,174178292,9677,3759,100
174183908,174182330,174192641,10311,3760,100
174198195,174196834,174205978,9144,3761,100
174211501,174210139,174218313,8174,3762,100
174223928,174222351,174231712,9361,3763,100
174237329,174235751,174246063,10312,3764,100
174251768,174250190,174259235,9045,3765,100
174264685,174263323,174271836,8513,3766,100
174277343,174275981,174283861,7880,3767,100
174289478,174287900,174297262,9362,3768,100
174302709,174301348,174310176,8828,3769,100
174315663,174314301,174323130,8829,3770,100
174328576,174327215,174336042,8827,3771,100
174341540,174340179,174348690,8511,3772,100
174354307,174352729,174362407,9678,3773,100
174368024,174366446,174376757,10311,3774,100
174382341,174380980,174388857,7877,3775,100
174394386,174393025,174402485,9460,3776,100
174408103,174406524,174416520,9996,3777,100
174421967,174420606,174430700,10094,3778,100
174436405,174434827,174443218,8391,3779,100
174448835,174447256,174457568,10312,3780,100
174463275,174461696,174471059,9363,3781,100
174476676,174475098,174484143,9045,3782,100
174489759,174488181,174497858,9677,3783,100
174503475,174501896,174511574,9678,3784,100
174517190,174515612,174525289,9677,3785,100
174530906,174529328,174537717,8389,3786,100
174543197,174541836,174550664,8828,3787,100
174556156,174554795,174563622,8827,3788,100
174569094,174567733,174576878,9145,3789,100
174582387,174581025,174590487,9462,3790,100
174596104,174594526,174603888,9362,3791,100
174609505,174607927,174616972,9045,3792,100
174622589,174621011,174630373,9362,3793,100
174635857,174634495,174643957,9462,3794,100
174649491,174648129,174657907,9778,3795,100
174663523,174661945,174671623,9678,3796,100
174677155,174675793,174684622,8829,3797,100
174690239,174688661,174697389,8728,3798,100
174703006,174701427,174711421,9994,3799,100
174717038,174715460,174723555,8095,3800,100
174729023,174727661,174736807,9146,3801,100
174742352,174740990,174748870,7880,3802,100
174754382,174753020,174762481,9461,3803,100
174768098,174766520,174774910,8390,3804,100
174780527,174778949,174787340,8391,3805,100
174792851,174791490,174800317,8827,3806,100
174805935,174804356,174814668,10312,3807,100
174820281,174818920,174828698,9778,3808,100
174834315,174832737,174842415,9678,3809,100
174848032,174846454,174856131,9677,3810,100
174861614,174860253,174869398,9145,3811,100
174875015,174873436,174883431,9995,3812,100
174889049,174887470,174895861,8391,3813,100
174901478,174899900,174908629,8729,3814,100
174914247,174912668,174922980,10312,3815,100
174928572,174927210,174936672,9462,3816,100
174942290,174940711,174950707,9996,3817,100
174956324,174954746,174964741,9995,3818,100
174970256,174968894,174977069,8175,3819,100
174982600,174981238,174990066,8828,3820,100
174995683,174994105,175004100,9995,3821,100
175009621,175008260,175017721,9461,3822,100
175023268,175021907,175030734,8827,3823,100
175036351,175034773,175043164,8391,3824,100
175048625,175047263,175055774,8511,3825,100
175061392,175059813,175069808,9995,3826,100
175075426,175073847,175082575,8728,3827,100
175088121,175086759,175095271,8512,3828,100
175100888,175099310,175107701,8391,3829,100
175113221,175111860,175120034,8174,3830,100
175125651,175124073,175132168,8095,3831,100
175137713,175136351,175146445,10094,3832,100
175152152,175150573,175159619,9046,3833,100
175165237,175163658,175172704,9046,3834,100
175178163,175176802,175184681,7879,3835,100
175190212,175188850,175197996,9146,3836,100
175203489,175202128,175211905,9777,3837,100
175217522,175215944,175224356,8412,3838,100
175229973,175228395,175236786,8391,3839,100
175242403,175240825,175249216,8391,3840,100
175254833,175253255,175261645,8390,3841,100
175267132,175265770,175274598,8828,3842,100
175280215,175278637,175286732,8095,3843,100
175292237,175290876,175300653,9777,3844,100
175306198,175304836,175314298,9462,3845,100
175319826,175318464,175326977,8513,3846,100
175332594,175331015,175340694,9679,3847,100
175346310,175344732,175354093,9361,3848,100
175359561,175358199,175366710,8511,3849,100
175372166,175370805,175379633,8828,3850,100
175385249,175383671,175392716,9045,3851,100
175398333,175396755,175404850,8095,3852,100
175410383,175409021,175417532,8511,3853,100
175422979,175421618,175431712,10094,3854,100
175437270,175435909,175446024,10115,3855,100
175451604,175450242,175458121,7879,3856,100
175463738,175462160,175472155,9995,3857,100
175477694,175476332,175485161,8829,3858,100
175490779,175489200,175497930,8730,3859,100
175503548,175501969,175511014,9045,3860,100
175516631,175515053,175523148,8095,3861,100
175528765,175527186,175535914,8728,3862,100
175541457,175540095,175547974,7879,3863,100
175553519,175552158,175560037,7879,3864,100
175565654,175564076,175574071,9995,3865,100
175579688,175578110,175588443,10333,3866,100
175594149,175592570,175602249,9679,3867,100
175607735,175606374,175616152,9778,3868,100
175621671,175620309,175628821,8512,3869,100
175634438,175632860,175642854,9994,3870,100
175648471,175646893,175656254,9361,3871,100
175661767,175660406,175669866,9460,3872,100
175675482,175673904,175683581,9677,3873,100
175689197,175687619,175696981,9362,3874,100
175702466,175701105,175709933,8828,3875,100
175715549,175713971,175723966,9995,3876,100
175729582,175728004,175737682,9678,3877,100
175743298,175741720,175750110,8390,3878,100
175755591,175754230,175763375,9145,3879,100
175768839,175767477,175777573,10096,3880,100
175783128,175781766,175790911,9145,3881,100
175796421,175795060,175804837,9777,3882,100
175810384,175809022,175817534,8512,3883,100
175823052,175821691,175831469,9778,3884,100
175836938,175835576,175844089,8513,3885,100
175849589,175848227,175856402,8175,3886,100
175862018,175860441,175868831,8390,3887,100
175874280,175872919,175882696,9777,3888,100
175888312,175886734,175896095,9361,3889,100
175901712,175900134,175908863,8729,3890,100
175914327,175912965,175921794,8829,3891,100
175927285,175925923,175934752,8829,3892,100
175940221,175938860,175947034,8174,3893,100
175952573,175951212,175960357,9145,3894,100
175965974,175964396,175974707,10311,3895,100
175980412,175978834,175988195,9361,3896,100
175993661,175992300,176001761,9461,3897,100
176007222,176005861,176014689,8828,3898,100
176020305,176018727,176028089,9362,3899,100
176033550,176032188,176040363,8175,3900,100
176045817,176044456,176052333,7877,3901,100
176057868,176056507,176064385,7878,3902,100
176069910,176068549,176077059,8510,3903,100
176082675,176081097,176091408,10311,3904,100
176096972,176095611,176103489,7878,3905,100
176109025,176107663,176116808,9145,3906,100
176122426,176120847,176129239,8392,3907,100
176134856,176133277,176142322,9045,3908,100
176147939,176146360,176155406,9046,3909,100
176161023,176159444,176169123,9679,3910,100
176174613,176173251,176183346,10095,3911,100
176188880,176187518,176197297,9779,3912,100
176202838,176201477,176211253,9776,3913,100
176216870,176215292,176224970,9678,3914,100
176230434,176229072,176237901,8829,3915,100
176243393,176242031,176252125,10094,3916,100
176257698,176256336,176265798,9462,3917,100
176271414,176269836,176279831,9995,3918,100
176285448,176283870,176291966,8096,3919,100
176297582,176296004,176305999,9995,3920,100
176311616,176310038,176318133,8095,3921,100
176323600,176322239,176331079,8840,3922,100
176336695,176335117,176345111,9994,3923,100
176350562,176349201,176358978,9777,3924,100
176364596,176363017,176371745,8728,3925,100
176377362,176375784,176384173,8389,3926,100
176389790,176388212,176398206,9994,3927,100
176403824,176402245,176412239,9994,3928,100
176417735,176416373,176426466,10093,3929,100
176432171,176430593,176438983,8390,3930,100
176444482,176443120,176451294,8174,3931,100
176456910,176455332,176465326,9994,3932,100
176470795,176469433,176478578,9145,3933,100
176484194,176482616,176492610,9994,3934,100
176498228,176496649,176505040,8391,3935,100
176510495,176509134,176518911,9777,3936,100
176524529,176522950,176531340,8390,3937,100
176536837,176535475,176544620,9145,3938,100
176550237,176548659,176558652,9993,3939,100
176564126,176562764,176570938,8174,3940,100
176576476,176575114,176582993,7879,3941,100
176588610,176587032,176596076,9044,3942,100
176601560,176600199,176609026,8827,3943,100
176614643,176613065,176623058,9993,3944,100
176628675,176627097,176635487,8390,3945,100
176640993,176639631,176647508,7877,3946,100
176653023,176651662,176660804,9142,3947,100
176666421,176664842,176673571,8729,3948,100
176679021,176677660,176685536,7876,3949,100
176691152,176689574,176699567,9993,3950,100
176705047,176703685,176712195,8510,3951,100
176717735,176716373,176725201,8828,3952,100
176730818,176729240,176738600,9360,3953,100
176744059,176742698,176752474,9776,3954,100
176757956,176756594,176764768,8174,3955,100
176770307,176768946,176778088,9142,3956,100
176783588,176782226,176792319,10093,3957,100
176798025,176796447,176806124,9677,3958,100
176811741,176810163,176820473,10310,3959,100
176826044,176824683,176833192,8509,3960,100
176838809,176837231,176847224,9993,3961,100
176852676,176851314,176861408,10094,3962,100
176866967,176865606,176874115,8509,3963,100
176879626,176878264,176886142,7878,3964,100
176891687,176890326,176900419,10093,3965,100
176905993,176904631,176913459,8828,3966,100
176918957,176917595,176927690,10095,3967,100
176933232,176931870,176940698,8828,3968,100
176946186,176944825,176954919,10094,3969,100
176960482,176959120,176968897,9777,3970,100
176974348,176972986,176981497,8511,3971,100
176987114,176985536,176995213,9677,3972,100
177000831,176999252,177007643,8391,3973,100
177013043,177011681,177021727,10046,3974,100
177027272,177025911,177035370,9459,3975,100
177040988,177039409,177048137,8728,3976,100
177053652,177052291,177061117,8826,3977,100
177066734,177065156,177075466,10310,3978,100
177081172,177079593,177089926,10333,3979,100
177095464,177094103,177102613,8510,3980,100
177108140,177106779,177114951,8172,3981,100
177120568,177118990,177128982,9992,3982,100
177134600,177133021,177143332,10311,3983,100
177149037,177147459,177157453,9994,3984,100
177163070,177161492,177170852,9360,3985,100
177176467,177174890,177183933,9043,3986,100
177189551,177187972,177197017,9045,3987,100
177202490,177201129,177209956,8827,3988,100
177215443,177214081,177222593,8512,3989,100
177228047,177226686,177234564,7878,3990,100
177240181,177238603,177248596,9993,3991,100
177254213,177252635,177261996,9361,3992,100
177267614,177266035,177274763,8728,3993,100
177280244,177278883,177288026,9143,3994,100
177293541,177292179,177300353,8174,3995,100
177305970,177304392,177314068,9676,3996,100
177319561,177318199,177327660,9461,3997,100
177333149,177331787,177341247,9460,3998,100
177346774,177345413,177354873,9460,3999,100
177360318,177358957,177368099,9142,4000,100
177373630,177372268,177380779,8511,4001,100
177386306,177384944,177393454,8510,4002,100
177399071,177397493,177406220,8727,4003,100
177411737,177410375,177419203,8828,4004,100
177424748,177423387,177432847,9460,4005,100
177438376,177437015,177446475,9460,4006,100
177452022,177450661,177458538,7877,4007,100
177464154,177462576,177470669,8093,4008,100
177476206,177474845,177483356,8511,4009,100
177488973,177487395,177497071,9676,4010,100
177502543,177501182,177509692,8510,4011,100
177515309,177513731,177523091,9360,4012,100
177528640,177527278,177535790,8512,4013,100
177541313,177539952,177550045,10093,4014,100
177555663,177554301,177562475,8174,4015,100
177567958,177566597,177574769,8172,4016,100
177580278,177578917,177588693,9776,4017,100
177594309,177592731,177602092,9361,4018,100
177607571,177606209,177615670,9461,4019,100
177621131,177619770,177629547,9777,4020,100
177635029,177633668,177641841,8173,4021,100
177647458,177645880,177655557,9677,4022,100
177661064,177659703,177669162,9459,4023,100
177674693,177673331,177682158,8827,4024,100
177687669,177686308,177694185,7877,4025,100
177699709,177698348,177707808,9460,4026,100
177713425,177711847,177721208,9361,4027,100
177726825,177725247,177734924,9677,4028,100
177740403,177739041,177748185,9144,4029,100
177753803,177752224,177762218,9994,4030,100
177767742,177766380,177775207,8827,4031,100
177780824,177779246,177787636,8390,4032,100
177793252,177791674,177801984,10310,4033,100
177807690,177806111,177815156,9045,4034,100
177820773,177819195,177829188,9993,4035,100
177834726,177833364,177841537,8173,4036,100
177847060,177845698,177854843,9145,4037,100
177860460,177858882,177866976,8094,4038,100
177872592,177871014,177879404,8390,4039,100
177884919,177883557,177891435,7878,4040,100
177897052,177895474,177903864,8390,4041,100
177909380,177908019,177916847,8828,4042,100
177922464,177920886,177929613,8727,4043,100
177935136,177933774,177942285,8511,4044,100
177947773,177946412,177954922,8510,4045,100
177960420,177959058,177967570,8512,4046,100
177973187,177971609,177980970,9361,4047,100
177986587,177985009,177994686,9677,4048,100
178000303,177998725,178007769,9044,4049,100
178013314,178011953,178020126,8173,4050,100
178025743,178024165,178032892,8727,4051,100
178038509,178036931,178045975,9044,4052,100
178051592,178050014,178059690,9676,4053,100
178065180,178063819,178071696,7877,4054,100
178077313,178075735,178085412,9677,4055,100
178090859,178089497,178097376,7879,4056,100
178102836,178101475,178110936,9461,4057,100
178116553,178114975,178123069,8094,4058,100
178128535,178127173,178136318,9145,4059,100
178141936,178140357,178150036,9679,4060,100
178155499,178154137,178162015,7878,4061,100
178167632,178166054,178175732,9678,4062,100
178181349,178179771,178188498,8727,4063,100
178194115,178192537,178202530,9993,4064,100
178207996,178206634,178216411,9777,4065,100
178221888,178220526,178230620,10094,4066,100
178236326,178234748,178243475,8727,4067,100
178249092,178247514,178257825,10311,4068,100
178263530,178261952,178271312,9360,4069,100
178276763,178275402,178284546,9144,4070,100
178290163,178288585,178298895,10310,4071,100
178304601,178303022,178313016,9994,4072,100
178318553,178317192,178326335,9143,4073,100
178331787,178330425,178338304,7879,4074,100
178343920,178342342,178351069,8727,4075,100
178356686,178355108,178364469,9361,4076,100
178370005,178368643,178377470,8827,4077,100
178382976,178381614,178389788,8174,4078,100
178395268,178393905,178402734,8829,4079,100
178408352,178406773,178416450,9677,4080,100
178421938,178420576,178428749,8173,4081,100
178434367,178432788,178441178,8390,4082,100
178446795,178445217,178455211,9994,4083,100
178460829,178459250,178467641,8391,4084,100
178473142,178471780,178479953,8173,4085,100
178485570,178483992,178493669,9677,4086,100
178499286,178497708,178507067,9359,4087,100
178512519,178511158,178519985,8827,4088,100
178525511,178524150,178532661,8511,4089,100
178538279,178536700,178545428,8728,4090,100
178550959,178549597,178559057,9460,4091,100
178564567,178563205,178572033,8828,4092,100
178577577,178576215,178585360,9145,4093,100
178590856,178589495,178598638,9143,4094,100
178604129,178602767,178611278,8511,4095,100
178616894,178615316,178624993,9677,4096,100
178630477,178629115,178639208,10093,4097,100
178644759,178643398,178653174,9776,4098,100
178658657,178657295,178667390,10095,4099,100
178673096,178671518,178679907,8389,4100,100
178685452,178684091,178694185,10094,4101,100
178699720,178698359,178706532,8173,4102,100
178712150,178710571,178720883,10312,4103,100
178726502,178725141,178733968,8827,4104,100
178739437,178738075,178746587,8512,4105,100
178752121,178750760,178759587,8827,4106,100
178765204,178763626,178772353,8727,4107,100
178777970,178776392,178786701,10309,4108,100
178792406,178790828,178800822,9994,4109,100
178806309,178804947,178814408,9461,4110,100
178819911,178818550,178828010,9460,4111,100
178833627,178832049,178841093,9044,4112,100
178846554,178845192,178854020,8828,4113,100
178859638,178858059,178866155,8096,4114,100
178871772,178870194,178878921,8727,4115,100
178884388,178883026,178892487,9461,4116,100
178897975,178896614,178906391,9777,4117,100
178912008,178910430,178919790,9360,4118,100
178925407,178923829,178933506,9677,4119,100
178939123,178937545,178946905,9360,4120,100
178952439,178951078,178960537,9459,4121,100
178966154,178964576,178973620,9044,4122,100
178979122,178977761,178987221,9460,4123,100
178992714,178991352,179000496,9144,4124,100
179005994,179004633,179012806,8173,4125,100
179018288,179016927,179025437,8510,4126,100
179031054,179029476,179037571,8095,4127,100
179043188,179041610,179049704,8094,4128,100
179055321,179053742,179062133,8391,4129,100
179067592,179066230,179075692,9462,4130,100
179081151,179079790,179088301,8511,4131,100
179093918,179092340,179101383,9043,4132,100
179106828,179105467,179114294,8827,4133,100
179119912,179118333,179126429,8096,4134,100
179131909,179130547,179139375,8828,4135,100
179144866,179143504,179153598,10094,4136,100
179159218,179157857,179166030,8173,4137,100
179171524,179170163,179178040,7877,4138,100
179183516,179182155,179190033,7878,4139,100
179195560,179194198,179203659,9461,4140,100
179209276,179207698,179217690,9992,4141,100
179223148,179221787,179231246,9459,4142,100
179236862,179235284,179244644,9360,4143,100
179250260,179248682,179258042,9360,4144,100
179263658,179262080,179270175,8095,4145,100
179275791,179274213,179283573,9360,4146,100
179289048,179287686,179297463,9777,4147,100
179303079,179301501,179309890,8389,4148,100
179315368,179314007,179323467,9460,4149,100
179328958,179327597,179337056,9459,4150,100
179342547,179341185,179349697,8512,4151,100
179355156,179353794,179361672,7878,4152,100
179367135,179365774,179374600,8826,4153,100
179380216,179378638,179387999,9361,4154,100
179393462,179392100,179400928,8828,4155,100
179406409,179405047,179413558,8511,4156,100
179419175,179417596,179426325,8729,4157,100
179431942,179430364,179440041,9677,4158,100
179445658,179444080,179453757,9677,4159,100
179459373,179457795,179466185,8390,4160,100
179471712,179470350,179479177,8827,4161,100
179484723,179483362,179491872,8510,4162,100
179497488,179495910,179504300,8390,4163,100
179509818,179508456,179516966,8510,4164,100
179522496,179521135,179529013,7878,4165,100
179534629,179533051,179541779,8728,4166,100
179547240,179545878,179553756,7878,4167,100
179559292,179557930,179568025,10095,4168,100
179573730,179572152,179581512,9360,4169,100
179587055,179585694,179594521,8827,4170,100
179600137,179598559,179607918,9359,4171,100
179613534,179611956,179621317,9361,4172,100
179626933,179625355,179634399,9044,4173,100
179640015,179638437,179648747,10310,4174,100
179654452,179652874,179662551,9677,4175,100
179668168,179666590,179675634,9044,4176,100
179681100,179679738,179689516,9778,4177,100
179695134,179693555,179703865,10310,4178,100
179709467,179708105,179717882,9777,4179,100
179723500,179721921,179730312,8391,4180,100
179735776,179734415,179742926,8511,4181,100
179748459,179747098,179755271,8173,4182,100
179760751,179759390,179767901,8511,4183,100
179773358,179771996,179780824,8828,4184,100
179786441,179784863,179794540,9677,4185,100
179800062,179798701,179806873,8172,4186,100
179812490,179810912,179820588,9676,4187,100
179826104,179824743,179834520,9777,4188,100
179839988,179838626,179848088,9462,4189,100
179853550,179852189,179861966,9777,4190,100
179867417,179866055,179874566,8511,4191,100
179880183,179878604,179886994,8390,4192,100
179892611,179891033,179901027,9994,4193,100
179906644,179905066,179913456,8390,4194,100
179919072,179917494,179926855,9361,4195,100
179932365,179931004,179940781,9777,4196,100
179946398,179944820,179953548,8728,4197,100
179959165,179957587,179967898,10311,4198,100
179973604,179972026,179981385,9359,4199,100
179986913,179985552,179995646,10094,4200,100
180001353,179999774,180010107,10333,4201,100
180015693,180014331,180023476,9145,4202,100
180028943,180027582,180035776,8194,4203,100
180041290,180039928,180048102,8174,4204,100
180053719,180052141,180061818,9677,4205,100
180067434,180065857,180075850,9993,4206,100
180081312,180079950,180089095,9145,4207,100
180094612,180093250,180102712,9462,4208,100
180108205,180106843,180114721,7878,4209,100
180120198,180118837,180127031,8194,4210,100
180132556,180131195,180140021,8826,4211,100
180145638,180144060,180152787,8727,4212,100
180158253,180156891,180166035,9144,4213,100
180171502,180170140,180179285,9145,4214,100
180184903,180183324,180192053,8729,4215,100
180197670,180196092,180205135,9043,4216,100
180210752,180209174,180218852,9678,4217,100
180224469,180222891,180233222,10331,4218,100
180238928,180237350,180246078,8728,4219,100
180251558,180250196,180259972,9776,4220,100
180265425,180264064,180274179,10115,4221,100
180279884,180278306,180287033,8727,4222,100
180292531,180291170,180299996,8826,4223,100
180305614,180304035,180313080,9045,4224,100
180318697,180317119,180325213,8094,4225,100
180330829,180329251,180337346,8095,4226,100
180342963,180341384,180351061,9677,4227,100
180356515,180355153,180364298,9145,4228,100
180369821,180368459,180377604,9145,4229,100
180383103,180381741,180391201,9460,4230,100
180396817,180395239,180404916,9677,4231,100
180410445,180409084,180419198,10114,4232,100
180424753,180423391,180433507,10116,4233,100
180439080,180437718,180446546,8828,4234,100
180452163,180450585,180459946,9361,4235,100
180465564,180463985,180473347,9362,4236,100
180478964,180477386,180486747,9361,4237,100
180492364,180490786,180500779,9993,4238,100
180506396,180504818,180512913,8095,4239,100
180518441,180517079,180525907,8828,4240,100
180531446,180530085,180538912,8827,4241,100
180544528,180542950,180552311,9361,4242,100
180557802,180556440,180564635,8195,4243,100
180570175,180568814,180577324,8510,4244,100
180582940,180581362,180590723,9361,4245,100
180596212,180594850,180603361,8511,4246,100
180608901,180607539,180615734,8195,4247,100
180621351,180619773,180629134,9361,4248,100
180634751,180633173,180643167,9994,4249,100
180648623,180647262,180656721,9459,4250,100
180662194,180660832,180669977,9145,4251,100
180675593,180674015,180683059,9044,4252,100
180688677,180687098,180697430,10332,4253,100
180703006,180701645,180710156,8511,4254,100
180715617,180714256,180724350,10094,4255,100
180729901,180728539,180738654,10115,4256,100
180744359,180742781,180751191,8410,4257,100
180756808,180755230,180764590,9360,4258,100
180770070,180768708,180777852,9144,4259,100
180783399,180782037,180791813,9776,4260,100
180797279,180795917,180805694,9777,4261,100
180811194,180809832,180818026,8194,4262,100
180823532,180822170,180830365,8195,4263,100
180835982,180834404,180844398,9994,4264,100
180850015,180848437,180856848,8411,4265,100
180862310,180860949,180870726,9777,4266,100
180876251,180874889,180884667,9778,4267,100
180890129,180888768,180897595,8827,4268,100
180903211,180901633,180909728,8095,4269,100
180915178,180913817,180922643,8826,4270,100
180928146,180926785,180935296,8511,4271,100
180940913,180939334,180948695,9361,4272,100
180956620,180955042,180963770,8728,4273,100
180969387,180967809,180977803,9994,4274,100
180983420,180981842,180990570,8728,4275,100
180996187,180994609,181004286,9677,4276,100
181009903,181008324,181017685,9361,4277,100
181023215,181021853,181030681,8828,4278,100
181036143,181034782,181043925,9143,4279,100
181049440,181048078,181057855,9777,4280,100
181063322,181061960,181072076,10116,4281,100
181077609,181076248,181086363,10115,4282,100
181091899,181090537,181098415,7878,4283,100
181104032,181102454,181111497,9043,4284,100
181117041,181115679,181125794,10115,4285,100
181131500,181129922,181139282,9360,4286,100
181144774,181143413,181153528,10115,4287,100
181159233,181157655,181166382,8727,4288,100
181171907,181170546,181179056,8510,4289,100
181184532,181183170,181191998,8828,4290,100
181197528,181196167,181204994,8827,4291,100
181210611,181209033,181218393,9360,4292,100
181224010,181222432,181232108,9676,4293,100
181237725,181236147,181245825,9678,4294,100
181251442,181249864,181259858,9994,4295,100
181265474,181263896,181271990,8094,4296,100
181277480,181276119,181285579,9460,4297,100
181291197,181289618,181298979,9361,4298,100
181304597,181303018,181313013,9995,4299,100
181318630,181317052,181327382,10330,4300,100
181332951,181331590,181340417,8827,4301,100
181345875,181344514,181353025,8511,4302,100
181358533,181357172,181365050,7878,4303,100
181370562,181369201,181377712,8511,4304,100
181383329,181381751,181390795,9044,4305,100
181396285,181394923,181404701,9778,4306,100
181410212,181408850,181417678,8828,4307,100
181423150,181421789,181430299,8510,4308,100
181435917,181434338,181444017,9679,4309,100
181449480,181448119,181456313,8194,4310,100
181461930,181460352,181469079,8727,4311,100
181474564,181473202,181482347,9145,4312,100
181487816,181486455,181494332,7877,4313,100
181499871,181498509,181507654,9145,4314,100
181513108,181511746,181520258,8512,4315,100
181525876,181524297,181533342,9045,4316,100
181538960,181537381,181547376,9995,4317,100
181552903,181551542,181559419,7877,4318,100
181564884,181563523,181572983,9460,4319,100
181578441,181577080,181585274,8194,4320,100
181590892,181589313,181598041,8728,4321,100
181603658,181602080,181611440,9360,4322,100
181617056,181615478,181625155,9677,4323,100
181630685,181629324,181637201,7877,4324,100
181642819,181641240,181650602,9362,4325,100
181656071,181654710,181663853,9143,4326,100
181669370,181668008,181675887,7879,4327,100
181681403,181680041,181688869,8828,4328,100
181694485,181692908,181701297,8389,4329,100
181706914,181705336,181714697,9361,4330,100
181720314,181718736,181727780,9044,4331,100
181733397,181731819,181741179,9360,4332,100
181746795,181745218,181753945,8727,4333,100
181759562,181757984,181766078,8094,4334,100
181771696,181770117,181778211,8094,4335,100
181783829,181782250,181791295,9045,4336,100
181796741,181795379,181804207,8828,4337,100
181809824,181808246,181816341,8095,4338,100
181821888,181820527,181830304,9777,4339,100
181835921,181834343,181843387,9044,4340,100
181849004,181847426,181855837,8411,4341,100
181861343,181859982,181868176,8194,4342,100
181873713,181872352,181881812,9460,4343,100
181887429,181885851,181895528,9677,4344,100
181901145,181899566,181907956,8390,4345,100
181913477,181912116,181920943,8827,4346,100
181926561,181924982,181933077,8095,4347,100
181938566,181937204,181946032,8828,4348,100
181951557,181950195,181958390,8195,4349,100
181963894,181962532,181971676,9144,4350,100
181977141,181975780,181983974,8194,4351,100
181989591,181988013,181998007,9994,4352,100
182003624,182002046,182010773,8727,4353,100
182016277,182014915,182022792,7877,4354,100
182028409,182026831,182034924,8093,4355,100
182040541,182038963,182047690,8727,4356,100
182053160,182051799,182059676,7877,4357,100
182065128,182063766,182073861,10095,4358,100
182079567,182077989,182088321,10332,4359,100
182094028,182092449,182101178,8729,4360,100
182106631,182105270,182114729,9459,4361,100
182120270,182118909,182127736,8827,4362,100
182133278,182131917,182140110,8193,4363,100
182145727,182144149,182152559,8410,4364,100
182158034,182156673,182166788,10115,4365,100
182172495,182170916,182179961,9045,4366,100
182185577,182183999,182193993,9994,4367,100
182199610,182198032,182208364,10332,4368,100
182214070,182212492,182221851,9359,4369,100
182227468,182225890,182235567,9677,4370,100
182241184,182239606,182247995,8389,4371,100
182253470,182252109,182259987,7878,4372,100
182265605,182264026,182272417,8391,4373,100
182278033,182276455,182286132,9677,4374,100
182291657,182290296,182298173,7877,4375,100
182303689,182302328,182311154,8826,4376,100
182316772,182315193,182324554,9361,4377,100
182330033,182328672,182336844,8172,4378,100
182342351,182340989,182351084,10095,4379,100
182356791,182355212,182363624,8412,4380,100
182369241,182367663,182376074,8411,4381,100
182381691,182380113,182388840,8727,4382,100
182394330,182392969,182401480,8511,4383,100
182406966,182405604,182415719,10115,4384,100
182421425,182419847,182428575,8728,4385,100
182434102,182432740,182442201,9461,4386,100
182447715,182446354,182455181,8827,4387,100
182460654,182459293,182468120,8827,4388,100
182473737,182472158,182481836,9678,4389,100
182487454,182485875,182494287,8412,4390,100
182499904,182498326,182506420,8094,4391,100
182511915,182510554,182520015,9461,4392,100
182525544,182524182,182533642,9460,4393,100
182539120,182537758,182546902,9144,4394,100
182552370,182551009,182561123,10114,4395,100
182566828,182565250,182575581,10331,4396,100
182581287,182579709,182590041,10332,4397,100
182595630,182594268,182603729,9461,4398,100
182609346,182607768,182617129,9361,4399,100
182622747,182621168,182630530,9362,4400,100
182636147,182634569,182643613,9044,4401,100
182649230,182647652,182657013,9361,4402,100
182662630,182661052,182670413,9361,4403,100
182676030,182674452,182683812,9360,4404,100
182689335,182687974,182697118,9144,4405,100
182702573,182701212,182709723,8511,4406,100
182715190,182713829,182721707,7878,4407,100
182727205,182725844,182735959,10115,4408,100
182741518,182740156,182750250,10094,4409,100
182755957,182754378,182764690,10312,4410,100
182770396,182768817,182779129,10312,4411,100
182784670,182783308,182791187,7879,4412,100
182796804,182795226,182803637,8411,4413,100
182809122,182807761,182817876,10115,4414,100
182823484,182822122,182830000,7878,4415,100
182835446,182834084,182842596,8512,4416,100
182848060,182846699,182856159,9460,4417,100
182861649,182860288,182869115,8827,4418,100
182874600,182873239,182882699,9460,4419,100
182888317,182886738,182895466,8728,4420,100
182901083,182899505,182908866,9361,4421,100
182914483,182912905,182920999,8094,4422,100
182926617,182925038,182933450,8412,4423,100
182938963,182937601,182945479,7878,4424,100
182950968,182949607,182958434,8827,4425,100
182964052,182962473,182970864,8391,4426,100
182976482,182974903,182983294,8391,4427,100
182988784,182987422,182997200,9778,4428,100
183002817,183001239,183009650,8411,4429,100
183015267,183013689,183023048,9359,4430,100
183028537,183027175,183035370,8195,4431,100
183040916,183039554,183047748,8194,4432,100
183053253,183051892,183059768,7876,4433,100
183065246,183063884,183074000,10116,4434,100
183079613,183078251,183088028,9777,4435,100
183093544,183092183,183102277,10094,4436,100
183107983,183106405,183116081,9676,4437,100
183121571,183120210,183130325,10115,4438,100
183135945,183134583,183143411,8828,4439,100
183148920,183147558,183157019,9461,4440,100
183162636,183161058,183170102,9044,4441,100
183175612,183174251,183184345,10094,4442,100
183190052,183188473,183197202,8729,4443,100
183202655,183201293,183210437,9144,4444,100
183216055,183214476,183224787,10311,4445,100
183230402,183229041,183236919,7878,4446,100
183242447,183241085,183250546,9461,4447,100
183256164,183254585,183264580,9995,4448,100
183270198,183268619,183278613,9994,4449,100
183284231,183282652,183291380,8728,4450,100
183296843,183295482,183304942,9460,4451,100
183310399,183309037,183319153,10116,4452,100
183324858,183323280,183332006,8726,4453,100
183337503,183336141,183345602,9461,4454,100
183351220,183349641,183358370,8729,4455,100
183363887,183362525,183370699,8174,4456,100
183376316,183374738,183383465,8727,4457,100
183388987,183387625,183397087,9462,4458,100
183402563,183401201,183410663,9462,4459,100
183416280,183414702,183424063,9361,4460,100
183429681,183428102,183438096,9994,4461,100
183443713,183442135,183450862,8727,4462,100
183456479,183454901,183464894,9993,4463,100
183470342,183468980,183479095,10115,4464,100
183484675,183483314,183493091,9777,4465,100
183498709,183497130,183506176,9046,4466,100
183511726,183510365,183518875,8510,4467,100
183524492,183522914,183532590,9676,4468,100
183538120,183536758,183546873,10115,4469,100
183552578,183551000,183560361,9361,4470,100
183565978,183564400,183573761,9361,4471,100
183579297,183577935,183588050,10115,4472,100
183593645,183592284,183601426,9142,4473,100
183606971,183605609,183615386,9777,4474,100
183620855,183619493,183627371,7878,4475,100
183632857,183631495,183640007,8512,4476,100
183645624,183644046,183653406,9360,4477,100
183658920,183657558,183666068,8510,4478,100
183671599,183670237,183678749,8512,4479,100
183684367,183682788,183692148,9360,4480,100
183697636,183696275,183705417,9142,4481,100
183710934,183709573,183717449,7876,4482,100
183722975,183721614,183731073,9459,4483,100
183736690,183735112,183744473,9361,4484,100
183750091,183748512,183758190,9678,4485,100
183763649,183762287,183771748,9461,4486,100
183777213,183775852,183784679,8827,4487,100
183790215,183788854,183797998,9144,4488,100
183803463,183802101,183811563,9462,4489,100
183817181,183815602,183825597,9995,4490,100
183831085,183829724,183839837,10113,4491,100
183845544,183843965,183853327,9362,4492,100
183858943,183857365,183866408,9043,4493,100
183872026,183870447,183879175,8728,4494,100
183884635,183883274,183893389,10115,4495,100
183899094,183897516,183907848,10332,4496,100
183913399,183912038,183921498,9460,4497,100
183927115,183925537,183935530,9993,4498,100
183941147,183939569,183948297,8728,4499,100
183953757,183952395,183960590,8195,4500,100
183966119,183964758,183972951,8193,4501,100
183978438,183977077,183986220,9143,4502,100
183991837,183990259,183999937,9678,4503,100
184005465,184004103,184013881,9778,4504,100
184019368,184018007,184025885,7878,4505,100
184031502,184029924,184039284,9360,4506,100
184044901,184043323,184053315,9992,4507,100
184058844,184057483,184066626,9143,4508,100
184072128,184070767,184079277,8510,4509,100
184084761,184083400,184091910,8510,4510,100
184097370,184096009,184105153,9144,4511,100
184110679,184109317,184117512,8195,4512,100
184123129,184121551,184130278,8727,4513,100
184135815,184134453,184144230,9777,4514,100
184149703,184148341,184157486,9145,4515,100
184162998,184161637,184170464,8827,4516,100
184175983,184174621,184183132,8511,4517,100
184188748,184187170,184195898,8728,4518,100
184201516,184199937,184210249,10312,4519,100
184215954,184214376,184222765,8389,4520,100
184228257,184226896,184236988,10092,4521,100
184242605,184241244,184249122,7878,4522,100
184254739,184253161,184261551,8390,4523,100
184267078,184265717,184274544,8827,4524,100
184280162,184278583,184287312,8729,4525,100
184292929,184291351,184300079,8728,4526,100
184305696,184304118,184313478,9360,4527,100
184319096,184317517,184327829,10312,4528,100
184333533,184331956,184340999,9043,4529,100
184346615,184345037,184354714,9677,4530,100
184360331,184358752,184369063,10311,4531,100
184374551,184373190,184384734,11544,4532,100
184390439,184388861,184397588,8727,4533,100
184403205,184401627,184409721,8094,4534,100
184415337,184413759,184422487,8728,4535,100
184427944,184426582,184435094,8512,4536,100
184440553,184439192,184448969,9777,4537,100
184454586,184453008,184462685,9677,4538,100
184468170,184466809,184475002,8193,4539,100
184480619,184479040,184489351,10311,4540,100
184495057,184493478,184502838,9360,4541,100
184508287,184506926,184515099,8173,4542,100
184520561,184519200,184528344,9144,4543,100
184533811,184532450,184542542,10092,4544,100
184548142,184546780,184554659,7879,4545,100
184560277,184558698,184568375,9677,4546,100
184573922,184572560,184582655,10095,4547,100
184588361,184586782,184594878,8096,4548,100
184600345,184598984,184607495,8511,4549,100
184613111,184611534,184621527,9993,4550,100
184627053,184625692,184634203,8511,4551,100
184639692,184638331,184648424,10093,4552,100
184654130,184652552,184661280,8728,4553,100
184666741,184665380,184673553,8173,4554,100
184679170,184677592,184686320,8728,4555,100
184691866,184690504,184699016,8512,4556,100
184704633,184703055,184712731,9676,4557,100
184718348,184716770,184725498,8728,4558,100
184731116,184729537,184738899,9362,4559,100
184744393,184743031,184752175,9144,4560,100
184757792,184756214,184765574,9360,4561,100
184771191,184769613,184777707,8094,4562,100
184783324,184781746,184790473,8727,4563,100
184796091,184794512,184802903,8391,4564,100
184808408,184807047,184815558,8511,4565,100
184821175,184819597,184827692,8095,4566,100
184833310,184831731,184841725,9994,4567,100
184847229,184845866,184855981,10115,4568,100
184861519,184860157,184868985,8828,4569,100
184874601,184873023,184881118,8095,4570,100
184886735,184885157,184894517,9360,4571,100
184899986,184898625,184908717,10092,4572,100
184914204,184912844,184924725,11881,4573,100
184930274,184928913,184938373,9460,4574,100
184943989,184942411,184952722,10311,4575,100
184958259,184956897,184966992,10095,4576,100
184972565,184971203,184979082,7879,4577,100
184984698,184983120,184991213,8093,4578,100
184996743,184995382,185004525,9143,4579,100
185010143,185008564,185018875,10311,4580,100
185024580,185023002,185032046,9044,4581,100
185037525,185036163,185045307,9144,4582,100
185050925,185049346,185059656,10310,4583,100
185065272,185063911,185074005,10094,4584,100
185079711,185078133,185088127,9994,4585,100
185093745,185092166,185100262,8096,4586,100
185105797,185104436,185114213,9777,4587,100
185119677,185118315,185126489,8174,4588,100
185132026,185130664,185140442,9778,4589,100
185146059,185144481,185154791,10310,4590,100
185160381,185159019,185168163,9144,4591,100
185173649,185172288,185180164,7876,4592,100
185185781,185184202,185194197,9995,4593,100
185199660,185198298,185208393,10095,4594,100
185214100,185212521,185222833,10312,4595,100
185228538,185226960,185236321,9361,4596,100
185241938,185240360,185248750,8390,4597,100
185254367,185252789,185261178,8389,4598,100
185266795,185265217,185274260,9043,4599,100
185279762,185278400,185286277,7877,4600,100
185291894,185290316,185300626,10310,4601,100
185306331,185304753,185314747,9994,4602,100
185320364,185318786,185327829,9043,4603,100
185333446,185331868,185340595,8727,4604,100
185346128,185344766,185354544,9778,4605,100
185360009,185358647,185368108,9461,4606,100
185373726,185372147,185380875,8728,4607,100
185386360,185384998,185394143,9145,4608,100
185399761,185398182,185406593,8411,4609,100
185412124,185410763,185419590,8827,4610,100
185425100,185423739,185431933,8194,4611,100
185437396,185436035,185444229,8194,4612,100
185449846,185448268,185458579,10311,4613,100
185464285,185462707,185471750,9043,4614,100
185477292,185475930,185485707,9777,4615,100
185491324,185489746,185499107,9361,4616,100
185504653,185503292,185511170,7878,4617,100
185516683,185515322,185525099,9777,4618,100
185530563,185529202,185538979,9777,4619,100
185544596,185543018,185553012,9994,4620,100
185558629,185557051,185565778,8727,4621,100
185571395,185569817,185580128,10311,4622,100
185585701,185584339,185594433,10094,4623,100
185599981,185598620,185607448,8828,4624,100
185612953,185611592,185620103,8511,4625,100
185625550,185624188,185633649,9461,4626,100
185639113,185637752,185646895,9143,4627,100
185652512,185650934,185659324,8390,4628,100
185664849,185663488,185672630,9142,4629,100
185678092,185676731,185685242,8511,4630,100
185690781,185689419,185697593,8174,4631,100
185703086,185701725,185710869,9144,4632,100
185716486,185714908,185723635,8727,4633,100
185729134,185727773,185736283,8510,4634,100
185741774,185740412,185748290,7878,4635,100
185753907,185752329,185762639,10310,4636,100
185768186,185766824,185774702,7878,4637,100
185780319,185778741,185787131,8390,4638,100
185792749,185791170,185800532,9362,4639,100
185806041,185804680,185814455,9775,4640,100
185820071,185818493,185827536,9043,4641,100
185833153,185831575,185840303,8728,4642,100
185845755,185844393,185853854,9461,4643,100
185859355,185857994,185867770,9776,4644,100
185873388,185871809,185880199,8390,4645,100
185885816,185884238,185892333,8095,4646,100
185897870,185896509,185906603,10094,4647,100
185912310,185910731,185920726,9995,4648,100
185926246,185924885,185934344,9459,4649,100
185939961,185938383,185947744,9361,4650,100
185953361,185951783,185960827,9044,4651,100
185966272,185964910,185972787,7877,4652,100
185978404,185976826,185985554,8728,4653,100
185991042,185989680,185998823,9143,4654,100
186004340,186002978,186013073,10095,4655,100
186018647,186017285,186027380,10095,4656,100
186033087,186031508,186040235,8727,4657,100
186045852,186044274,186054268,9994,4658,100
186059734,186058373,186066883,8510,4659,100
186072343,186070982,186079809,8827,4660,100
186085427,186083848,186092239,8391,4661,100
186097856,186096278,186105006,8728,4662,100
186110624,186109045,186117436,8391,4663,100
186122958,186121597,186131057,9460,4664,100
186136587,186135225,186143736,8511,4665,100
186149252,186147891,186157351,9460,4666,100
186162968,186161390,186169484,8094,4667,100
186174995,186173634,186182777,9143,4668,100
186188394,186186816,186195544,8728,4669,100
186201161,186199583,186207677,8094,4670,100
186213294,186211716,186220759,9043,4671,100
186226376,186224798,186232892,8094,4672,100
186238417,186237056,186244933,7877,4673,100
186250405,186249044,186258188,9144,4674,100
186263805,186262227,186270321,8094,4675,100
186275857,186274496,186284273,9777,4676,100
186289891,186288312,186297990,9678,4677,100
186303607,186302029,186311390,9361,4678,100
186316853,186315492,186323664,8172,4679,100
186329210,186327848,186337625,9777,4680,100
186343164,186341802,186351263,9461,4681,100
186356880,186355302,186364345,9043,4682,100
186369962,186368384,186378694,10310,4683,100
186384287,186382925,186391436,8511,4684,100
186397053,186395475,186405151,9676,4685,100
186410642,186409280,186418425,9145,4686,100
186424042,186422464,186430854,8390,4687,100
186436341,186434979,186443491,8512,4688,100
186449027,186447667,186456810,9143,4689,100
186462427,186460849,186469239,8390,4690,100
186474725,186473364,186482191,8827,4691,100
186487809,186486230,186494959,8729,4692,100
186500429,186499068,186508845,9777,4693,100
186514463,186512884,186521929,9045,4694,100
186527391,186526029,186534857,8828,4695,100
186540474,186538896,186548257,9361,4696,100
186553874,186552296,186562289,9993,4697,100
186567906,186566328,186576660,10332,4698,100
186582197,186580836,186588714,7878,4699,100
186594182,186592820,186601648,8828,4700,100
186607171,186605810,186615903,10093,4701,100
186621393,186620031,186628390,8359,4702,100
186634007,186632429,186641157,8728,4703,100
186646608,186645247,186654706,9459,4704,100
186660323,186658745,186667473,8728,4705,100
186673090,186671512,186680239,8727,4706,100
186685780,186684418,186693879,9461,4707,100
186699496,186697918,186708228,10310,4708,100
186713812,186712451,186720328,7877,4709,100
186725858,186724497,186732669,8172,4710,100
186738287,186736708,186746069,9361,4711,100
186751559,186750197,186758371,8174,4712,100
186763988,186762410,186772088,9678,4713,100
186777618,186776256,186785399,9143,4714,100
186790932,186789571,186798082,8511,4715,100
186803700,186802121,186810217,8096,4716,100
186815833,186814255,186823300,9045,4717,100
186828834,186827473,186837566,10093,4718,100
186843183,186841821,186851282,9461,4719,100
186856772,186855411,186865188,9777,4720,100
186870736,186869375,186878519,9144,4721,100
186884017,186882656,186892749,10093,4722,100
186898320,186896958,186905131,8173,4723,100
186910645,186909284,186917162,7878,4724,100
186922678,186921316,186929490,8174,4725,100
186935107,186933528,186941919,8391,4726,100
186947409,186946047,186955191,9144,4727,100
186960807,186959230,186969223,9993,4728,100
186974772,186973411,186981584,8173,4729,100
186987074,186985712,186993906,8194,4730,100
186999443,186998081,187007859,9778,4731,100
187013323,187011962,187021106,9144,4732,100
187026578,187025217,187033728,8511,4733,100
187039345,187037767,187045860,8093,4734,100
187051477,187049899,187059260,9361,4735,100
187064718,187063356,187073134,9778,4736,100
187078626,187077265,187085143,7878,4737,100
187090761,187089182,187099177,9995,4738,100
187104640,187103278,187111473,8195,4739,100
187116988,187115627,187124770,9143,4740,100
187130235,187128873,187138651,9778,4741,100
187144269,187142690,187151735,9045,4742,100
187157352,187155774,187166085,10311,4743,100
187171791,187170213,187178941,8728,4744,100
187184469,187183107,187193201,10094,4745,100
187198762,187197400,187205595,8195,4746,100
187211113,187209752,187218261,8509,4747,100
187223748,187222386,187231847,9461,4748,100
187237464,187235886,187246197,10311,4749,100
187251902,187250324,187258714,8390,4750,100
187264331,187262753,187270848,8095,4751,100
187276466,187274887,187284249,9362,4752,100
187289866,187288288,187296677,8389,4753,100
187302295,187300716,187308812,8096,4754,100
187314281,187312919,187323013,10094,4755,100
187328719,187327141,187336185,9044,4756,100
187341802,187340224,187348614,8390,4757,100
187354147,187352785,187361929,9144,4758,100
187367547,187365968,187374696,8728,4759,100
187380189,187378828,187388288,9460,4760,100
187393771,187392409,187400920,8511,4761,100
187406460,187405099,187413926,8827,4762,100
187419401,187418039,187426233,8194,4763,100
187431752,187430390,187439218,8828,4764,100
187444686,187443324,187452785,9461,4765,100
187458324,187456963,187467056,10093,4766,100
187472761,187471183,187479911,8728,4767,100
187485368,187484006,187493151,9145,4768,100
187498769,187497190,187507184,9994,4769,100
187512643,187511281,187520742,9461,4770,100
187526359,187524781,187534142,9361,4771,100
187539759,187538181,187548512,10331,4772,100
187554217,187552639,187560733,8094,4773,100
187566225,187564864,187574640,9776,4774,100
187580187,187578826,187587653,8827,4775,100
187593270,187591692,187599787,8095,4776,100
187605246,187603885,187612396,8511,4777,100
187617869,187616508,187626600,10092,4778,100
187632149,187630787,187640248,9461,4779,100
187645693,187644332,187653475,9143,4780,100
187658966,187657604,187665483,7879,4781,100
187671003,187669642,187677520,7878,4782,100
187683041,187681679,187689853,8174,4783,100
187695328,187693967,187702140,8173,4784,100
187707647,187706285,187714162,7877,4785,100
187719690,187718328,187726207,7879,4786,100
187731698,187730336,187740114,9778,4787,100
187745731,187744153,187754484,10331,4788,100
187760061,187758700,187767211,8511,4789,100
187772828,187771250,187781244,9994,4790,100
187786742,187785381,187793553,8172,4791,100
187799171,187797592,187807587,9995,4792,100
187813130,187811769,187820279,8510,4793,100
187825761,187824400,187833227,8827,4794,100
187838715,187837353,187847447,10094,4795,100
187853153,187851575,187859668,8093,4796,100
187865175,187863812,187873591,9779,4797,100
187879053,187877691,187887469,9778,4798,100
187892964,187891602,187901379,9777,4799,100
187906997,187905418,187915412,9994,4800,100
187921029,187919451,187927546,8095,4801,100
187933020,187931658,187940486,8828,4802,100
187945936,187944574,187954667,10093,4803,100
187960372,187958795,187968472,9677,4804,100
187974089,187972511,187982505,9994,4805,100
187988122,187986544,187996855,10311,4806,100
188002560,188000983,188009075,8092,4807,100
188014525,188013164,188022941,9777,4808,100
188028467,188027105,188036250,9145,4809,100
188041743,188040382,188048260,7878,4810,100
188053804,188052443,188061587,9144,4811,100
188067074,188065712,188075174,9462,4812,100
188080791,188079213,188088257,9044,4813,100
188093722,188092361,188102138,9777,4814,100
188107755,188106177,188116488,10311,4815,100
188122194,188120616,188129976,9360,4816,100
188135474,188134112,188142940,8828,4817,100
188148403,188147043,188155214,8171,4818,100
188160725,188159364,188168824,9460,4819,100
188174442,188172863,188181254,8391,4820,100
188186871,188185293,188194970,9677,4821,100
188200499,188199137,188207016,7879,4822,100
188212633,188211055,188220732,9677,4823,100
188226217,188224856,188234633,9777,4824,100
188240159,188238798,188246675,7877,4825,100
188252292,188250714,188259104,8390,4826,100
188264721,188263143,188271871,8728,4827,100
188277336,188275974,188284486,8512,4828,100
188290103,188288525,188298518,9993,4829,100
188304010,188302648,188310526,7878,4830,100
188316144,188314565,188323926,9361,4831,100
188329407,188328045,188336556,8511,4832,100
188342173,188340595,188348985,8390,4833,100
188354493,188353131,188362276,9145,4834,100
188367810,188366448,188376226,9778,4835,100
188381735,188380374,188389201,8827,4836,100
188394819,188393240,188401968,8728,4837,100
188407477,188406115,188413994,7879,4838,100
188419463,188418101,188427246,9145,4839,100
188432863,188431284,188439674,8390,4840,100
188445291,188443713,188453074,9361,4841,100
188458595,188457233,188465745,8512,4842,100
188471269,188469907,188479685,9778,4843,100
188485192,188483831,188492341,8510,4844,100
188497791,188496429,188505573,9144,4845,100
188511051,188509690,188519151,9461,4846,100
188524768,188523189,188533184,9995,4847,100
188538802,188537223,188546901,9678,4848,100
188552518,188550940,188561251,10311,4849,100
188566957,188565378,188574422,9044,4850,100
188579876,188578514,188587658,9144,4851,100
188593174,188591812,188601928,10116,4852,100
188607475,188606114,188613991,7877,4853,100
188619455,188618093,188625971,7878,4854,100
188631466,188630105,188639565,9460,4855,100
188645182,188643604,188653280,9676,4856,100
188658758,188657396,188666541,9145,4857,100
188672158,188670580,188679623,9043,4858,100
188685240,188683662,188693656,9994,4859,100
188699204,188697842,188707302,9460,4860,100
188712919,188711341,188720069,8728,4861,100
188725686,188724108,188732201,8093,4862,100
188737818,188736240,188745600,9360,4863,100
188751217,188749639,188758683,9044,4864,100
188764299,188762721,188770814,8093,4865,100
188776302,188774941,188783114,8173,4866,100
188788598,188787237,188796380,9143,4867,100
188801929,188800567,188810027,9460,4868,100
188815552,188814190,188822364,8174,4869,100
188827892,188826530,188836624,10094,4870,100
188842195,188840833,188849344,8511,4871,100
188854961,188853382,188863694,10312,4872,100
188869400,188867822,188876550,8728,4873,100
188882168,188880589,188890584,9995,4874,100
188896201,188894623,188903666,9043,4875,100
188909134,188907772,188916283,8511,4876,100
188921744,188920383,188930477,10094,4877,100
188936182,188934604,188944914,10310,4878,100
188950619,188949041,188958085,9044,4879,100
188963594,188962233,188972010,9777,4880,100
188977628,188976049,188986361,10312,4881,100
188991959,188990597,188998771,8174,4882,100
189004310,189002948,189011122,8174,4883,100
189016610,189015249,189024391,9142,4884,100
189029926,189028565,189037392,8827,4885,100
189043009,189041431,189050791,9360,4886,100
189056320,189054959,189063131,8172,4887,100
189068603,189067241,189075752,8511,4888,100
189081368,189079790,189089467,9677,4889,100
189095084,189093506,189103817,10311,4890,100
189109436,189108074,189117851,9777,4891,100
189123323,189121961,189129839,7878,4892,100
189135456,189133878,189144189,10311,4893,100
189149894,189148316,189156706,8390,4894,100
189162240,189160879,189170656,9777,4895,100
189176190,189174829,189183002,8173,4896,100
189188531,189187169,189195342,8173,4897,100
189200960,189199381,189209059,9678,4898,100
189214602,189213241,189221414,8173,4899,100
189226907,189225545,189234055,8510,4900,100
189239672,189238094,189248088,9994,4901,100
189253629,189252267,189261728,9461,4902,100
189267345,189265767,189276077,10310,4903,100
189281565,189280204,189290799,10595,4904,100
189296345,189294983,189305078,10095,4905,100
189310785,189309206,189318885,9679,4906,100
189324433,189323072,189330948,7876,4907,100
189336495,189335134,189345228,10094,4908,100
189350934,189349356,189359034,9678,4909,100
189364521,189363160,189372937,9777,4910,100
189378400,189377038,189386182,9144,4911,100
189391653,189390292,189398170,7878,4912,100
189403787,189402209,189410937,8728,4913,100
189416554,189414976,189425287,10311,4914,100
189430993,189429415,189438143,8728,4915,100
189443759,189442182,189450275,8093,4916,100
189455891,189454313,189463673,9360,4917,100
189469157,189467796,189477889,10093,4918,100
189483431,189482069,189492164,10095,4919,100
189497700,189496339,189505166,8827,4920,100
189510783,189509205,189519199,9994,4921,100
189524676,189523315,189531488,8173,4922,100
189536989,189535628,189543800,8172,4923,100
189549200,189547839,189559488,11649,4924,100
189565043,189563681,189573459,9778,4925,100
189578913,189577552,189586063,8511,4926,100
189591612,189590251,189598128,7877,4927,100
189603642,189602281,189611741,9460,4928,100
189617272,189615910,189625055,9145,4929,100
189630672,189629094,189637484,8390,4930,100
189643100,189641522,189650250,8728,4931,100
189655868,189654289,189662680,8391,4932,100
189668297,189666719,189676396,9677,4933,100
189682013,189680435,189690111,9676,4934,100
189695572,189694211,189703671,9460,4935,100
189709289,189707710,189715805,8095,4936,100
189721422,189719844,189727939,8095,4937,100
189733556,189731978,189742289,10311,4938,100
189747867,189746506,189754679,8173,4939,100
189760296,189758718,189769027,10309,4940,100
189774733,189773155,189783464,10309,4941,100
189789026,189787665,189797758,10093,4942,100
189803464,189801886,189810929,9043,4943,100
189816394,189815032,189823859,8827,4944,100
189829477,189827898,189838209,10311,4945,100
189843697,189842336,189854197,11861,4946,100
189859816,189858454,189866628,8174,4947,100
189872109,189870748,189878625,7877,4948,100
189884070,189882709,189890903,8194,4949,100
189896420,189895058,189903569,8511,4950,100
189909056,189907695,189916522,8827,4951,100
189922140,189920561,189929289,8728,4952,100
189934906,189933328,189941718,8390,4953,100
189947336,189945757,189954802,9045,4954,100
189960298,189958936,189968081,9145,4955,100
189973699,189972120,189981164,9044,4956,100
189986692,189985330,189994474,9144,4957,100
190000091,189998513,190008189,9676,4958,100
190013715,190012354,190021814,9460,4959,100
190027432,190025853,190035215,9362,4960,100
190040833,190039254,190047645,8391,4961,100
190053262,190051684,190060074,8390,4962,100
190065691,190064113,190074424,10311,4963,100
190079981,190078620,190086793,8173,4964,100
190092259,190090898,190098775,7877,4965,100
190104264,190102902,190111730,8828,4966,100
190117345,190115768,190126078,10310,4967,100
190131785,190130206,190140200,9994,4968,100
190145723,190144361,190153189,8828,4969,100
190158807,190157228,190165619,8391,4970,100
190171132,190169770,190177649,7879,4971,100
190183096,190181734,190190879,9145,4972,100
190196406,190195045,190204822,9777,4973,100
190210440,190208861,190218856,9995,4974,100
190224403,190223041,190231214,8173,4975,100
190236831,190235253,190245564,10311,4976,100
190251270,190249691,190258736,9045,4977,100
190264353,190262775,190272451,9676,4978,100
190278068,190276490,190285218,8728,4979,100
190290837,190289257,190297649,8392,4980,100
190303266,190301688,190310077,8389,4981,100
190315543,190314181,190322058,7877,4982,100
190327676,190326097,190335776,9679,4983,100
190341393,190339815,190348204,8389,4984,100
190353821,190352243,190361286,9043,4985,100
190366903,190365325,190373420,8095,4986,100
190378909,190377548,190386691,9143,4987,100
190392236,190390875,190400969,10094,4988,100
190406675,190405097,190413825,8728,4989,100
190419320,190417958,190427736,9778,4990,100
190433199,190431837,190439716,7879,4991,100
190445334,190443755,190451850,8095,4992,100
190457467,190455889,190466200,10311,4993,100
190471906,190470327,190479056,8729,4994,100
190484543,190483182,190491692,8510,4995,100
190497176,190495815,190503987,8172,4996,100
190509604,190508026,190517387,9361,4997,100
190522860,190521498,190530959,9461,4998,100
190536577,190534998,190543725,8727,4999,100
190549342,190547764,190557758,9994,5000,100
190563533,190561797,190572030,10233,1,125
190577623,190575888,190584832,8944,2,125
190590337,190588601,190596934,8333,3,125
190602221,190600703,190610015,9312,4,125
190615519,190613784,190623383,9599,5,125
190628671,190627152,190636096,8944,6,125
190641385,190639866,190647892,8026,7,125
190653398,190651662,190662212,10550,8,125
190667589,190666070,190676618,10548,9,125
190681994,190680476,190689788,9312,10,125
190695382,190693646,190702908,9262,11,125
190708284,190706766,190716048,9282,12,125
190721596,190720078,190730093,10015,13,125
190735557,190734039,190742667,8628,14,125
190748260,190746525,190755786,9261,15,125
190761379,190759644,190767976,8332,16,125
190773569,190771834,190780777,8943,17,125
190786327,190784808,190793873,9065,18,125
190799466,190797731,190807013,9282,19,125
190812607,190810871,190821103,10232,20,125
190826568,190825050,190835597,10547,21,125
190841063,190839544,190847877,8333,22,125
190853471,190851735,190861334,9599,23,125
190866712,190865193,190873526,8333,24,125
190879120,190877384,190885717,8333,25,125
190891093,190889575,190898519,8944,26,125
190903896,190902377,190911006,8629,27,125
190916599,190914864,190923491,8627,28,125
190928867,190927349,190936292,8943,29,125
190941885,190940150,190948482,8332,30,125
190953858,190952340,190961653,9313,31,125
190967246,190965511,190974138,8627,32,125
190979686,190978167,190987549,9382,33,125
190993143,190991407,191001007,9600,34,125
191006385,191004866,191013200,8334,35,125
191018577,191017058,191025400,8342,36,125
191030777,191029259,191039521,10262,37,125
191044988,191043468,191053700,10232,38,125
191059383,191057647,191067563,9916,39,125
191073155,191071421,191079753,8332,40,125
191085346,191083611,191091944,8333,41,125
191097493,191095974,191105673,9699,42,125
191111266,191109531,191119128,9597,43,125
191124666,191123148,191132530,9382,44,125
191138124,191136388,191144721,8333,45,125
191150316,191148580,191158180,9600,46,125
191163557,191162038,191171014,8976,47,125
191176391,191174873,191182898,8025,48,125
191188275,191186757,191195384,8627,49,125
191200762,191199243,191207903,8660,50,125
191213281,191211762,191220094,8332,51,125
191225688,191223952,191234184,10232,52,125
191239868,191238132,191248682,10550,53,125
191254365,191252629,191262862,10233,54,125
191268546,191266810,191275756,8946,55,125
191281350,191279615,191289214,9599,56,125
191294809,191293073,191302356,9283,57,125
191307913,191306394,191315121,8727,58,125
191320673,191319155,191327882,8727,59,125
191333259,191331741,191340400,8659,60,125
191345931,191344412,191353478,9066,61,125
191359072,191357337,191366935,9598,62,125
191372528,191370793,191379126,8333,63,125
191384719,191382984,191393532,10548,64,125
191399215,191397479,191407078,9599,65,125
191412672,191410936,191420218,9282,66,125
191425813,191424077,191432706,8629,67,125
191438299,191436564,191444896,8332,68,125
191450490,191448754,191458986,10232,69,125
191464452,191462934,191472532,9598,70,125
191477910,191476391,191484418,8027,71,125
191489969,191488450,191498781,10331,72,125
191504463,191502728,191512326,9598,73,125
191517919,191516184,191524812,8628,74,125
191530343,191528825,191538522,9697,75,125
191544115,191542380,191552611,10231,76,125
191558294,191556559,191566474,9915,77,125
191572068,191570333,191580881,10548,78,125
191586564,191584828,191593774,8946,79,125
191599151,191597632,191608591,10959,80,125
191614056,191612538,191621481,8943,81,125
191626858,191625339,191634653,9314,82,125
191640247,191638512,191647139,8627,83,125
191652734,191650998,191659944,8946,84,125
191665538,191663803,191673717,9914,85,125
191679311,191677576,191687808,10232,86,125
191693491,191691756,191701671,9915,87,125
191707049,191705530,191714190,8660,88,125
191719784,191718048,191727647,9599,89,125
191733241,191731505,191739837,8332,90,125
191745214,191743695,191753641,9946,91,125
191759234,191757499,191767731,10232,92,125
191773196,191771678,191781593,9915,93,125
191786970,191785452,191795683,10231,94,125
191801366,191799630,191810180,10550,95,125
191815862,191814127,191823726,9599,96,125
191829321,191827585,191837817,10232,97,125
191843283,191841764,191851997,10233,98,125
191857679,191855944,191864572,8628,99,125
191870166,191868431,191876764,8333,100,125
191882230,191880711,191889994,9283,101,125
191895678,191893942,191903859,9917,102,125
191909541,191907807,191918038,10231,103,125
191923809,191922074,191931673,9599,104,125
191937233,191935714,191943831,8117,105,125
191949512,191947778,191957376,9598,106,125
191962843,191961324,191970269,8945,107,125
191975952,191974217,191984449,10232,108,125
191990221,191988486,191998085,9599,109,125
192003633,192002114,192011178,9064,110,125
192016861,192015125,192025041,9916,111,125
192030507,192028988,192039536,10548,112,125
192045307,192043572,192053487,9915,113,125
192059026,192057508,192067205,9697,114,125
192072888,192071152,192081384,10232,115,125
192087156,192085420,192095019,9599,116,125
192100555,192099036,192108734,9698,117,125
192114417,192112681,192121964,9283,118,125
192127647,192125911,192135827,9916,119,125
192141293,192139774,192149057,9283,120,125
192154739,192153004,192161632,8628,121,125
192167189,192165670,192174082,8412,122,125
192179548,192178029,192186362,8333,123,125
192192044,192190309,192200541,10232,124,125
192206313,192204577,192215126,10549,125,125
192220898,192219162,192229710,10548,126,125
192235481,192233746,192243978,10232,127,125
192249749,192248014,192258246,10232,128,125
192264017,192262282,192271564,9282,129,125
192277247,192275511,192284793,9282,130,125
192290476,192288740,192298340,9600,131,125
192303806,192302287,192311570,9283,132,125
192317252,192315517,192325432,9915,133,125
192331115,192329379,192338661,9282,134,125
192344343,192342608,192351890,9282,135,125
192357573,192355837,192364465,8628,136,125
192370147,192368412,192378959,10547,137,125
192384513,192382994,192393542,10548,138,125
192399096,192397578,192406860,9282,139,125
192412543,192410807,192419435,8628,140,125
192424900,192423382,192433612,10230,141,125
192439384,192437648,192447248,9600,142,125
192452713,192451195,192459823,8628,143,125
192465372,192463853,192472265,8412,144,125
192477948,192476212,192484546,8334,145,125
192490229,192488493,192497775,9282,146,125
192503241,192501722,192510666,8944,147,125
192516350,192514614,192524213,9599,148,125
192529679,192528160,192538392,10232,149,125
192543947,192542428,192552028,9600,150,125
192557710,192555975,192564603,8628,151,125
192570141,192568622,192577688,9066,152,125
192583153,192581635,192590896,9261,153,125
192596578,192594843,192603175,8332,154,125
192608857,192607122,192616404,9282,155,125
192621870,192620351,192629634,9283,156,125
192635317,192633581,192643497,9916,157,125
192649179,192647444,192655775,8331,158,125
192661240,192659722,192670270,10548,159,125
192675912,192674393,192684091,9698,160,125
192689774,192688038,192697321,9283,161,125
192703005,192701269,192711184,9915,162,125
192716650,192715131,192725680,10549,163,125
192731235,192729716,192738344,8628,164,125
192744028,192742292,192752524,10232,165,125
192758297,192756561,192765823,9262,166,125
192771506,192769771,192778715,8944,167,125
192784398,192782663,192792578,9915,168,125
192798261,192796526,192806125,9599,169,125
192811808,192810073,192820305,10232,170,125
192825859,192824341,192833285,8944,171,125
192838967,192837232,192847780,10548,172,125
192853551,192851816,192860759,8943,173,125
192866443,192864707,192873336,8629,174,125
192878874,192877355,192887687,10332,175,125
192893458,192891723,192901004,9281,176,125
192906540,192905022,192913432,8410,177,125
192919116,192917380,192927296,9916,178,125
192932978,192931243,192941475,10232,179,125
192947098,192945580,192954308,8728,180,125
192959775,192958256,192966589,8333,181,125
192972271,192970536,192979480,8944,182,125
192985164,192983428,192992711,9283,183,125
192998250,192996732,193007063,10331,184,125
193012834,193011099,193020380,9281,185,125
193026063,193024328,193034875,10547,186,125
193040647,193038911,193047539,8628,187,125
193053070,193051551,193060933,9382,188,125
193066477,193064959,193074024,9065,189,125
193079491,193077972,193088205,10233,190,125
193093760,193092241,193102157,9916,191,125
193107701,193106183,193114911,8728,192,125
193120594,193118859,193128141,9282,193,125
193133824,193132089,193141370,9281,194,125
193147053,193145318,193154917,9599,195,125
193160384,193158865,193168464,9599,196,125
193174147,193172412,193180745,8333,197,125
193186428,193184693,193193320,8627,198,125
193198866,193197347,193206728,9381,199,125
193212412,193210676,193220276,9600,200,125
193225827,193224309,193232424,8115,201,125
193237890,193236372,193245970,9598,202,125
193251653,193249918,193259833,9915,203,125
193265300,193263781,193273697,9916,204,125
193279380,193277645,193287560,9915,205,125
193293243,193291508,193301739,10231,206,125
193307385,193305867,193318267,12400,207,125
193324039,193322304,193340323,18019,208,125
193345879,193344361,193352692,8331,209,125
193358375,193356640,193365268,8628,210,125
193370951,193369216,193378497,9281,211,125
193384181,193382445,193392678,10233,212,125
193398319,193396800,193404917,8117,213,125
193410600,193408865,193417493,8628,214,125
193423176,193421441,193431990,10549,215,125
193437763,193436027,193445310,9283,216,125
193450994,193449258,193458857,9599,217,125
193464540,193462805,193471748,8943,218,125
193477433,193475697,193484325,8628,219,125
193490009,193488273,193497873,9600,220,125
193503556,193501821,193510449,8628,221,125
193516132,193514397,193523679,9282,222,125
193529362,193527627,193536255,8628,223,125
193541785,193540267,193548382,8115,224,125
193553849,193552330,193561274,8944,225,125
193566741,193565222,193575770,10548,226,125
193581542,193579807,193590038,10231,227,125
193595810,193594075,193604307,10232,228,125
193610081,193608344,193617627,9283,229,125
193623310,193621575,193630519,8944,230,125
193635985,193634467,193645015,10548,231,125
193650788,193649052,193657998,8946,232,125
193663682,193661946,193670892,8946,233,125
193676575,193674840,193683468,8628,234,125
193689152,193687416,193697015,9599,235,125
193702698,193700963,193709295,8332,236,125
193714762,193713243,193721576,8333,237,125
193727259,193725524,193735756,10232,238,125
193741311,193739793,193748737,8944,239,125
193754421,193752685,193763233,10548,240,125
193768788,193767270,193775602,8332,241,125
193781285,193779550,193788831,9281,242,125
193794298,193792779,193802378,9599,243,125
193807913,193806394,193815776,9382,244,125
193821459,193819724,193829955,10231,245,125
193835728,193833992,193842325,8333,246,125
193848008,193846273,193855872,9599,247,125
193861557,193859821,193868155,8334,248,125
193873838,193872103,193880435,8332,249,125
193886119,193884383,193894616,10233,250,125
193900172,193898653,193906985,8332,251,125
193912452,193910933,193920216,9283,252,125
193925758,193924240,193933938,9698,253,125
193939621,193937886,193947484,9598,254,125
193952950,193951432,193961031,9599,255,125
193966714,193964979,193973607,8628,256,125
193979291,193977555,193985887,8332,257,125
193991354,193989835,193998464,8629,258,125
194004147,194002412,194010745,8333,259,125
194016212,194014693,194023026,8333,260,125
194028709,194026974,194036573,9599,261,125
194042040,194040521,194049149,8628,262,125
194054697,194053178,194061294,8116,263,125
194066850,194065331,194073447,8116,264,125
194079130,194077395,194087309,9914,265,125
194092992,194091257,194100856,9599,266,125
194106540,194104804,194115353,10549,267,125
194121125,194119390,194129938,10548,268,125
194135494,194133975,194142308,8333,269,125
194147992,194146257,194155539,9282,270,125
194161222,194159487,194168431,8944,271,125
194174114,194172379,194181661,9282,272,125
194187218,194185699,194195398,9699,273,125
194201081,194199346,194209577,10231,274,125
194215350,194213614,194222896,9282,275,125
194228363,194226844,194237076,10232,276,125
194242848,194241113,194250712,9599,277,125
194256264,194254745,194263811,9066,278,125
194269495,194267759,194277041,9282,279,125
194282507,194280989,194290903,9914,280,125
194296587,194294851,194305400,10549,281,125
194311172,194309437,194319036,9599,282,125
194324719,194322985,194331927,8942,283,125
194337612,194335876,194345158,9282,284,125
194350842,194349106,194357439,8333,285,125
194362906,194361387,194370986,9599,286,125
194376671,194374935,194385484,10549,287,125
194391256,194389521,194399753,10232,288,125
194405372,194403854,194412582,8728,289,125
194418265,194416530,194424862,8332,290,125
194430547,194428811,194439360,10549,291,125
194445133,194443397,194453947,10550,292,125
194459719,194457984,194468532,10548,293,125
194474305,194472569,194481515,8946,294,125
194487198,194485463,194494408,8945,295,125
194500093,194498357,194506986,8629,296,125
194512670,194510935,194520217,9282,297,125
194525900,194524165,194534081,9916,298,125
194539765,194538029,194546974,8945,299,125
194552532,194551013,194559741,8728,300,125
194565426,194563690,194572972,9282,301,125
194578654,194576919,194586200,9281,302,125
194591883,194590148,194599747,9599,303,125
194605431,194603695,194612978,9283,304,125
194618533,194617014,194626080,9066,305,125
194631763,194630028,194639942,9914,306,125
194645626,194643891,194653173,9282,307,125
194658639,194657121,194667351,10230,308,125
194673123,194671388,194681936,10548,309,125
194687708,194685973,194695255,9282,310,125
194700788,194699269,194707386,8117,311,125
194712853,194711334,194721249,9915,312,125
194726933,194725198,194734141,8943,313,125
194739691,194738172,194747237,9065,314,125
194752921,194751185,194760130,8945,315,125
194765813,194764078,194774626,10548,316,125
194780182,194778663,194786995,8332,317,125
194792679,194790943,194801175,10232,318,125
194806730,194805212,194815760,10548,319,125
194821532,194819797,194829395,9598,320,125
194835078,194833343,194843890,10547,321,125
194849446,194847927,194856556,8629,322,125
194862240,194860504,194869132,8628,323,125
194874815,194873080,194883311,10231,324,125
194888929,194887410,194896138,8728,325,125
194901821,194900086,194910001,9915,326,125
194915684,194913949,194922282,8333,327,125
194927749,194926230,194936146,9916,328,125
194941829,194940094,194950325,10231,329,125
194955881,194954362,194963306,8944,330,125
194968989,194967254,194976536,9282,331,125
194982002,194980484,194989112,8628,332,125
194994653,194993134,195003149,10015,333,125
195008922,195007186,195017102,9916,334,125
195022568,195021050,195031281,10231,335,125
195037053,195035318,195043944,8626,336,125
195049628,195047892,195058124,10232,337,125
195063896,195062161,195071106,8945,338,125
195076637,195075119,195083847,8728,339,125
195089314,195087795,195096740,8945,340,125
195102424,195100688,195111237,10549,341,125
195117010,195115274,195124220,8946,342,125
195129903,195128168,195138715,10547,343,125
195144487,195142752,195151696,8944,344,125
195157380,195155644,195165243,9599,345,125
195170927,195169191,195178136,8945,346,125
195183604,195182085,195192001,9916,347,125
195197685,195195949,195204281,8332,348,125
195209965,195208229,195217512,9283,349,125
195223195,195221460,195230741,9281,350,125
195236425,195234689,195243022,8333,351,125
195248705,195246970,195255597,8627,352,125
195261063,195259545,195269460,9915,353,125
195274995,195273476,195283808,10332,354,125
195289580,195287845,195298077,10232,355,125
195303850,195302114,195311397,9283,356,125
195316864,195315345,195325894,10549,357,125
195331667,195329931,195340164,10233,358,125
195345936,195344201,195352828,8627,359,125
195358512,195356776,195365110,8334,360,125
195370794,195369058,195378003,8945,361,125
195383687,195381951,195390895,8944,362,125
195396361,195394843,195405073,10230,363,125
195410844,195409110,195417737,8627,364,125
195423421,195421685,195431601,9916,365,125
195437284,195435549,195446096,10547,366,125
195451869,195450133,195459416,9283,367,125
195465101,195463365,195471993,8628,368,125
195477678,195475942,195484571,8629,369,125
195490254,195488519,195499067,10548,370,125
195504839,195503104,195512386,9282,371,125
195517853,195516334,195524667,8333,372,125
195530207,195528688,195537100,8412,373,125
195542783,195541048,195551596,10548,374,125
195557232,195555714,195565729,10015,375,125
195571373,195569854,195578582,8728,376,125
195584266,195582531,195591813,9282,377,125
195597280,195595761,195605360,9599,378,125
195611044,195609308,195618253,8945,379,125
195623719,195622201,195632433,10232,380,125
195638206,195636470,195645752,9282,381,125
195651220,195649700,195660249,10549,382,125
195665804,195664286,195672913,8627,383,125
195678380,195676861,195686143,9282,384,125
195691828,195690092,195700641,10549,385,125
195706413,195704678,195714276,9598,386,125
195719959,195718225,195728772,10547,387,125
195734544,195732809,195742091,9282,388,125
195747774,195746039,195754667,8628,389,125
195760134,195758616,195767242,8626,390,125
195772926,195771190,195779522,8332,391,125
195785207,195783471,195793387,9916,392,125
195799071,195797336,195807251,9915,393,125
195812719,195811200,195820144,8944,394,125
195825827,195824092,195833037,8945,395,125
195838505,195836986,195846268,9282,396,125
195851952,195850216,195859499,9283,397,125
195864965,195863447,195872390,8943,398,125
195878073,195876338,195886569,10231,399,125
195892342,195890606,195900206,9600,400,125
195905889,195904154,195914069,9915,401,125
195919752,195918017,195928565,10548,402,125
195934337,195932602,195941884,9282,403,125
195947568,195945832,195954460,8628,404,125
195960143,195958408,195968639,10231,405,125
195974411,195972676,195981304,8628,406,125
195986771,195985252,195995167,9915,407,125
196000850,195999115,196009663,10548,408,125
196015219,196013700,196024249,10549,409,125
196030021,196028286,196038202,9916,410,125
196043670,196042151,196050780,8629,411,125
196056313,196054795,196062910,8115,412,125
196068593,196066858,196076139,9281,413,125
196081605,196080087,196090002,9915,414,125
196095685,196093950,196102578,8628,415,125
196108262,196106526,196116126,9600,416,125
196121809,196120074,196129356,9282,417,125
196135039,196133304,196142903,9599,418,125
196148586,196146851,196156450,9599,419,125
196161918,196160399,196168732,8333,420,125
196174199,196172680,196182911,10231,421,125
196188683,196186948,196197497,10549,422,125
196203269,196201534,196209866,8332,423,125
196215549,196213814,196224363,10549,424,125
196230135,196228400,196238631,10231,425,125
196244403,196242668,196251612,8944,426,125
196257295,196255560,196264505,8945,427,125
196269972,196268453,196276785,8332,428,125
196282469,196280734,196290966,10232,429,125
196296522,196295003,196303336,8333,430,125
196309020,196307284,196315913,8629,431,125
196321596,196319861,196328806,8945,432,125
196334490,196332755,196342036,9281,433,125
196347720,196345984,196356217,10233,434,125
196361838,196360319,196370018,9699,435,125
196375701,196373966,196389895,15929,436,125
196395518,196394000,196402115,8115,437,125
196407798,196406063,196416294,10231,438,125
196422066,196420331,196429613,9282,439,125
196435297,196433562,196443477,9915,440,125
196449161,196447426,196456708,9282,441,125
196462175,196460656,196468990,8334,442,125
196474675,196472939,196483172,10233,443,125
196488944,196487209,196497124,9915,444,125
196502807,196501072,196509699,8627,445,125
196515166,196513648,196522591,8943,446,125
196528057,196526539,196534870,8331,447,125
196540553,196538818,196547763,8945,448,125
196553230,196551712,196560339,8627,449,125
196565805,196564287,196572915,8628,450,125
196578599,196576863,196587412,10549,451,125
196593185,196591449,196601049,9600,452,125
196606733,196604997,196613943,8946,453,125
196619410,196617891,196628122,10231,454,125
196633677,196632159,196641103,8944,455,125
196646786,196645051,196655599,10548,456,125
196661370,196659635,196669234,9599,457,125
196674917,196673182,196682781,9599,458,125
196688247,196686729,196696961,10232,459,125
196702516,196700998,196711229,10231,460,125
196717001,196715266,196724210,8944,461,125
196729747,196728228,196736344,8116,462,125
196741875,196740356,196749739,9383,463,125
196755423,196753687,196762632,8945,464,125
196768316,196766580,196777129,10549,465,125
196782902,196781166,196791715,10549,466,125
196797333,196795815,196806145,10330,467,125
196811701,196810182,196819464,9282,468,125
196825147,196823412,196832040,8628,469,125
196837585,196836066,196845765,9699,470,125
196851448,196849713,196859945,10232,471,125
196865717,196863982,196874530,10548,472,125
196880086,196878567,196887196,8629,473,125
196892663,196891144,196901376,10232,474,125
196906932,196905413,196915011,9598,475,125
196920695,196918959,196928875,9916,476,125
196934558,196932823,196942738,9915,477,125
196948421,196946686,196955968,9282,478,125
196961652,196959916,196969198,9282,479,125
196974664,196973146,196983061,9915,480,125
196988527,196987009,196996923,9914,481,125
197002606,197000871,197011419,10548,482,125
197017191,197015456,197024401,8945,483,125
197030084,197028349,197038264,9915,484,125
197043947,197042212,197050544,8332,485,125
197056228,197054492,197063774,9282,486,125
197069241,197067722,197076667,8945,487,125
197082350,197080615,197090529,9914,488,125
197096212,197094477,197104392,9915,489,125
197109859,197108340,197118256,9916,490,125
197123722,197122204,197132119,9915,491,125
197137802,197136067,197145981,9914,492,125
197151534,197150015,197160346,10331,493,125
197165974,197164455,197174469,10014,494,125
197180025,197178506,197187451,8945,495,125
197192918,197191399,197200027,8628,496,125
197205710,197203975,197214207,10232,497,125
197219980,197218244,197226873,8629,498,125
197232557,197230821,197239450,8629,499,125
197244979,197243461,197252843,9382,500,125
197258310,197256791,197265735,8944,501,125
197271419,197269683,197278966,9283,502,125
197284649,197282914,197291542,8628,503,125
197297225,197295490,197306038,10548,504,125
197311811,197310075,197318408,8333,505,125
197323874,197322356,197331955,9599,506,125
197337638,197335903,197346451,10548,507,125
197352224,197350488,197361036,10548,508,125
197366809,197365073,197374017,8944,509,125
197379703,197377966,197387883,9917,510,125
197393349,197391831,197400162,8331,511,125
197405845,197404110,197414341,10231,512,125
197419896,197418378,197428292,9914,513,125
197433975,197432240,197442788,10548,514,125
197448420,197446902,197455313,8411,515,125
197460997,197459261,197468860,9599,516,125
197474544,197472808,197481140,8332,517,125
197486823,197485088,197494032,8944,518,125
197499716,197497980,197506314,8334,519,125
197511997,197510262,197518594,8332,520,125
197524278,197522542,197531486,8944,521,125
197537169,197535434,197543767,8333,522,125
197549451,197547715,197556661,8946,523,125
197562344,197560609,197570840,10231,524,125
197576612,197574877,197585109,10232,525,125
197590882,197589146,197598091,8945,526,125
197603558,197602040,197610667,8627,527,125
197616350,197614615,197625163,10548,528,125
197630936,197629200,197639115,9915,529,125
197644799,197643063,197652979,9916,530,125
197658662,197656927,197665871,8944,531,125
197671554,197669819,197678152,8333,532,125
197683688,197682170,197692185,10015,533,125
197697822,197696304,197705369,9065,534,125
197711053,197709317,197718262,8945,535,125
197723946,197722210,197731155,8945,536,125
197736839,197735103,197743437,8334,537,125
197748904,197747385,197757934,10549,538,125
197763490,197761971,197771569,9598,539,125
197777253,197775517,197785433,9916,540,125
197791117,197789381,197799929,10548,541,125
197805565,197804047,197813745,9698,542,125
197819428,197817693,197826025,8332,543,125
197831709,197829973,197838305,8332,544,125
197843989,197842253,197851536,9283,545,125
197857220,197855484,197865717,10233,546,125
197871273,197869754,197879986,10232,547,125
197885542,197884023,197892652,8629,548,125
197898336,197896601,197904933,8332,549,125
197910465,197908946,197918329,9383,550,125
197924012,197922277,197932192,9915,551,125
197937740,197936222,197946235,10013,552,125
197952008,197950272,197958605,8333,553,125
197964288,197962553,197972468,9915,554,125
197978151,197976416,197986331,9915,555,125
197991797,197990279,198000510,10231,556,125
198006066,198004547,198013176,8629,557,125
198018860,198017124,198026406,9282,558,125
198032090,198030354,198039954,9600,559,125
198045638,198043903,198054134,10231,560,125
198059906,198058171,198068402,10231,561,125
198074024,198072506,198082203,9697,562,125
198087887,198086151,198095097,8946,563,125
198100780,198099045,198108960,9915,564,125
198114426,198112908,198121852,8944,565,125
198127535,198125800,198134428,8628,566,125
198139894,198138376,198147002,8626,567,125
198152468,198150950,198160549,9599,568,125
198166233,198164497,198174097,9600,569,125
198179651,198178132,198187198,9066,570,125
198192881,198191146,198200744,9598,571,125
198206427,198204692,198214291,9599,572,125
198219975,198218240,198227839,9599,573,125
198233525,198231788,198242339,10551,574,125
198248111,198246376,198256607,10231,575,125
198262380,198260644,198269927,9283,576,125
198275610,198273875,198282207,8332,577,125
198287674,198286155,198294784,8629,578,125
198300469,198298732,198308333,9601,579,125
198314017,198312281,198322197,9916,580,125
198327881,198326145,198336695,10550,581,125
198342252,198340732,198349362,8630,582,125
198355046,198353310,198361939,8629,583,125
198367622,198365887,198375485,9598,584,125
198381170,198379434,198388063,8629,585,125
198393747,198392012,198401927,9915,586,125
198407393,198405875,198416106,10231,587,125
198421662,198420143,198430059,9916,588,125
198435743,198434008,198442636,8628,589,125
198448319,198446584,198457131,10547,590,125
198462687,198461168,198469501,8333,591,125
198475184,198473449,198483680,10231,592,125
198489453,198487717,198497000,9283,593,125
198502466,198500948,198511496,10548,594,125
198517115,198515597,198524979,9382,595,125
198530663,198528927,198537556,8629,596,125
198543109,198541590,198550319,8729,597,125
198555786,198554267,198563211,8944,598,125
198568894,198567159,198576103,8944,599,125
198581786,198580051,198590599,10548,600,125
198596372,198594636,198603919,9283,601,125
198609602,198607867,198616495,8628,602,125
198622178,198620443,198629070,8627,603,125
198634538,198633019,198642301,9282,604,125
198647984,198646249,198655848,9599,605,125
198661315,198659796,198670345,10549,606,125
198675900,198674382,198683009,8627,607,125
198688568,198687049,198696115,9066,608,125
198701798,198700063,198709007,8944,609,125
198714690,198712955,198723504,10549,610,125
198729060,198727541,198736170,8629,611,125
198741853,198740118,198749716,9598,612,125
198755399,198753664,198762946,9282,613,125
198768413,198766894,198777443,10549,614,125
198782999,198781480,198791395,9915,615,125
198797078,198795343,198804942,9599,616,125
198810625,198808890,198818151,9261,617,125
198823618,198822099,198832015,9916,618,125
198837699,198835963,198844908,8945,619,125
198850376,198848857,198857189,8332,620,125
198862873,198861137,198871370,10233,621,125
198876926,198875407,198885323,9916,622,125
198891006,198889271,198898216,8945,623,125
198903684,198902165,198911764,9599,624,125
198917448,198915712,198925312,9600,625,125
198930996,198929260,198938859,9599,626,125
198944392,198942873,198951938,9065,627,125
198957623,198955887,198965803,9916,628,125
198971486,198969751,198979982,10231,629,125
198985754,198984019,198994249,10230,630,125
199000021,198998286,199006914,8628,631,125
199012449,199010930,199019996,9066,632,125
199025680,199023944,199034176,10232,633,125
199039948,199038213,199048444,10231,634,125
199053999,199052481,199063029,10548,635,125
199068666,199067147,199075874,8727,636,125
199081341,199079822,199089737,9915,637,125
199095421,199093685,199102019,8334,638,125
199107485,199105967,199114595,8628,639,125
199120278,199118543,199126874,8331,640,125
199132341,199130822,199141054,10232,641,125
199146826,199145091,199153719,8628,642,125
199159403,199157667,199167900,10233,643,125
199173672,199171937,199181219,9282,644,125
199186903,199185167,199193500,8333,645,125
199198967,199197448,199206731,9283,646,125
199212198,199210679,199220595,9916,647,125
199226063,199224544,199234144,9600,648,125
199239827,199238092,199248006,9914,649,125
199253472,199251954,199260898,8944,650,125
199266365,199264846,199273474,8628,651,125
199279157,199277422,199287653,10231,652,125
199293426,199291690,199300636,8946,653,125
199306102,199304584,199315132,10548,654,125
199320904,199319169,199329084,9915,655,125
199334624,199333105,199343120,10015,656,125
199348892,199347157,199355785,8628,657,125
199361318,199359798,199368211,8413,658,125
199373895,199372159,199381442,9283,659,125
199387125,199385390,199394334,8944,660,125
199400017,199398282,199406614,8332,661,125
199412298,199410562,199419507,8945,662,125
199424973,199423455,199433369,9914,663,125
199439052,199437317,199447232,9915,664,125
199452699,199451180,199459808,8628,665,125
199465492,199463757,199473671,9914,666,125
199479137,199477619,199486246,8627,667,125
199491930,199490194,199498526,8332,668,125
199503992,199502474,199511102,8628,669,125
199516785,199515050,199525599,10549,670,125
199531371,199529636,199539235,9599,671,125
199544701,199543183,199553098,9915,672,125
199558565,199557047,199567595,10548,673,125
199573367,199571632,199580575,8943,674,125
199586042,199584523,199594439,9916,675,125
199600122,199598387,199607014,8627,676,125
199612547,199611028,199620094,9066,677,125
199625560,199624042,199633641,9599,678,125
199639325,199637589,199647505,9916,679,125
199652973,199651454,199660736,9282,680,125
199666204,199664685,199673968,9283,681,125
199679435,199677916,199686545,8629,682,125
199692012,199690493,199699775,9282,683,125
199705458,199703723,199713004,9281,684,125
199718687,199716952,199725284,8332,685,125
199730968,199729232,199738177,8945,686,125
199743860,199742125,199752039,9914,687,125
199757505,199755987,199766219,10232,688,125
199771776,199770256,199780806,10550,689,125
199786579,199784843,199793472,8629,690,125
199799004,199797486,199807816,10330,691,125
199813371,199811853,199820797,8944,692,125
199826338,199824819,199834518,9699,693,125
199840202,199838466,199848699,10233,694,125
199854344,199852825,199862841,10016,695,125
199868481,199866962,199876977,10015,696,125
199882617,199881099,199889827,8728,697,125
199895510,199893775,199904005,10230,698,125
199909561,199908042,199917640,9598,699,125
199923107,199921588,199930532,8944,700,125
199936216,199934481,199944395,9914,701,125
199949862,199948343,199958891,10548,702,125
199964531,199963012,199972077,9065,703,125
199977760,199976025,199984357,8332,704,125
199990040,199988305,199997587,9282,705,125
200003130,200001611,200010677,9066,706,125
200016361,200014626,200022958,8332,707,125
200028494,200026975,200035704,8729,708,125
200041172,200039653,200049253,9600,709,125
200054721,200053202,200063118,9916,710,125
200068803,200067067,200076982,9915,711,125
200082667,200080931,200089876,8945,712,125
200095420,200093901,200103916,10015,713,125
200109690,200107954,200116899,8945,714,125
200122583,200120848,200129793,8945,715,125
200135260,200133742,200142686,8944,716,125
200148370,200146635,200156550,9915,717,125
200162235,200160499,200168833,8334,718,125
200174518,200172782,200182382,9600,719,125
200187850,200186331,200196563,10232,720,125
200202336,200200601,200211149,10548,721,125
200216706,200215187,200224786,9599,722,125
200230319,200228800,200236916,8116,723,125
200242600,200240865,200250464,9599,724,125
200256148,200254413,200262746,8333,725,125
200268430,200266695,200276610,9915,726,125
200282148,200280630,200290012,9382,727,125
200295480,200293961,200303877,9916,728,125
200309561,200307826,200317741,9915,729,125
200323288,200321769,200329886,8117,730,125
200335354,200333835,200342169,8334,731,125
200347853,200346118,200356350,10232,732,125
200361994,200360475,200368887,8412,733,125
200374354,200372836,200381464,8628,734,125
200387148,200385413,200395962,10549,735,125
200401518,200400000,200408628,8628,736,125
200414096,200412577,200422494,9917,737,125
200428178,200426443,200436992,10549,738,125
200442626,200441107,200449519,8412,739,125
200455204,200453468,200462096,8628,740,125
200467779,200466045,200475960,9915,741,125
200481645,200479909,200488855,8946,742,125
200494540,200492805,200502404,9599,743,125
200508088,200506353,200514981,8628,744,125
200520527,200519009,200529340,10331,745,125
200535113,200533378,200543609,10231,746,125
200549382,200547647,200557878,10231,747,125
200563523,200562005,200572336,10331,748,125
200577891,200576373,200586922,10549,749,125
200592694,200590959,200599904,8945,750,125
200605371,200603853,200612481,8628,751,125
200618011,200616492,200625221,8729,752,125
200630906,200629170,200639403,10233,753,125
200645033,200643514,200653847,10333,754,125
200659404,200657885,200668434,10549,755,125
200674207,200672472,200682071,9599,756,125
200687755,200686020,200695618,9598,757,125
200701086,200699567,200709484,9917,758,125
200715169,200713433,200723350,9917,759,125
200729034,200727299,200737848,10549,760,125
200743621,200741886,200750514,8628,761,125
200755981,200754463,200764378,9915,762,125
200769916,200768397,200778730,10333,763,125
200784503,200782767,200793315,10548,764,125
200799089,200797353,200807902,10549,765,125
200813675,200811940,200821856,9916,766,125
200827324,200825805,200835722,9917,767,125
200841190,200839671,200849270,9599,768,125
200854737,200853219,200863134,9915,769,125
200868602,200867083,200876682,9599,770,125
200882241,200880722,200889451,8729,771,125
200894919,200893400,200902345,8945,772,125
200908030,200906295,200914627,8332,773,125
200920311,200918576,200928174,9598,774,125
200933727,200932208,200941590,9382,775,125
200947274,200945539,200954167,8628,776,125
200959634,200958116,200968665,10549,777,125
200974438,200972703,200981985,9282,778,125
200987519,200986000,200996333,10333,779,125
201002106,201000371,201010603,10232,780,125
201016377,201014641,201023270,8629,781,125
201028954,201027219,201036818,9599,782,125
201042502,201040767,201049100,8333,783,125
201054785,201053049,201062649,9600,784,125
201068334,201066598,201075544,8946,785,125
201081012,201079493,201088439,8946,786,125
201093907,201092388,201101672,9284,787,125
201107200,201105682,201115064,9382,788,125
201120748,201119013,201128928,9915,789,125
201134396,201132877,201142159,9282,790,125
201147844,201146108,201154737,8629,791,125
201160421,201158686,201167019,8333,792,125
201172559,201171040,201180423,9383,793,125
201185890,201184372,201193970,9598,794,125
201199522,201198003,201207386,9383,795,125
201213071,201211335,201220281,8946,796,125
201225748,201224230,201233512,9282,797,125
201239196,201237461,201245792,8331,798,125
201251351,201249832,201258897,9065,799,125
201264582,201262846,201273395,10549,800,125
201279168,201277433,201287349,9916,801,125
201293034,201291298,201300243,8945,802,125
201305927,201304192,201314423,10231,803,125
201320051,201318532,201326944,8412,804,125
201332629,201330893,201340809,9916,805,125
201346493,201344758,201354040,9282,806,125
201359724,201357989,201368537,10548,807,125
201374094,201372575,201381521,8946,808,125
201387205,201385470,201394414,8944,809,125
201399947,201398428,201407811,9383,810,125
201413496,201411761,201420389,8628,811,125
201425857,201424339,201434571,10232,812,125
201440344,201438609,201447236,8627,813,125
201452920,201451185,201459517,8332,814,125
201465201,201463466,201474015,10549,815,125
201479571,201478053,201487969,9916,816,125
201493653,201491918,201500547,8629,817,125
201506231,201504496,201514095,9599,818,125
201519779,201518044,201526377,8333,819,125
201532062,201530326,201540243,9917,820,125
201545928,201544192,201554425,10233,821,125
201559981,201558463,201566796,8333,822,125
201572481,201570745,201580028,9283,823,125
201585713,201583977,201593892,9915,824,125
201599359,201597841,201609348,11507,825,125
201615122,201613386,201623302,9916,826,125
201628770,201627251,201635880,8629,827,125
201641348,201639829,201648458,8629,828,125
201653926,201652407,201660740,8333,829,125
201666424,201664689,201673022,8333,830,125
201678490,201676971,201686570,9599,831,125
201692038,201690519,201698853,8334,832,125
201704537,201702802,201711134,8332,833,125
201716818,201715083,201725315,10232,834,125
201731089,201729353,201739269,9916,835,125
201744736,201743218,201752163,8945,836,125
201757847,201756112,201764740,8628,837,125
201770425,201768689,201777951,9262,838,125
201783635,201781900,201792132,10232,839,125
201797905,201796170,201806719,10549,840,125
201812492,201810757,201820356,9599,841,125
201826041,201824305,201833589,9284,842,125
201839273,201837538,201846165,8627,843,125
201851851,201850115,201860348,10233,844,125
201866121,201864386,201874301,9915,845,125
201879838,201878318,201888335,10017,846,125
201894109,201892373,201902923,10550,847,125
201908696,201906961,201916244,9283,848,125
201921779,201920260,201929959,9699,849,125
201935644,201933908,201942853,8945,850,125
201948321,201946802,201957034,10232,851,125
201962591,201961072,201970018,8946,852,125
201975703,201973967,201983567,9600,853,125
201989035,201987516,201996462,8946,854,125
202001996,202000478,202009543,9065,855,125
202015226,202013492,202023090,9598,856,125
202028558,202027039,202037589,10550,857,125
202043213,202041694,202050106,8412,858,125
202055790,202054055,202064604,10549,859,125
202070240,202068721,202078420,9699,860,125
202084105,202082369,202091651,9282,861,125
202097335,202095600,202105515,9915,862,125
202111200,202109464,202118727,9263,863,125
202124194,202122676,202131009,8333,864,125
202136544,202135026,202144408,9382,865,125
202149875,202148357,202157956,9599,866,125
202163641,202161905,202172138,10233,867,125
202177911,202176176,202186091,9915,868,125
202191776,202190040,202199640,9600,869,125
202205108,202203589,202212535,8946,870,125
202218220,202216484,202227034,10550,871,125
202232665,202231147,202241478,10331,872,125
202247252,202245516,202254800,9284,873,125
202260485,202258749,202267693,8944,874,125
202273377,202271642,202279975,8333,875,125
202285659,202283924,202294156,10232,876,125
202299930,202298194,202306823,8629,877,125
202312355,202310836,202318952,8116,878,125
202324636,202322901,202333450,10549,879,125
202339007,202337488,202346117,8629,880,125
202351802,202350066,202359350,9284,881,125
202364882,202363364,202372092,8728,882,125
202377560,202376041,202385641,9600,883,125
202391108,202389590,202399821,10231,884,125
202405377,202403859,202412192,8333,885,125
202417877,202416141,202425424,9283,886,125
202431108,202429373,202439289,9916,887,125
202444974,202443238,202453788,10550,888,125
202459344,202457826,202467107,9281,889,125
202472663,202471144,202480844,9700,890,125
202486529,202484793,202493127,8334,891,125
202498812,202497076,202506358,9282,892,125
202512043,202510307,202519252,8945,893,125
202524798,202523279,202533612,10333,894,125
202539168,202537650,202546594,8944,895,125
202552278,202550543,202560142,9599,896,125
202565826,202564091,202572719,8628,897,125
202578187,202576668,202585613,8945,898,125
202591080,202589562,202599161,9599,899,125
202604845,202603110,202612393,9283,900,125
202618078,202616342,202624972,8630,901,125
202630440,202628921,202637867,8946,902,125
202643551,202641816,202652048,10232,903,125
202657822,202656086,202665369,9283,904,125
202671054,202669318,202678264,8946,905,125
202683734,202682214,202692765,10551,906,125
202698538,202696803,202705431,8628,907,125
202711115,202709380,202719613,10233,908,125
202725386,202723651,202732278,8627,909,125
202737964,202736228,202746778,10550,910,125
202752552,202750816,202760732,9916,911,125
202766279,202764761,202774143,9382,912,125
202779687,202778168,202786897,8729,913,125
202792581,202790846,202801079,10233,914,125
202806713,202805194,202814893,9699,915,125
202820425,202818907,202827319,8412,916,125
202833003,202831268,202841816,10548,917,125
202847589,202845854,202854483,8629,918,125
202860167,202858432,202866765,8333,919,125
202872233,202870714,202879048,8334,920,125
202884734,202882998,202891331,8333,921,125
202897015,202895280,202904224,8944,922,125
202909910,202908174,202917458,9284,923,125
202923143,202921407,202930690,9283,924,125
202936376,202934640,202943586,8946,925,125
202949055,202947536,202956819,9283,926,125
202962503,202960768,202969100,8332,927,125
202974568,202973049,202982333,9284,928,125
202987801,202986283,202994615,8332,929,125
203000299,202998564,203008479,9915,930,125
203014164,203012428,203021373,8945,931,125
203026842,203025323,203034269,8946,932,125
203039955,203038219,203047818,9599,933,125
203053285,203051767,203061366,9599,934,125
203067052,203065316,203075866,10550,935,125
203081422,203079904,203088236,8332,936,125
203093703,203092185,203102101,9916,937,125
203107569,203106050,203115967,9917,938,125
203121652,203119917,203130466,10549,939,125
203136240,203134504,203142838,8334,940,125
203148523,203146788,203157021,10233,941,125
203162794,203161059,203171291,10232,942,125
203177065,203175329,203184613,9284,943,125
203190297,203188562,203197190,8628,944,125
203202874,203201139,203209767,8628,945,125
203215452,203213716,203223000,9284,946,125
203228684,203226949,203236864,9915,947,125
203242331,203240813,203251361,10548,948,125
203256918,203255399,203265949,10550,949,125
203271588,203270069,203279136,9067,950,125
203284821,203283085,203292685,9600,951,125
203298370,203296634,203305263,8629,952,125
203310732,203309212,203319129,9917,953,125
203324814,203323078,203332023,8945,954,125
203337708,203335972,203346521,10549,955,125
203352295,203350559,203359187,8628,956,125
203364872,203363136,203373053,9917,957,125
203378737,203377002,203385335,8333,958,125
203390803,203389284,203398568,9284,959,125
203404252,203402517,203411799,9282,960,125
203417484,203415748,203424694,8946,961,125
203430162,203428643,203437926,9283,962,125
203443610,203441875,203452106,10231,963,125
203457880,203456144,203465428,9284,964,125
203471112,203469377,203479292,9915,965,125
203484976,203483241,203493156,9915,966,125
203498688,203497170,203505898,8728,967,125
203511583,203509847,203518793,8946,968,125
203524478,203522742,203531686,8944,969,125
203537370,203535635,203545867,10232,970,125
203551424,203549905,203560137,10232,971,125
203565910,203564175,203574407,10232,972,125
203580181,203578445,203588678,10233,973,125
203594451,203592716,203602948,10232,974,125
203608505,203606986,203616269,9283,975,125
203621954,203620218,203629164,8946,976,125
203634631,203633113,203643028,9915,977,125
203648495,203646977,203657209,10232,978,125
203662983,203661247,203671796,10549,979,125
203677570,203675834,203686067,10233,980,125
203691840,203690105,203699703,9598,981,125
203705387,203703652,203713568,9916,982,125
203719036,203717517,203727750,10233,983,125
203733375,203731856,203742189,10333,984,125
203747746,203746227,203756460,10233,985,125
203762017,203760498,203771047,10549,986,125
203776693,203775174,203784557,9383,987,125
203790105,203788587,203797968,9381,988,125
203803514,203801996,203811378,9382,989,125
203816846,203815327,203825876,10549,990,125
203831519,203830001,203840016,10015,991,125
203845660,203844142,203852257,8115,992,125
203857941,203856206,203866754,10548,993,125
203872526,203870792,203881023,10231,994,125
203886580,203885061,203893395,8334,995,125
203899079,203897344,203906942,9598,996,125
203912626,203910891,203919836,8945,997,125
203925521,203923785,203932119,8334,998,125
203937804,203936069,203945668,9599,999,125
203951352,203949617,203958900,9283,1000,125
203964673,203962938,203973486,10548,1001,125
203979349,203977613,203988163,10550,1002,125
203994026,203992290,204000919,8629,1003,125
204006692,204004957,204015189,10232,1004,125
204021051,204019316,204028915,9599,1005,125
204034688,204032953,204041898,8945,1006,125
204047671,204045936,204055219,9283,1007,125
204060992,204059257,204069489,10232,1008,125
204075351,204073616,204081948,8332,1009,125
204087505,204085986,204094319,8333,1010,125
204100092,204098357,204106689,8332,1011,125
204112323,204110804,204120820,10016,1012,125
204126683,204124947,204134231,9284,1013,125
204140005,204138269,204148819,10550,1014,125
204154681,204152946,204163179,10233,1015,125
204169042,204167306,204175639,8333,1016,125
204181195,204179677,204189908,10231,1017,125
204195554,204194035,204202664,8629,1018,125
204208220,204206702,204216616,9914,1019,125
204222389,204220654,204228986,8332,1020,125
204234760,204233024,204242307,9283,1021,125
204247945,204246427,204255808,9381,1022,125
204261365,204259846,204270396,10550,1023,125
204276260,204274523,204283470,8947,1024,125
204289243,204287508,204297739,10231,1025,125
204303384,204301866,204310494,8628,1026,125
204316051,204314532,204324765,10233,1027,125
204330627,204328892,204339440,10548,1028,125
204345301,204343566,204352193,8627,1029,125
204357966,204356231,204366780,10549,1030,125
204372425,204370907,204380506,9599,1031,125
204386280,204384544,204393828,9284,1032,125
204399602,204397866,204408099,10233,1033,125
204413961,204412226,204420855,8629,1034,125
204426628,204424893,204435124,10231,1035,125
204440986,204439251,204449483,10232,1036,125
204455129,204453610,204463527,9917,1037,125
204469301,204467565,204475899,8334,1038,125
204481673,204479937,204490170,10233,1039,125
204495884,204494366,204503094,8728,1040,125
204508867,204507132,204516731,9599,1041,125
204522504,204520769,204530685,9916,1042,125
204536241,204534723,204543056,8333,1043,125
204548830,204547094,204557327,10233,1044,125
204563055,204561536,204571551,10015,1045,125
204577413,204575678,204584011,8333,1046,125
204589567,204588049,204597332,9283,1047,125
204602889,204601370,204609999,8629,1048,125
204615556,204614037,204623954,9917,1049,125
204629511,204627992,204636325,8333,1050,125
204642098,204640363,204649646,9283,1051,125
204655267,204653749,204662815,9066,1052,125
204668372,204666853,204675481,8628,1053,125
204681256,204679520,204689119,9599,1054,125
204694676,204693157,204701786,8629,1055,125
204707430,204705911,204716244,10333,1056,125
204722106,204720371,204729969,9598,1057,125
204735742,204734007,204742340,8333,1058,125
204748114,204746379,204755662,9283,1059,125
204761436,204759700,204770250,10550,1060,125
204775896,204774377,204784293,9916,1061,125
204789850,204788332,204796665,8333,1062,125
204802438,204800703,204810301,9598,1063,125
204816073,204814338,204822966,8628,1064,125
204828522,204827003,204836919,9916,1065,125
204842691,204840956,204850238,9282,1066,125
204855793,204854275,204864507,10232,1067,125
204870368,204868633,204877260,8627,1068,125
204882815,204881297,204891212,9915,1069,125
204896768,204895249,204905165,9916,1070,125
204910937,204909202,204917535,8333,1071,125
204923157,204921639,204930365,8726,1072,125
204935986,204934468,204943533,9065,1073,125
204949305,204947570,204957168,9598,1074,125
204962941,204961206,204970489,9283,1075,125
204976129,204974611,204983676,9065,1076,125
204989232,204987714,204996342,8628,1077,125
205002115,205000380,205009325,8945,1078,125
205015097,205013362,205022960,9598,1079,125
205028516,205026998,205035330,8332,1080,125
205041103,205039368,205049917,10549,1081,125
205055779,205054260,205062377,8117,1082,125
205067933,205066415,205076330,9915,1083,125
205081958,205080439,205090455,10016,1084,125
205096316,205094581,205104813,10232,1085,125
205110547,205109027,205117757,8730,1086,125
205123530,205121795,205132026,10231,1087,125
205137888,205136152,205145434,9282,1088,125
205151207,205149472,205158100,8628,1089,125
205163872,205162137,205171081,8944,1090,125
205176854,205175119,205184718,9599,1091,125
205190490,205188755,205197700,8945,1092,125
205203473,205201738,205210071,8333,1093,125
205215844,205214108,205223054,8946,1094,125
205228683,205227165,205236864,9699,1095,125
205242638,205240902,205249848,8946,1096,125
205255404,205253885,205262831,8946,1097,125
205268387,205266869,205275496,8627,1098,125
205281269,205279534,205289765,10231,1099,125
205295626,205293891,205302835,8944,1100,125
205308607,205306872,205317104,10232,1101,125
205322748,205321230,205329562,8332,1102,125
205335209,205333690,205342101,8411,1103,125
205347657,205346138,205356054,9916,1104,125
205361828,205360092,205368426,8334,1105,125
205373982,205372463,205383012,10549,1106,125
205388874,205387139,205395471,8332,1107,125
205401027,205399509,205408454,8945,1108,125
205414076,205412557,205421940,9383,1109,125
205427713,205425978,205434923,8945,1110,125
205440696,205438961,205448243,9282,1111,125
205453799,205452281,205461879,9598,1112,125
205467652,205465917,205474862,8945,1113,125
205480635,205478900,205487233,8333,1114,125
205492788,205491270,205500551,9281,1115,125
205506323,205504588,205513533,8945,1116,125
205519090,205517571,205526199,8628,1117,125
205531973,205530237,205539519,9282,1118,125
205545291,205543556,205554105,10549,1119,125
205559826,205558307,205567036,8729,1120,125
205572593,205571074,205580990,9916,1121,125
205586612,205585093,205593820,8727,1122,125
205599378,205597858,205608408,10550,1123,125
205614269,205612534,205621479,8945,1124,125
205627104,205625585,205634652,9067,1125,125
205640208,205638689,205647318,8629,1126,125
205653091,205651356,205661904,10548,1127,125
205667766,205666031,205674658,8627,1128,125
205680214,205678696,205687639,8943,1129,125
205693260,205691742,205702073,10331,1130,125
205707934,205706199,205715798,9599,1131,125
205721354,205719836,205730385,10549,1132,125
205736247,205734512,205742844,8332,1133,125
205748485,205746967,205757299,10332,1134,125
205763161,205761426,205771341,9915,1135,125
205777114,205775379,205785611,10232,1136,125
205791473,205789737,205800287,10550,1137,125
205805931,205804413,205813040,8627,1138,125
205818669,205817151,205826217,9066,1139,125
205831990,205830255,205838586,8331,1140,125
205844359,205842624,205850956,8332,1141,125
205856729,205854994,205865226,10232,1142,125
205871087,205869352,205879584,10232,1143,125
205885434,205883916,205894246,10330,1144,125
205899890,205898372,205908921,10549,1145,125
205914630,205913112,205922178,9066,1146,125
205927952,205926216,205935816,9600,1147,125
205941453,205939935,205949634,9699,1148,125
205955191,205953672,205962618,8946,1149,125
205968391,205966656,205976888,10232,1150,125
205982749,205981014,205990295,9281,1151,125
205996068,205994333,206004565,10232,1152,125
206010210,206008692,206018924,10232,1153,125
206024786,206023051,206032333,9282,1154,125
206037890,206036371,206045316,8945,1155,125
206050873,206049354,206057983,8629,1156,125
206063757,206062021,206071621,9600,1157,125
206077394,206075659,206084604,8945,1158,125
206090161,206088642,206098874,10232,1159,125
206104520,206103001,206112601,9600,1160,125
206118245,206116726,206126108,9382,1161,125
206131881,206130146,206139428,9282,1162,125
206145202,206143466,206152412,8946,1163,125
206158185,206156450,206166681,10231,1164,125
206172399,206170879,206178996,8117,1165,125
206184770,206183034,206192318,9284,1166,125
206197875,206196356,206206271,9915,1167,125
206212044,206210309,206219908,9599,1168,125
206225465,206223946,206232575,8629,1169,125
206238348,206236613,206245895,9282,1170,125
206251668,206249933,206258265,8332,1171,125
206264038,206262303,206272218,9915,1172,125
206277991,206276256,206286171,9915,1173,125
206291945,206290209,206298542,8333,1174,125
206304098,206302580,206311862,9282,1175,125
206317505,206315987,206324397,8410,1176,125
206329954,206328435,206338668,10233,1177,125
206344530,206342795,206353027,10232,1178,125
206358742,206357223,206365952,8729,1179,125
206371509,206369990,206380539,10549,1180,125
206386395,206384876,206393942,9066,1181,125
206399499,206397980,206407580,9600,1182,125
206413354,206411618,206421535,9917,1183,125
206427092,206425573,206435490,9917,1184,125
206441263,206439528,206447860,8332,1185,125
206453632,206451897,206461813,9916,1186,125
206467452,206465933,206474344,8411,1187,125
206480117,206478382,206486714,8332,1188,125
206492488,206490752,206499381,8629,1189,125
206505153,206503418,206513332,9914,1190,125
206518889,206517370,206526653,9283,1191,125
206532427,206530691,206540291,9600,1192,125
206546065,206544329,206553612,9283,1193,125
206559229,206557711,206567410,9699,1194,125
206573183,206571447,206581680,10233,1195,125
206587542,206586023,206595406,9383,1196,125
206601179,206599444,206607777,8333,1197,125
206613334,206611815,206622364,10549,1198,125
206628226,206626491,206636405,9914,1199,125
206641962,206640443,206649071,8628,1200,125
206654844,206653109,206661442,8333,1201,125
206667071,206665552,206674281,8729,1202,125
206680055,206678319,206686652,8333,1203,125
206692425,206690690,206700922,10232,1204,125
206706784,206705048,206713381,8333,1205,125
206719156,206717419,206726366,8947,1206,125
206731924,206730404,206738738,8334,1207,125
206744358,206742840,206752854,10014,1208,125
206758717,206756981,206765927,8946,1209,125
206771700,206769965,206778297,8332,1210,125
206784071,206782335,206790669,8334,1211,125
206796226,206794707,206804940,10233,1212,125
206810802,206809067,206818012,8945,1213,125
206823785,206822050,206830678,8628,1214,125
206836234,206834716,206843998,9282,1215,125
206849772,206848036,206856665,8629,1216,125
206862438,206860702,206869984,9282,1217,125
206875757,206874022,206882354,8332,1218,125
206887977,206886458,206896791,10333,1219,125
206902513,206900994,206910060,9066,1220,125
206915833,206914098,206924646,10548,1221,125
206930368,206928849,206938231,9382,1222,125
206943788,206942269,206950898,8629,1223,125
206956671,206954936,206964219,9283,1224,125
206969776,206968257,206976886,8629,1225,125
206982442,206980924,206989256,8332,1226,125
206995029,206993294,207002893,9599,1227,125
207008666,207006931,207015875,8944,1228,125
207021648,207019913,207028540,8627,1229,125
207034314,207032578,207042810,10232,1230,125
207048672,207046937,207057486,10549,1231,125
207063130,207061612,207072160,10548,1232,125
207077805,207076287,207084915,8628,1233,125
207090689,207088953,207099501,10548,1234,125
207105147,207103628,207112911,9283,1235,125
207118684,207116949,207125577,8628,1236,125
207131350,207129615,207138243,8628,1237,125
207144016,207142281,207151880,9599,1238,125
207157653,207155918,207166466,10548,1239,125
207172187,207170668,207178785,8117,1240,125
207184409,207182889,207191618,8729,1241,125
207197392,207195656,207204601,8945,1242,125
207210158,207208639,207217585,8946,1243,125
207223359,207221623,207231856,10233,1244,125
207237501,207235983,207246532,10549,1245,125
207252393,207250658,207260890,10232,1246,125
207266752,207265016,207274299,9283,1247,125
207279855,207278337,207287282,8945,1248,125
207293055,207291320,207301551,10231,1249,125
207307197,207305678,207314961,9283,1250,125
207320735,207318999,207329549,10550,1251,125
207335273,207333754,207342821,9067,1252,125
207348378,207346859,207355487,8628,1253,125
207361260,207359525,207370074,10549,1254,125
207375936,207374201,207383800,9599,1255,125
207389574,207387838,207398388,10550,1256,125
207404111,207402592,207411320,8728,1257,125
207417094,207415358,207424303,8945,1258,125
207430076,207428341,207438573,10232,1259,125
207444434,207442699,207451326,8627,1260,125
207457100,207455364,207464963,9599,1261,125
207470520,207469001,207477630,8629,1262,125
207483403,207481668,207490001,8333,1263,125
207495774,207494039,207504271,10232,1264,125
207509917,207508398,207518948,10550,1265,125
207524811,207523075,207532991,9916,1266,125
207538764,207537029,207545974,8945,1267,125
207551747,207550012,207558344,8332,1268,125
207564117,207562382,207570715,8333,1269,125
207576271,207574753,207583086,8333,1270,125
207588859,207587124,207597356,10232,1271,125
207603218,207601483,207610766,9283,1272,125
207616322,207614804,207625351,10547,1273,125
207631213,207629478,207639392,9914,1274,125
207645166,207643430,207653030,9600,1275,125
207658660,207657141,207666840,9699,1276,125
207672614,207670878,207681110,10232,1277,125
207686973,207685237,207694521,9284,1278,125
207700144,207698625,207707690,9065,1279,125
207713464,207711728,207720357,8629,1280,125
207726130,207724395,207733676,9281,1281,125
207739450,207737714,207748264,10550,1282,125
207754127,207752391,207761990,9599,1283,125
207767547,207766028,207774974,8946,1284,125
207780530,207779012,207787956,8944,1285,125
207793730,207791994,207802226,10232,1286,125
207807871,207806353,207815298,8945,1287,125
207820854,207819336,207827964,8628,1288,125
207833588,207832069,207841452,9383,1289,125
207847225,207845490,207856039,10549,1290,125
207861901,207860166,207869447,9281,1291,125
207875004,207873485,207882114,8629,1292,125
207887749,207886230,207894958,8728,1293,125
207900731,207898996,207907940,8944,1294,125
207913497,207911978,207921261,9283,1295,125
207926818,207925299,207935216,9917,1296,125
207940991,207939254,207948854,9600,1297,125
207954626,207952891,207962806,9915,1298,125
207968579,207966844,207976443,9599,1299,125
207982216,207980481,207989426,8945,1300,125
207995199,207993464,208004011,10547,1301,125
208009873,208008138,208016766,8628,1302,125
208022402,208020884,208029000,8116,1303,125
208034772,208033037,208042318,9281,1304,125
208047875,208046356,208055640,9284,1305,125
208061196,208059678,208068306,8628,1306,125
208074080,208072344,208082893,10549,1307,125
208088538,208087019,208096935,9916,1308,125
208102491,208100973,208111522,10549,1309,125
208117384,208115649,208126197,10548,1310,125
208131843,208130324,208140239,9915,1311,125
208146013,208144277,208154827,10550,1312,125
208160550,208159031,208168097,9066,1313,125
208173870,208172135,208180762,8627,1314,125
208186534,208184799,208193744,8945,1315,125
208199517,208197782,208207698,9916,1316,125
208213471,208211736,208221651,9915,1317,125
208227292,208225773,208233890,8117,1318,125
208239663,208237928,208248477,10549,1319,125
208254340,208252604,208260938,8334,1320,125
208266712,208264976,208273605,8629,1321,125
208279243,208277725,208286789,9064,1322,125
208292407,208290888,208300904,10016,1323,125
208306765,208305030,208314313,9283,1324,125
208320085,208318351,208328582,10231,1325,125
208334438,208332920,208341035,8115,1326,125
208346592,208345073,208355623,10550,1327,125
208361485,208359750,208369666,9916,1328,125
208375223,208373704,208384254,10550,1329,125
208390116,208388381,208396714,8333,1330,125
208402487,208400752,208409379,8627,1331,125
208414935,208413417,208423648,10231,1332,125
208429355,208427836,208437536,9700,1333,125
208443309,208441574,208450856,9282,1334,125
208456629,208454894,208465443,10549,1335,125
208471304,208469569,208478197,8628,1336,125
208483970,208482235,208491180,8945,1337,125
208496954,208495218,208504501,9283,1338,125
208510273,208508538,208518453,9915,1339,125
208524226,208522491,208531774,9283,1340,125
208537547,208535812,208544441,8629,1341,125
208549997,208548479,208556811,8332,1342,125
208562584,208560849,208571081,10232,1343,125
208576726,208575207,208585123,9916,1344,125
208590679,208589161,208597492,8331,1345,125
208603265,208601530,208610158,8628,1346,125
208615931,208614196,208623794,9598,1347,125
208629350,208627832,208638380,10548,1348,125
208644106,208642587,208651653,9066,1349,125
208657426,208655691,208664635,8944,1350,125
208670408,208668673,208677956,9283,1351,125
208683729,208681994,208691275,9281,1352,125
208697048,208695313,208704911,9598,1353,125
208710541,208709022,208719354,10332,1354,125
208725075,208723556,208732285,8729,1355,125
208737842,208736323,208746871,10548,1356,125
208752516,208750998,208760597,9599,1357,125
208766154,208764635,208773581,8946,1358,125
208779355,208777619,208788169,10550,1359,125
208794030,208792295,208801578,9283,1360,125
208807351,208805616,208815215,9599,1361,125
208820988,208819253,208827586,8333,1362,125
208833143,208831624,208840570,8946,1363,125
208846212,208844693,208853422,8729,1364,125
208858978,208857460,208866087,8627,1365,125
208871861,208870125,208878458,8333,1366,125
208884232,208882496,208892413,9917,1367,125
208897970,208896451,208906682,10231,1368,125
208912543,208910808,208919753,8945,1369,125
208925309,208923790,208933707,9917,1370,125
208939263,208937745,208947342,9597,1371,125
208953116,208951380,208960326,8946,1372,125
208965882,208964363,208972992,8629,1373,125
208978765,208977030,208985657,8627,1374,125
208991213,208989695,208998977,9282,1375,125
209004750,209003015,209013247,10232,1376,125
209018893,209017374,209026974,9600,1377,125
209032748,209031012,209039640,8628,1378,125
209045197,209043678,209053595,9917,1379,125
209059214,209057695,209066424,8729,1380,125
209072196,209070462,209078794,8332,1381,125
209084567,209082832,209092430,9598,1382,125
209098203,209096468,209107016,10548,1383,125
209112727,209111208,209120590,9382,1384,125
209126363,209124628,209133573,8945,1385,125
209139346,209137611,209148160,10549,1386,125
209153806,209152287,209162519,10232,1387,125
209168164,209166646,209175928,9282,1388,125
209181701,209179966,209188594,8628,1389,125
209194233,209192714,209201443,8729,1390,125
209207216,209205481,209213814,8333,1391,125
209219371,209217852,209227135,9283,1392,125
209232779,209231259,209239673,8414,1393,125
209245446,209243711,209252339,8628,1394,125
209257895,209256377,209265321,8944,1395,125
209270878,209269359,209279276,9917,1396,125
209285049,209283314,209292913,9599,1397,125
209298469,209296951,209307182,10231,1398,125
209312903,209311384,209319796,8412,1399,125
209325431,209323912,209333611,9699,1400,125
209339166,209337649,209348196,10547,1401,125
209354057,209352322,209362238,9916,1402,125
209368012,209366276,209375222,8946,1403,125
209380995,209379260,209388542,9282,1404,125
209394099,209392580,209400913,8333,1405,125
209406551,209405032,209415364,10332,1406,125
209421226,209419491,209428119,8628,1407,125
209433892,209432157,209441101,8944,1408,125
209446657,209445139,209454738,9599,1409,125
209460511,209458776,209467721,8945,1410,125
209473495,209471759,209481043,9284,1411,125
209486816,209485081,209495313,10232,1412,125
209500958,209499440,209509356,9916,1413,125
209515130,209513394,209522023,8629,1414,125
209527796,209526061,209536609,10548,1415,125
209542472,209540953,209550651,9698,1416,125
209556424,209554689,209563633,8944,1417,125
209569189,209567671,209577902,10231,1418,125
209583547,209582029,209591627,9598,1419,125
209597402,209595666,209604296,8630,1420,125
209609940,209608421,209618121,9700,1421,125
209623894,209622159,209630492,8333,1422,125
209636136,209634617,209644000,9383,1423,125
209649773,209648038,209656666,8628,1424,125
209662439,209660704,209669037,8333,1425,125
209674654,209673135,209682517,9382,1426,125
209688074,209686555,209697104,10549,1427,125
209702966,209701231,209709859,8628,1428,125
209715632,209713897,209724444,10547,1429,125
209730089,209728571,209739119,10548,1430,125
209744763,209743245,209751873,8628,1431,125
209757430,209755911,209766144,10233,1432,125
209771872,209770353,209780684,10331,1433,125
209786540,209785022,209794088,9066,1434,125
209799645,209798126,209807071,8945,1435,125
209812712,209811193,209819605,8412,1436,125
209825377,209823642,209832586,8944,1437,125
209838359,209836624,209846856,10232,1438,125
209852717,209850982,209859927,8945,1439,125
209865700,209863965,209874197,10232,1440,125
209879843,209878324,209887607,9283,1441,125
209893380,209891645,209902194,10549,1442,125
209908056,209906320,209915919,9599,1443,125
209921475,209919957,209929555,9598,1444,125
209935198,209933679,209943378,9699,1445,125
209948934,209947415,209955747,8332,1446,125
209961519,209959784,209970016,10232,1447,125
209975660,209974142,209984374,10232,1448,125
209990019,209988500,209998733,10233,1449,125
210004594,210002859,210013091,10232,1450,125
210018953,210017217,210027449,10232,1451,125
210033094,210031575,210041490,9915,1452,125
210047046,210045528,210055127,9599,1453,125
210060899,210059164,210069395,10231,1454,125
210075242,210073723,210083423,9700,1455,125
210089045,210087527,210096908,9381,1456,125
210102464,210100945,210110861,9916,1457,125
210116417,210114899,210123526,8627,1458,125
210129082,210127563,210136508,8945,1459,125
210142280,210140545,210148877,8332,1460,125
210154650,210152914,210163464,10550,1461,125
210169108,210167590,210177505,9915,1462,125
210183278,210181543,210192092,10549,1463,125
210197737,210196218,210204551,8333,1464,125
210210107,210208589,210217533,8944,1465,125
210223306,210221570,210230199,8629,1466,125
210235973,210234237,210243183,8946,1467,125
210248956,210247221,210257769,10548,1468,125
210263631,210261895,210272128,10233,1469,125
210277990,210276254,210285854,9600,1470,125
210291627,210289892,210299174,9282,1471,125
210304947,210303212,210313444,10232,1472,125
210319089,210317570,210326516,8946,1473,125
210332072,210330554,210340469,9915,1474,125
210346243,210344507,210353790,9283,1475,125
210359562,210357827,210368376,10549,1476,125
210374106,210372588,210382287,9699,1477,125
210388061,210386325,210394659,8334,1478,125
210400214,210398696,210408611,9915,1479,125
210414168,210412649,210421594,8945,1480,125
210427368,210425632,210435231,9599,1481,125
210440787,210439268,210448867,9599,1482,125
210454506,210452988,210462370,9382,1483,125
210468143,210466408,210476640,10232,1484,125
210482359,210480840,210490223,9383,1485,125
210495864,210494345,210503073,8728,1486,125
210508630,210507111,210515740,8629,1487,125
210521366,210519847,210528912,9065,1488,125
210534684,210532949,210542864,9915,1489,125
210548637,210546902,210555847,8945,1490,125
210561619,210559884,210569483,9599,1491,125
210575125,210573606,210583622,10016,1492,125
210589266,210587748,210597347,9599,1493,125
210603119,210601385,210610982,9597,1494,125
210616754,210615019,210625567,10548,1495,125
210631428,210629693,210639925,10232,1496,125
210645787,210644051,210653334,9283,1497,125
210659106,210657371,210667602,10231,1498,125
210673463,210671728,210682277,10549,1499,125
210688139,210686404,210696952,10548,1500,125
210702813,210701078,210711310,10232,1501,125
210716955,210715436,210725036,9600,1502,125
210730809,210729073,210738019,8946,1503,125
210743576,210742057,210751657,9600,1504,125
210757213,210755695,210764977,9282,1505,125
210770749,210769014,210779563,10549,1506,125
210785425,210783690,210793606,9916,1507,125
210799162,210797644,210807558,9914,1508,125
210813331,210811596,210821511,9915,1509,125
210827284,210825548,210835464,9916,1510,125
210841237,210839502,210848131,8629,1511,125
210853904,210852169,210862085,9916,1512,125
210867858,210866123,210875404,9281,1513,125
210881178,210879442,210888388,8946,1514,125
210894162,210892426,210901055,8629,1515,125
210906828,210905093,210915640,10547,1516,125
210921502,210919767,210929366,9599,1517,125
210935139,210933404,210943003,9599,1518,125
210948776,210947041,210956640,9599,1519,125
210962285,210960767,210970466,9699,1520,125
210976097,210974579,210983961,9382,1521,125
210989734,210987999,210996332,8333,1522,125
211001889,211000370,211010920,10550,1523,125
211016781,211015046,211025278,10232,1524,125
211031141,211029405,211038034,8629,1525,125
211043590,211042072,211052619,10547,1526,125
211058347,211056829,211066528,9699,1527,125
211072300,211070565,211079192,8627,1528,125
211084965,211083230,211093146,9916,1529,125
211098919,211097184,211107733,10549,1530,125
211113378,211111859,211121775,9916,1531,125
211127549,211125813,211135097,9284,1532,125
211140870,211139135,211149051,9916,1533,125
211154824,211153088,211161421,8333,1534,125
211166977,211165458,211175058,9600,1535,125
211180614,211179095,211188694,9599,1536,125
211194251,211192732,211203282,10550,1537,125
211208993,211207475,211216540,9065,1538,125
211222312,211220577,211229205,8628,1539,125
211234979,211233243,211241577,8334,1540,125
211247350,211245614,211255846,10232,1541,125
211261686,211260167,211269866,9699,1542,125
211275422,211273903,211284135,10232,1543,125
211289996,211288261,211298810,10549,1544,125
211304672,211302936,211313486,10550,1545,125
211319192,211317673,211327056,9383,1546,125
211332829,211331094,211339427,8333,1547,125
211345200,211343465,211352093,8628,1548,125
211357650,211356131,211366363,10232,1549,125
211372225,211370490,211380088,9598,1550,125
211385644,211384125,211393070,8945,1551,125
211398844,211397108,211407657,10549,1552,125
211413519,211412000,211420412,8412,1553,125
211426185,211424449,211434997,10548,1554,125
211440723,211439204,211447321,8117,1555,125
211452944,211451425,211460808,9383,1556,125
211466581,211464846,211473790,8944,1557,125
211479428,211477909,211487924,10015,1558,125
211493786,211492267,211501967,9700,1559,125
211507586,211506067,211516083,10016,1560,125
211521944,211520209,211528837,8628,1561,125
211534393,211532874,211543423,10549,1562,125
211549284,211547549,211558098,10549,1563,125
211563809,211562291,211572306,10015,1564,125
211577950,211576432,211585377,8945,1565,125
211591150,211589414,211599330,9916,1566,125
211605103,211603368,211611995,8627,1567,125
211617551,211616032,211632667,16635,1568,125
211638517,211636998,211645115,8117,1569,125
211650888,211649153,211658098,8945,1570,125
211663655,211662136,211671419,9283,1571,125
211677192,211675457,211684739,9282,1572,125
211690513,211688777,211697111,8334,1573,125
211702883,211701148,211709776,8628,1574,125
211715398,211713879,211722944,9065,1575,125
211728718,211726982,211737532,10550,1576,125
211743376,211741858,211750924,9066,1577,125
211756698,211754962,211764246,9284,1578,125
211770019,211768284,211778832,10548,1579,125
211784536,211783017,211793033,10016,1580,125
211798677,211797159,211807707,10548,1581,125
211813353,211811834,211820779,8945,1582,125
211826422,211824904,211833969,9065,1583,125
211839743,211838007,211847606,9599,1584,125
211853380,211851644,211861561,9917,1585,125
211867117,211865599,211874544,8945,1586,125
211880318,211878582,211887210,8628,1587,125
211892983,211891248,211901162,9914,1588,125
211906935,211905200,211913533,8333,1589,125
211919306,211917571,211926198,8627,1590,125
211931972,211930236,211940152,9916,1591,125
211945926,211944190,211952524,8334,1592,125
211958158,211956639,211966654,10015,1593,125
211972517,211970781,211981013,10232,1594,125
211986874,211985139,211994084,8945,1595,125
211999640,211998121,212008670,10549,1596,125
212014524,212013005,212023338,10333,1597,125
212028983,212027464,212037697,10233,1598,125
212043413,212041894,212050959,9065,1599,125
212056732,212054996,212063625,8629,1600,125
212069398,212067663,212076946,9283,1601,125
212082583,212081064,212090129,9065,1602,125
212095902,212094167,212103112,8945,1603,125
212108886,212107150,212117383,10233,1604,125
212123245,212121510,212130792,9282,1605,125
212136349,212134831,212144746,9915,1606,125
212150520,212148784,212158383,9599,1607,125
212164156,212162421,212171703,9282,1608,125
212177477,212175742,212186291,10549,1609,125
212191997,212190478,212198595,8117,1610,125
212204369,212202633,212211916,9283,1611,125
212217473,212215954,212224583,8629,1612,125
212230357,212228621,212237567,8946,1613,125
212243341,212241606,212252154,10548,1614,125
212258017,212256281,212266513,10232,1615,125
212272159,212270640,212280872,10232,1616,125
212286518,212284999,212294598,9599,1617,125
212300220,212298701,212309033,10332,1618,125
212314895,212313160,212323392,10232,1619,125
212329255,212327519,212336465,8946,1620,125
212342022,212340503,212348837,8334,1621,125
212354393,212352875,212361820,8945,1622,125
212367593,212365858,212376090,10232,1623,125
212381797,212380279,212389345,9066,1624,125
212395119,212393383,212403300,9917,1625,125
212408856,212407338,212415671,8333,1626,125
212421444,212419709,212430256,10547,1627,125
212436116,212434597,212444928,10331,1628,125
212450790,212449055,212459604,10549,1629,125
212465467,212463731,212473015,9284,1630,125
212478571,212477053,212486652,9599,1631,125
212492273,212490754,212499482,8728,1632,125
212505256,212503520,212513119,9599,1633,125
212518676,212517157,212526440,9283,1634,125
212532214,212530478,212538811,8333,1635,125
212544586,212542850,212552132,9282,1636,125
212557777,212556258,212565324,9066,1637,125
212571099,212569363,212578309,8946,1638,125
212584083,212582347,212591630,9283,1639,125
212597403,212595669,212604951,9282,1640,125
212610724,212608989,212617933,8944,1641,125
212623707,212621971,212630600,8629,1642,125
212636157,212634638,212643584,8946,1643,125
212649357,212647622,212655955,8333,1644,125
212661729,212659994,212669592,9598,1645,125
212675367,212673631,212683864,10233,1646,125
212689726,212687991,212697590,9599,1647,125
212703236,212701717,212712050,10333,1648,125
212717696,212716177,212724511,8334,1649,125
212730142,212728624,212738955,10331,1650,125
212744818,212743082,212751711,8629,1651,125
212757485,212755749,212765348,9599,1652,125
212771122,212769386,212778015,8629,1653,125
212783788,212782053,212791969,9916,1654,125
212797743,212796008,212804341,8333,1655,125
212809899,212808379,212818612,10233,1656,125
212824475,212822739,212832023,9284,1657,125
212837579,212836061,212844394,8333,1658,125
212849950,212848432,212858031,9599,1659,125
212863588,212862069,212872618,10549,1660,125
212878342,212876823,212884939,8116,1661,125
212890713,212888977,212898577,9600,1662,125
212904350,212902615,212910948,8333,1663,125
212916581,212915063,212923179,8116,1664,125
212928737,212927217,212937767,10550,1665,125
212943413,212941894,212951177,9283,1666,125
212956951,212955216,212963844,8628,1667,125
212969401,212967882,212978115,10233,1668,125
212983961,212982443,212992142,9699,1669,125
212997916,212996180,213005779,9599,1670,125
213011417,213009898,213019914,10016,1671,125
213025559,213024041,213033639,9598,1672,125
213039413,213037677,213046623,8946,1673,125
213052396,213050661,213060893,10232,1674,125
213066755,213065020,213075252,10232,1675,125
213081114,213079379,213088977,9598,1676,125
213094750,213093015,213101960,8945,1677,125
213107734,213105998,213116231,10233,1678,125
213122093,213120358,213130273,9915,1679,125
213135829,213134311,213144542,10231,1680,125
213150248,213148729,213159061,10332,1681,125
213164924,213163188,213172133,8945,1682,125
213177772,213176252,213184369,8117,1683,125
213190142,213188407,213198639,10232,1684,125
213204284,213202766,213212998,10232,1685,125
213218861,213217342,213225459,8117,1686,125
213231232,213229497,213240046,10549,1687,125
213245908,213244173,213254404,10231,1688,125
213260050,213258531,213267477,8946,1689,125
213273250,213271515,213279847,8332,1690,125
213285621,213283885,213294435,10550,1691,125
213300279,213298760,213309092,10332,1692,125
213314954,213313219,213322818,9599,1693,125
213328462,213326944,213336959,10015,1694,125
213342822,213341086,213349715,8629,1695,125
213355332,213353814,213363829,10015,1696,125
213369692,213367956,213377873,9917,1697,125
213383647,213381911,213392144,10233,1698,125
213398006,213396271,213404604,8333,1699,125
213410377,213408642,213418556,9914,1700,125
213424112,213422594,213431876,9282,1701,125
213437650,213435914,213445829,9915,1702,125
213451471,213449952,213458069,8117,1703,125
213463843,213462107,213470441,8334,1704,125
213476214,213474479,213483760,9281,1705,125
213489317,213487798,213496132,8334,1706,125
213501688,213500170,213509452,9282,1707,125
213515225,213513490,213523405,9915,1708,125
213529043,213527525,213536907,9382,1709,125
213542463,213540945,213550227,9282,1710,125
213556001,213554265,213564815,10550,1711,125
213570678,213568942,213579175,10233,1712,125
213585037,213583302,213593533,10231,1713,125
213599395,213597660,213607892,10232,1714,125
213613754,213612019,213620964,8945,1715,125
213626737,213625002,213634283,9281,1716,125
213639840,213638321,213647604,9283,1717,125
213653161,213651642,213659975,8333,1718,125
213665595,213664076,213672488,8412,1719,125
213678261,213676526,213686758,10232,1720,125
213692620,213690885,213701117,10232,1721,125
213706979,213705244,213715792,10548,1722,125
213721639,213720120,213729502,9382,1723,125
213735275,213733540,213743454,9914,1724,125
213749228,213747492,213755826,8334,1725,125
213761383,213759865,213769146,9281,1726,125
213774920,213773185,213781518,8333,1727,125
213787075,213785556,213794501,8945,1728,125
213800276,213798540,213807486,8946,1729,125
213813259,213811524,213821122,9598,1730,125
213826896,213825160,213835076,9916,1731,125
213840850,213839114,213849347,10233,1732,125
213855209,213853474,213863706,10232,1733,125
213869351,213867833,213876166,8333,1734,125
213881723,213880204,213890754,10550,1735,125
213896400,213894881,213904481,9600,1736,125
213910038,213908519,213918436,9917,1737,125
213924211,213922475,213931419,8944,1738,125
213937193,213935457,213946007,10550,1739,125
213951869,213950134,213959416,9282,1740,125
213964972,213963454,213971786,8332,1741,125
213977343,213975824,213985740,9916,1742,125
213991513,213989778,213998405,8627,1743,125
214004047,214002528,214012861,10333,1744,125
214018724,214016988,214025934,8946,1745,125
214031707,214029972,214039571,9599,1746,125
214045346,214043610,214053527,9917,1747,125
214059302,214057566,214066512,8946,1748,125
214072287,214070551,214079834,9283,1749,125
214085392,214083873,214092207,8334,1750,125
214097980,214096245,214106160,9915,1751,125
214111933,214110198,214118531,8333,1752,125
214124305,214122570,214132486,9916,1753,125
214138260,214136524,214145808,9284,1754,125
214151582,214149846,214160078,10232,1755,125
214165724,214164205,214173487,9282,1756,125
214179043,214177525,214185858,8333,1757,125
214191632,214189897,214199179,9282,1758,125
214204954,214203218,214213134,9916,1759,125
214218691,214217173,214225801,8628,1760,125
214231576,214229840,214240390,10550,1761,125
214246036,214244517,214253462,8945,1762,125
214259236,214257500,214267417,9917,1763,125
214273191,214271456,214280738,9282,1764,125
214286383,214284865,214293592,8727,1765,125
214299367,214297631,214305965,8334,1766,125
214311739,214310004,214319919,9915,1767,125
214325476,214323957,214332290,8333,1768,125
214337848,214336329,214346879,10550,1769,125
214352742,214351006,214361239,10233,1770,125
214366886,214365367,214373700,8333,1771,125
214379257,214377738,214387971,10233,1772,125
214393686,214392167,214401234,9067,1773,125
214407007,214405272,214415821,10549,1774,125
214421538,214420020,214429086,9066,1775,125
214434859,214433124,214443672,10548,1776,125
214449317,214447799,214458348,10549,1777,125
214464211,214462692,214471104,8412,1778,125
214476878,214475143,214485691,10548,1779,125
214491553,214489818,214498763,8945,1780,125
214504405,214502886,214511614,8728,1781,125
214517171,214515653,214523986,8333,1782,125
214529542,214528024,214537305,9281,1783,125
214542862,214541343,214551258,9915,1784,125
214556880,214555361,214565694,10333,1785,125
214571339,214569821,214579103,9282,1786,125
214584877,214583142,214593058,9916,1787,125
214598833,214597097,214606380,9283,1788,125
214612154,214610418,214620968,10550,1789,125
214626614,214625095,214633724,8629,1790,125
214639499,214637763,214646096,8333,1791,125
214651870,214650134,214659733,9599,1792,125
214665290,214663771,214674321,10550,1793,125
214680184,214678448,214687731,9283,1794,125
214693289,214691770,214701685,9915,1795,125
214707459,214705724,214715323,9599,1796,125
214721098,214719362,214729278,9916,1797,125
214734905,214733387,214743085,9698,1798,125
214748642,214747123,214755752,8629,1799,125
214761308,214759790,214770021,10231,1800,125
214775728,214774209,214784224,10015,1801,125
214789870,214788351,214797295,8944,1802,125
214803069,214801334,214810933,9599,1803,125
214816560,214815041,214823770,8729,1804,125
214829545,214827809,214838042,10233,1805,125
214843898,214842379,214852395,10016,1806,125
214858041,214856522,214866122,9600,1807,125
214871680,214870161,214878790,8629,1808,125
214884563,214882828,214891456,8628,1809,125
214897230,214895495,214904440,8945,1810,125
214910214,214908479,214917424,8945,1811,125
214923043,214921524,214931540,10016,1812,125
214937403,214935668,214946217,10549,1813,125
214952080,214950345,214958973,8628,1814,125
214964748,214963012,214972296,9284,1815,125
214978070,214976335,214984962,8627,1816,125
214990735,214989000,214999232,10232,1817,125
215004948,215003429,215013128,9699,1818,125
215018758,215017238,215025651,8413,1819,125
215031424,215029689,215038318,8629,1820,125
215043875,215042357,215052272,9915,1821,125
215058046,215056310,215065255,8945,1822,125
215070812,215069293,215078891,9598,1823,125
215084665,215082929,215092529,9600,1824,125
215098302,215096567,215106482,9915,1825,125
215112255,215110520,215120752,10232,1826,125
215126598,215125079,215133808,8729,1827,125
215139450,215137932,215146659,8727,1828,125
215152432,215150697,215161246,10549,1829,125
215166962,215165443,215175143,9700,1830,125
215180916,215179181,215187808,8627,1831,125
215193366,215191847,215201447,9600,1832,125
215207004,215205485,215213819,8334,1833,125
215219592,215217857,215226190,8333,1834,125
215231963,215230228,215239827,9599,1835,125
215245385,215243866,215252199,8333,1836,125
215257972,215256237,215266786,10549,1837,125
215272633,215271114,215279231,8117,1838,125
215285005,215283270,215292552,9282,1839,125
215298326,215296590,215306507,9917,1840,125
215312280,215310545,215321093,10548,1841,125
215326739,215325220,215333849,8629,1842,125
215339624,215337888,215346516,8628,1843,125
215352289,215350554,215360469,9915,1844,125
215366242,215364507,215374106,9599,1845,125
215379879,215378144,215387089,8945,1846,125
215392863,215391127,215400073,8946,1847,125
215405629,215404111,215413709,9598,1848,125
215419346,215417827,215427527,9700,1849,125
215433301,215431565,215441481,9916,1850,125
215447254,215445519,215454464,8945,1851,125
215460239,215458503,215466837,8334,1852,125
215472394,215470875,215480475,9600,1853,125
215486249,215484513,215493141,8628,1854,125
215498914,215497179,215505807,8628,1855,125
215511365,215509846,215520078,10232,1856,125
215525724,215524205,215533488,9283,1857,125
215539112,215537594,215546005,8411,1858,125
215551779,215550044,215558672,8628,1859,125
215564230,215562711,215571340,8629,1860,125
215577115,215575379,215584979,9600,1861,125
215590752,215589017,215598300,9283,1862,125
215603857,215602338,215611938,9600,1863,125
215617711,215615976,215625575,9599,1864,125
215631347,215629613,215638895,9282,1865,125
215644669,215642933,215651562,8629,1866,125
215657335,215655600,215663932,8332,1867,125
215669490,215667971,215677570,9599,1868,125
215683344,215681609,215691841,10232,1869,125
215697703,215695968,215705251,9283,1870,125
215711024,215709289,215718572,9283,1871,125
215724345,215722610,215733159,10549,1872,125
215739022,215737286,215747836,10550,1873,125
215753481,215751963,215760295,8332,1874,125
215766069,215764334,215773279,8945,1875,125
215778836,215777317,215787549,10232,1876,125
215793283,215791764,215800176,8412,1877,125
215805949,215804214,215814446,10232,1878,125
215820292,215818774,215827839,9065,1879,125
215833396,215831877,215842109,10232,1880,125
215847971,215846236,215854569,8333,1881,125
215860343,215858608,215868206,9598,1882,125
215873830,215872312,215882644,10332,1883,125
215888506,215886771,215895715,8944,1884,125
215901353,215899835,215909217,9382,1885,125
215914991,215913256,215922855,9599,1886,125
215928630,215926894,215937126,10232,1887,125
215942771,215941253,215950850,9597,1888,125
215956625,215954889,215963518,8629,1889,125
215969075,215967557,215975889,8332,1890,125
215981447,215979928,215988557,8629,1891,125
215994332,215992596,216002829,10233,1892,125
216008691,216006956,216016238,9282,1893,125
216022011,216020276,216030191,9915,1894,125
216035837,216034318,216043045,8727,1895,125
216048602,216047084,216057633,10549,1896,125
216063278,216061760,216071991,10231,1897,125
216077853,216076118,216084451,8333,1898,125
216090008,216088489,216098089,9600,1899,125
216103645,216102127,216110755,8628,1900,125
216116401,216114882,216123294,8412,1901,125
216129068,216127333,216137249,9916,1902,125
216142807,216141288,216150888,9600,1903,125
216156661,216154926,216164842,9916,1904,125
216170399,216168881,216177509,8628,1905,125
216183283,216181547,216190831,9284,1906,125
216196388,216194870,216205102,10232,1907,125
216210748,216209229,216218828,9599,1908,125
216224603,216222867,216231812,8945,1909,125
216237369,216235851,216244479,8628,1910,125
216250037,216248518,216257463,8945,1911,125
216263238,216261502,216270785,9283,1912,125
216276341,216274823,216283450,8627,1913,125
216289006,216287488,216296770,9282,1914,125
216302543,216300808,216309140,8332,1915,125
216314696,216313178,216323410,10232,1916,125
216329141,216327622,216337321,9699,1917,125
216343094,216341359,216351908,10549,1918,125
216357553,216356035,216366583,10548,1919,125
216372446,216370710,216380310,9600,1920,125
216386083,216384348,216394580,10232,1921,125
216400300,216398781,216408796,10015,1922,125
216414500,216412981,216422047,9066,1923,125
216427604,216426086,216436635,10549,1924,125
216442497,216440762,216449706,8944,1925,125
216455263,216453744,216462373,8629,1926,125
216467931,216466412,216475041,8629,1927,125
216480815,216479079,216489629,10550,1928,125
216495492,216493756,216503672,9916,1929,125
216509229,216507710,216518259,10549,1930,125
216523904,216522386,216531014,8628,1931,125
216536787,216535052,216545284,10232,1932,125
216551147,216549411,216559644,10233,1933,125
216565290,216563771,216572104,8333,1934,125
216577877,216576142,216586374,10232,1935,125
216592237,216590501,216600101,9600,1936,125
216605874,216604139,216612472,8333,1937,125
216618029,216616510,216626426,9916,1938,125
216632200,216630464,216640696,10232,1939,125
216646536,216645018,216653428,8410,1940,125
216658986,216657467,216667382,9915,1941,125
216673156,216671420,216681653,10233,1942,125
216687515,216685780,216695378,9598,1943,125
216701151,216699416,216709015,9599,1944,125
216714788,216713054,216722969,9915,1945,125
216728743,216727007,216737240,10233,1946,125
216743102,216741367,216751916,10549,1947,125
216757778,216756043,216765326,9283,1948,125
216770884,216769365,216777699,8334,1949,125
216783472,216781737,216791969,10232,1950,125
216797832,216796096,216804430,8334,1951,125
216810204,216808469,216818385,9916,1952,125
216824159,216822424,216831368,8944,1953,125
216836924,216835406,216844034,8628,1954,125
216849809,216848073,216858623,10550,1955,125
216864347,216862828,216871240,8412,1956,125
216876797,216875278,216885511,10233,1957,125
216891221,216889702,216898113,8411,1958,125
216903886,216902151,216910483,8332,1959,125
216916257,216914522,216924437,9915,1960,125
216930210,216928475,216939024,10549,1961,125
216944863,216943344,216952073,8729,1962,125
216957847,216956112,216964445,8333,1963,125
216970218,216968483,216977766,9283,1964,125
216983539,216981804,216991087,9283,1965,125
216996861,216995125,217004408,9283,1966,125
217010182,217008447,217018046,9599,1967,125
217023821,217022085,217030418,8333,1968,125
217036065,217034546,217043612,9066,1969,125
217049387,217047651,217058200,10549,1970,125
217064062,217062327,217072559,10232,1971,125
217078205,217076687,217087235,10548,1972,125
217093095,217091577,217099692,8115,1973,125
217105465,217103730,217112358,8628,1974,125
217118132,217116396,217126946,10550,1975,125
217132591,217131073,217139700,8627,1976,125
217145473,217143738,217152366,8628,1977,125
217157922,217156404,217166953,10549,1978,125
217172815,217171080,217179412,8332,1979,125
217185185,217183450,217193048,9598,1980,125
217198821,217197086,217206030,8944,1981,125
217211804,217210068,217219351,9283,1982,125
217224987,217223468,217232850,9382,1983,125
217238625,217236889,217245835,8946,1984,125
217251470,217249951,217259967,10016,1985,125
217265830,217264094,217274010,9916,1986,125
217279783,217278048,217286677,8629,1987,125
217292304,217290786,217299513,8727,1988,125
217305134,217303615,217311732,8117,1989,125
217317505,217315770,217325368,9598,1990,125
217331142,217329406,217339956,10550,1991,125
217345796,217344277,217353006,8729,1992,125
217358779,217357044,217366643,9599,1993,125
217372417,217370681,217381231,10550,1994,125
217387093,217385358,217393986,8628,1995,125
217399760,217398025,217407308,9283,1996,125
217413082,217411347,217421263,9916,1997,125
217426819,217425301,217433928,8627,1998,125
217439703,217437967,217447566,9599,1999,125
217453340,217451605,217462154,10549,2000,125
217468017,217466282,217476514,10232,2001,125
217482249,217480730,217489459,8729,2002,125
217495233,217493498,217503096,9598,2003,125
217508871,217507135,217517051,9916,2004,125
217522825,217521090,217529718,8628,2005,125
217535275,217533757,217543040,9283,2006,125
217548660,217547141,217555554,8413,2007,125
217561112,217559593,217569192,9599,2008,125
217574750,217573231,217582176,8945,2009,125
217587950,217586215,217596131,9916,2010,125
217601688,217600170,217610718,10548,2011,125
217616580,217614845,217623789,8944,2012,125
217629347,217627828,217637744,9916,2013,125
217643518,217641783,217651382,9599,2014,125
217657156,217655420,217665969,10549,2015,125
217671831,217670096,217678724,8628,2016,125
217684498,217682762,217692994,10232,2017,125
217698641,217697122,217707354,10232,2018,125
217713217,217711482,217722030,10548,2019,125
217727677,217726158,217735440,9282,2020,125
217741076,217739558,217749257,9699,2021,125
217755032,217753296,217761629,8333,2022,125
217767403,217765667,217776216,10549,2023,125
217781944,217780426,217790125,9699,2024,125
217795761,217794242,217803307,9065,2025,125
217809082,217807346,217817579,10233,2026,125
217823443,217821707,217830991,9284,2027,125
217836638,217835119,217843848,8729,2028,125
217849622,217847887,217856515,8628,2029,125
217862073,217860554,217870471,9917,2030,125
217876103,217874584,217882996,8412,2031,125
217888771,217887035,217897585,10550,2032,125
217903448,217901713,217910996,9283,2033,125
217916554,217915035,217925268,10233,2034,125
217931131,217929612,217938995,9383,2035,125
217944552,217943033,217952316,9283,2036,125
217958090,217956355,217964983,8628,2037,125
217970756,217969021,217977649,8628,2038,125
217983423,217981688,217990633,8945,2039,125
217996190,217994672,218003954,9282,2040,125
218009729,218007993,218016939,8946,2041,125
218022713,218020978,218031209,10231,2042,125
218037072,218035337,218045569,10232,2043,125
218051432,218049697,218059612,9915,2044,125
218065387,218063651,218072935,9284,2045,125
218078709,218076974,218087206,10232,2046,125
218092853,218091334,218101566,10232,2047,125
218107423,218105905,218116237,10332,2048,125
218122101,218120365,218130915,10550,2049,125
218136777,218135042,218144641,9599,2050,125
218150199,218148680,218159230,10550,2051,125
218164877,218163358,218172303,8945,2052,125
218177926,218176407,218184819,8412,2053,125
218190593,218188858,218199407,10549,2054,125
218205269,218203534,218212817,9283,2055,125
218218592,218216856,218227406,10550,2056,125
218233052,218231534,218239866,8332,2057,125
218245641,218243905,218252534,8629,2058,125
218258308,218256573,218265518,8945,2059,125
218271076,218269557,218279157,9600,2060,125
218284931,218283196,218293744,10548,2061,125
218299607,218297872,218307788,9916,2062,125
218313346,218311827,218320773,8946,2063,125
218326548,218324812,218333757,8945,2064,125
218339532,218337796,218348345,10549,2065,125
218354209,218352473,218362073,9600,2066,125
218367630,218366112,218374444,8332,2067,125
218380002,218378483,218388083,9600,2068,125
218393857,218392122,218400455,8333,2069,125
218406230,218404494,218414410,9916,2070,125
218420044,218418525,218428857,10332,2071,125
218434719,218432984,218441612,8628,2072,125
218447387,218445651,218455883,10232,2073,125
218461746,218460011,218470560,10549,2074,125
218476422,218474687,218484919,10232,2075,125
218490565,218489047,218498963,9916,2076,125
218504737,218503002,218512283,9281,2077,125
218517841,218516322,218526555,10233,2078,125
218532201,218530683,218541230,10547,2079,125
218546951,218545432,218555764,10332,2080,125
218561626,218559891,218568519,8628,2081,125
218574293,218572558,218582157,9599,2082,125
218587932,218586196,218594825,8629,2083,125
218600383,218598864,218608464,9600,2084,125
218614095,218612576,218622276,9700,2085,125
218627834,218626315,218634943,8628,2086,125
218640500,218638982,218649531,10549,2087,125
218655178,218653659,218662287,8628,2088,125
218668062,218666326,218674660,8334,2089,125
218680218,218678699,218688616,9917,2090,125
218694391,218692655,218701601,8946,2091,125
218707376,218705640,218714586,8946,2092,125
218720144,218718625,218729175,10550,2093,125
218735039,218733303,218743535,10232,2094,125
218749181,218747662,218756608,8946,2095,125
218762382,218760647,218770246,9599,2096,125
218776020,218774285,218782618,8333,2097,125
218788244,218786725,218796424,9699,2098,125
218802198,218800463,218810695,10232,2099,125
218816557,218815039,218823767,8728,2100,125
218829324,218827806,218836433,8627,2101,125
218842208,218840472,218850705,10233,2102,125
218856568,218854833,218865382,10549,2103,125
218871227,218869708,218878120,8412,2104,125
218883894,218882159,218890787,8628,2105,125
218896344,218894826,218903771,8945,2106,125
218909329,218907810,218917093,9283,2107,125
218922650,218921132,218929760,8628,2108,125
218935535,218933799,218942427,8628,2109,125
218948202,218946466,218955412,8946,2110,125
218961186,218959451,218969366,9915,2111,125
218975140,218973405,218982033,8628,2112,125
218987591,218986072,218995671,9599,2113,125
219001289,218999771,219008181,8410,2114,125
219013955,219012220,219020848,8628,2115,125
219026405,219024887,219033832,8945,2116,125
219039390,219037871,219047786,9915,2117,125
219053560,219051825,219061741,9916,2118,125
219067515,219065780,219075062,9282,2119,125
219080692,219079173,219089189,10016,2120,125
219095052,219093317,219101945,8628,2121,125
219107503,219105984,219116217,10233,2122,125
219121864,219120345,219128974,8629,2123,125
219134748,219133013,219141346,8333,2124,125
219146981,219145462,219153874,8412,2125,125
219159648,219157913,219168145,10232,2126,125
219174009,219172273,219180606,8333,2127,125
219186164,219184645,219195195,10550,2128,125
219201058,219199323,219209872,10549,2129,125
219215735,219214000,219223282,9282,2130,125
219229057,219227321,219236582,9261,2131,125
219242356,219240621,219248954,8333,2132,125
219254729,219252993,219262910,9917,2133,125
219268685,219266949,219276233,9284,2134,125
219282007,219280272,219290504,10232,2135,125
219296353,219294835,219304534,9699,2136,125
219310092,219308573,219316906,8333,2137,125
219322681,219320945,219330862,9917,2138,125
219336497,219334978,219343390,8412,2139,125
219349164,219347429,219356374,8945,2140,125
219362149,219360413,219368747,8334,2141,125
219374305,219372786,219381730,8944,2142,125
219387505,219385770,219395368,9598,2143,125
219400926,219399407,219407741,8334,2144,125
219413299,219411780,219421062,9282,2145,125
219426837,219425101,219434383,9282,2146,125
219439940,219438422,219446755,8333,2147,125
219452313,219450794,219459128,8334,2148,125
219464686,219463167,219473399,10232,2149,125
219479263,219477527,219487444,9917,2150,125
219493219,219491483,219501400,9917,2151,125
219507175,219505439,219514385,8946,2152,125
219520160,219518424,219528974,10550,2153,125
219534833,219533315,219541727,8412,2154,125
219547285,219545766,219555682,9916,2155,125
219561456,219559721,219569004,9283,2156,125
219574779,219573043,219582642,9599,2157,125
219588200,219586681,219596281,9600,2158,125
219602055,219600320,219610551,10231,2159,125
219616197,219614679,219623624,8945,2160,125
219629399,219627663,219636945,9282,2161,125
219642720,219640984,219649929,8945,2162,125
219655703,219653968,219662301,8333,2163,125
219667945,219666427,219675155,8728,2164,125
219680929,219679194,219688792,9598,2165,125
219694566,219692831,219701164,8333,2166,125
219706721,219705203,219715119,9916,2167,125
219720894,219719158,219729074,9916,2168,125
219734704,219733185,219742251,9066,2169,125
219748026,219746290,219755574,9284,2170,125
219761349,219759613,219769529,9916,2171,125
219775303,219773568,219783799,10231,2172,125
219789445,219787927,219796260,8333,2173,125
219802034,219800299,219810214,9915,2174,125
219815772,219814253,219822881,8628,2175,125
219828655,219826920,219835548,8628,2176,125
219841106,219839587,219849820,10233,2177,125
219855684,219853948,219863232,9284,2178,125
219869006,219867271,219875603,8332,2179,125
219881241,219879722,219888451,8729,2180,125
219894226,219892490,219901774,9284,2181,125
219907548,219905813,219916362,10549,2182,125
219922218,219920699,219929427,8728,2183,125
219935201,219933466,219943065,9599,2184,125
219948623,219947104,219956387,9283,2185,125
219961944,219960426,219970975,10549,2186,125
219976704,219975186,219983914,8728,2187,125
219989689,219987953,219998185,10232,2188,125
220004048,220002313,220011258,8945,2189,125
220017033,220015297,220025530,10233,2190,125
220031384,220029865,220037982,8117,2191,125
220043757,220042021,220051937,9916,2192,125
220057494,220055976,220064921,8945,2193,125
220070695,220068960,220078559,9599,2194,125
220084333,220082598,220091880,9282,2195,125
220097654,220095919,220106467,10548,2196,125
220112330,220110595,220119223,8628,2197,125
220124781,220123262,220133812,10550,2198,125
220139675,220137940,220147201,9261,2199,125
220152975,220151240,220159867,8627,2200,125
220165426,220163907,220172853,8946,2201,125
220178626,220176892,220186174,9282,2202,125
220191949,220190213,220198547,8334,2203,125
220204321,220202586,220212185,9599,2204,125
220217823,220216304,220225348,9044,2205,125
220231123,220229387,220239936,10549,2206,125
220245799,220244064,220253346,9282,2207,125
220259120,220257385,220266668,9283,2208,125
220272442,220270707,220279040,8333,2209,125
220284668,220283149,220291266,8117,2210,125
220296909,220295390,220303802,8412,2211,125
220309577,220307841,220317756,9915,2212,125
220323313,220321795,220331710,9915,2213,125
220337341,220335822,220345837,10015,2214,125
220351701,220349965,220358910,8945,2215,125
220364468,220362949,220371262,8313,2216,125
220376820,220375301,220383929,8628,2217,125
220389703,220387968,220397567,9599,2218,125
220403342,220401606,220410868,9262,2219,125
220416642,220414907,220424189,9282,2220,125
220429963,220428228,220438144,9916,2221,125
220443768,220442250,220451316,9066,2222,125
220456874,220455355,220464638,9283,2223,125
220470413,220468677,220478594,9917,2224,125
220484369,220482633,220491917,9284,2225,125
220497691,220495956,220505554,9598,2226,125
220511113,220509594,220517928,8334,2227,125
220523486,220521967,220530913,8946,2228,125
220536687,220534952,220544551,9599,2229,125
220550325,220548590,220557535,8945,2230,125
220563310,220561574,220570203,8629,2231,125
220575977,220574242,220584474,10232,2232,125
220590323,220588805,220597215,8410,2233,125
220602989,220601254,220610852,9598,2234,125
220616491,220614973,220623089,8116,2235,125
220628864,220627128,220636728,9600,2236,125
220642502,220640767,220650366,9599,2237,125
220656140,220654405,220664954,10549,2238,125
220670818,220669082,220678681,9599,2239,125
220684456,220682720,220692320,9600,2240,125
220698094,220696359,220704987,8628,2241,125
220710762,220709026,220719259,10233,2242,125
220725123,220723387,220733937,10550,2243,125
220739800,220738065,220747980,9915,2244,125
220753754,220752019,220761934,9915,2245,125
220767491,220765973,220775572,9599,2246,125
220781130,220779611,220788240,8629,2247,125
220793797,220792279,220802511,10232,2248,125
220808375,220806856,220816239,9383,2249,125
220822014,220820278,220830511,10233,2250,125
220836157,220834639,220843921,9282,2251,125
220849696,220847960,220856906,8946,2252,125
220862680,220860945,220871494,10549,2253,125
220877355,220875837,220886168,10331,2254,125
220892031,220890296,220900212,9916,2255,125
220905986,220904251,220913513,9262,2256,125
220919071,220917552,220925886,8334,2257,125
220931512,220929993,220938405,8412,2258,125
220944179,220942444,220952359,9915,2259,125
220958133,220956398,220965026,8628,2260,125
220970800,220969065,220978981,9916,2261,125
220984756,220983020,220991649,8629,2262,125
220997423,220995688,221004020,8332,2263,125
221009795,221008059,221017004,8945,2264,125
221022621,221021102,221029219,8117,2265,125
221034835,221033317,221042383,9066,2266,125
221048157,221046422,221055050,8628,2267,125
221060608,221059089,221069322,10233,2268,125
221075186,221073450,221084000,10550,2269,125
221089864,221088128,221097727,9599,2270,125
221103501,221101766,221111364,9598,2271,125
221117138,221115403,221125002,9599,2272,125
221130776,221129041,221137986,8945,2273,125
221143760,221142025,221152572,10547,2274,125
221158435,221156700,221166298,9598,2275,125
221172073,221170337,221178671,8334,2276,125
221184297,221182779,221192161,9382,2277,125
221197718,221196200,221206431,10231,2278,125
221212293,221210558,221218890,8332,2279,125
221224663,221222928,221231260,8332,2280,125
221237034,221235299,221243926,8627,2281,125
221249700,221247965,221256910,8945,2282,125
221262467,221260949,221269893,8944,2283,125
221275668,221273932,221282266,8334,2284,125
221288040,221286305,221294637,8332,2285,125
221300412,221298676,221307621,8945,2286,125
221313179,221311660,221321893,10233,2287,125
221327755,221326237,221334964,8727,2288,125
221340521,221339003,221348264,9261,2289,125
221354039,221352303,221362536,10233,2290,125
221368182,221366664,221375608,8944,2291,125
221381383,221379647,221388276,8629,2292,125
221393833,221392315,221400943,8628,2293,125
221406717,221404982,221415530,10548,2294,125
221421177,221419658,221429258,9600,2295,125
221434816,221433297,221442897,9600,2296,125
221448671,221446936,221456218,9282,2297,125
221461992,221460257,221470173,9916,2298,125
221475947,221474212,221484761,10549,2299,125
221490624,221488889,221497221,8332,2300,125
221502850,221501332,221509743,8411,2301,125
221515301,221513782,221522116,8334,2302,125
221527890,221526155,221535437,9282,2303,125
221540996,221539476,221548739,9263,2304,125
221554366,221552847,221560963,8116,2305,125
221566521,221565002,221573631,8629,2306,125
221579405,221577670,221587902,10232,2307,125
221593766,221592030,221608637,16607,2308,125
221614283,221612765,221627934,15169,2309,125
221633581,221632062,221641979,9917,2310,125
221647753,221646018,221654349,8331,2311,125
221659982,221658463,221667192,8729,2312,125
221672967,221671231,221679860,8629,2313,125
221685635,221683899,221692528,8629,2314,125
221698302,221696567,221705849,9282,2315,125
221711623,221709888,221718219,8331,2316,125
221723777,221722258,221730887,8629,2317,125
221736445,221734926,221744843,9917,2318,125
221750617,221748882,221757510,8628,2319,125
221763068,221761549,221771465,9916,2320,125
221777238,221775504,221784448,8944,2321,125
221790222,221788487,221798085,9598,2322,125
221803860,221802124,221810753,8629,2323,125
221816528,221814792,221825342,10550,2324,125
221831206,221829470,221839387,9917,2325,125
221844944,221843426,221852370,8944,2326,125
221857927,221856409,221866007,9598,2327,125
221871781,221870046,221878379,8333,2328,125
221883936,221882418,221892017,9599,2329,125
221897791,221896056,221905001,8945,2330,125
221910775,221909040,221917373,8333,2331,125
221923147,221921412,221930039,8627,2332,125
221935813,221934078,221944626,10548,2333,125
221950347,221948828,221957241,8413,2334,125
221962873,221961355,221969471,8116,2335,125
221975246,221973510,221984060,10550,2336,125
221989924,221988188,221998105,9917,2337,125
222003663,222002144,222010477,8333,2338,125
222016100,222014581,222024912,10331,2339,125
222030759,222029241,222037969,8728,2340,125
222043743,222042008,222052240,10232,2341,125
222058103,222056368,222066917,10549,2342,125
222072781,222071045,222079379,8334,2343,125
222085015,222083496,222092879,9383,2344,125
222098653,222096918,222105545,8627,2345,125
222111319,222109584,222117916,8332,2346,125
222123474,222121955,222131555,9600,2347,125
222137113,222135594,222144223,8629,2348,125
222149780,222148262,222158810,10548,2349,125
222164673,222162938,222172537,9599,2350,125
222178313,222176577,222186177,9600,2351,125
222191951,222190216,222199161,8945,2352,125
222204780,222203262,222212961,9699,2353,125
222218735,222217000,222225944,8944,2354,125
222231502,222229983,222239582,9599,2355,125
222245356,222243621,222253220,9599,2356,125
222258995,222257259,222265888,8629,2357,125
222271662,222269927,222278554,8627,2358,125
222284329,222282593,222292826,10233,2359,125
222298690,222296954,222307187,10233,2360,125
222313050,222311315,222319647,8332,2361,125
222325421,222323686,222333917,10231,2362,125
222339564,222338045,222346991,8946,2363,125
222352549,222351030,222360946,9916,2364,125
222366721,222364986,222373930,8944,2365,125
222379704,222377969,222388201,10232,2366,125
222394064,222392545,222402245,9700,2367,125
222408019,222406284,222414617,8333,2368,125
222420391,222418656,222426989,8333,2369,125
222432763,222431028,222439655,8627,2370,125
222445213,222443694,222453610,9916,2371,125
222459384,222457649,222467564,9915,2372,125
222473338,222471603,222480885,9282,2373,125
222486659,222484924,222494206,9282,2374,125
222499980,222498245,222507843,9598,2375,125
222513618,222511882,222522115,10233,2376,125
222527762,222526243,222536476,10233,2377,125
222542339,222540604,222550519,9915,2378,125
222556295,222554559,222565108,10549,2379,125
222570972,222569236,222579786,10550,2380,125
222585433,222583914,222592860,8946,2381,125
222598634,222596899,222606815,9916,2382,125
222612373,222610854,222620454,9600,2383,125
222626229,222624493,222634093,9600,2384,125
222639650,222638132,222647415,9283,2385,125
222652974,222651455,222660738,9283,2386,125
222666512,222664777,222673721,8944,2387,125
222679352,222677833,222686562,8729,2388,125
222692209,222690690,222699757,9067,2389,125
222705315,222703796,222713396,9600,2390,125
222719172,222717436,222726381,8945,2391,125
222731938,222730420,222738753,8333,2392,125
222744527,222742792,222752706,9914,2393,125
222758324,222756805,222767138,10333,2394,125
222773001,222771266,222781497,10231,2395,125
222787360,222785625,222794907,9282,2396,125
222800682,222798946,222808230,9284,2397,125
222814006,222812270,222822820,10550,2398,125
222828466,222826948,222836230,9282,2399,125
222841788,222840269,222850819,10550,2400,125
222856682,222854946,222865179,10233,2401,125
222871042,222869306,222878252,8946,2402,125
222883809,222882291,222892523,10232,2403,125
222898379,222896860,222906560,9700,2404,125
222912118,222910599,222918931,8332,2405,125
222924489,222922970,222933520,10550,2406,125
222939363,222937844,222946572,8728,2407,125
222952217,222950698,222959427,8729,2408,125
222965202,222963466,222973699,10233,2409,125
222979346,222977827,222986772,8945,2410,125
222992546,222990811,223000093,9282,2411,125
223005868,223004132,223014048,9916,2412,125
223019822,223018087,223026419,8332,2413,125
223031976,223030458,223040057,9599,2414,125
223045831,223044096,223054012,9916,2415,125
223059786,223058051,223066995,8944,2416,125
223072615,223071097,223080479,9382,2417,125
223086254,223084518,223094434,9916,2418,125
223100070,223098552,223106963,8411,2419,125
223112738,223111002,223119948,8946,2420,125
223125571,223124052,223134385,10333,2421,125
223140249,223138513,223148113,9600,2422,125
223153736,223152218,223160628,8410,2423,125
223166402,223164667,223173000,8333,2424,125
223178774,223177039,223185984,8945,2425,125
223191759,223190023,223199939,9916,2426,125
223205713,223203978,223214210,10232,2427,125
223219936,223218417,223228750,10333,2428,125
223234614,223232878,223243427,10549,2429,125
223249289,223247554,223256182,8628,2430,125
223261957,223260221,223268849,8628,2431,125
223274407,223272888,223283121,10233,2432,125
223288768,223287249,223297166,9917,2433,125
223302724,223301205,223311122,9917,2434,125
223316896,223315161,223324444,9283,2435,125
223330001,223328483,223338398,9915,2436,125
223344173,223342437,223350770,8333,2437,125
223356544,223354809,223364408,9599,2438,125
223369965,223368447,223377075,8628,2439,125
223382633,223381114,223391030,9916,2440,125
223396656,223395137,223404181,9044,2441,125
223409738,223408220,223418135,9915,2442,125
223423909,223422174,223432090,9916,2443,125
223437733,223436214,223446230,10016,2444,125
223452094,223450358,223459303,8945,2445,125
223464942,223463423,223473439,10016,2446,125
223479303,223477567,223486196,8629,2447,125
223491971,223490235,223498864,8629,2448,125
223504638,223502903,223512186,9283,2449,125
223517960,223516225,223525487,9262,2450,125
223531045,223529526,223539443,9917,2451,125
223545218,223543482,223553398,9916,2452,125
223559172,223557437,223566065,8628,2453,125
223571697,223570178,223579561,9383,2454,125
223585335,223583600,223593516,9916,2455,125
223599150,223597631,223607964,10333,2456,125
223613827,223612092,223621375,9283,2457,125
223627149,223625414,223635646,10232,2458,125
223641509,223639774,223650007,10233,2459,125
223655653,223654135,223662763,8628,2460,125
223668538,223666802,223675431,8629,2461,125
223681206,223679470,223688416,8946,2462,125
223694191,223692455,223702688,10233,2463,125
223708551,223706816,223715444,8628,2464,125
223721217,223719483,223729713,10230,2465,125
223735563,223734045,223744377,10332,2466,125
223750024,223748505,223758105,9600,2467,125
223763879,223762144,223772376,10232,2468,125
223778239,223776504,223784836,8332,2469,125
223790611,223788875,223798475,9600,2470,125
223804249,223802514,223812113,9599,2471,125
223817887,223816152,223826701,10549,2472,125
223832565,223830829,223839775,8946,2473,125
223845550,223843815,223853414,9599,2474,125
223859188,223857453,223867051,9598,2475,125
223872825,223871090,223881322,10232,2476,125
223886968,223885450,223895998,10548,2477,125
223901645,223900126,223910042,9916,2478,125
223915817,223914081,223923364,9283,2479,125
223929138,223927403,223937635,10232,2480,125
223943498,223941763,223950095,8332,2481,125
223955869,223954134,223962467,8333,2482,125
223968241,223966506,223977055,10549,2483,125
223982896,223981377,223991077,9700,2484,125
223996851,223995116,224005665,10549,2485,125
224011509,224009990,224018106,8116,2486,125
224023664,224022145,224031744,9599,2487,125
224037301,224035783,224046331,10548,2488,125
224052194,224050459,224059087,8628,2489,125
224064862,224063126,224072725,9599,2490,125
224078283,224076764,224086680,9916,2491,125
224092454,224090719,224101268,10549,2492,125
224107130,224105611,224115627,10016,2493,125
224121491,224119755,224128384,8629,2494,125
224134158,224132423,224142022,9599,2495,125
224147797,224146061,224155976,9915,2496,125
224161599,224160081,224168197,8116,2497,125
224173972,224172236,224182786,10550,2498,125
224188434,224186914,224195544,8630,2499,125
224201101,224199583,224209814,10231,2500,125
224215678,224213942,224222276,8334,2501,125
224228050,224226315,224236864,10549,2502,125
224242707,224241188,224250888,9700,2503,125
224256662,224254927,224263872,8945,2504,125
224269646,224267911,224278459,10548,2505,125
224284322,224282587,224291870,9283,2506,125
224297644,224295909,224304854,8945,2507,125
224310628,224308893,224318491,9598,2508,125
224324266,224322530,224332762,10232,2509,125
224338626,224336890,224345224,8334,2510,125
224350868,224349350,224359365,10015,2511,125
224365091,224363571,224372954,9383,2512,125
224378729,224376993,224386277,9284,2513,125
224392051,224390316,224399915,9599,2514,125
224405690,224403954,224414502,10548,2515,125
224420366,224418630,224428863,10233,2516,125
224434727,224433208,224443540,10332,2517,125
224449187,224447668,224456002,8334,2518,125
224461559,224460041,224470272,10231,2519,125
224475980,224474462,224483844,9382,2520,125
224489485,224487966,224497666,9700,2521,125
224503440,224501705,224511937,10232,2522,125
224517800,224516065,224525981,9916,2523,125
224531539,224530020,224540570,10550,2524,125
224546274,224544755,224553822,9067,2525,125
224559463,224557944,224568276,10332,2526,125
224574139,224572404,224581686,9282,2527,125
224587243,224585725,224595006,9281,2528,125
224600564,224599045,224609595,10550,2529,125
224615459,224613723,224623005,9282,2530,125
224628563,224627044,224637277,10233,2531,125
224643140,224641405,224651637,10232,2532,125
224657500,224655765,224665364,9599,2533,125
224670923,224669403,224679637,10234,2534,125
224685501,224683765,224693048,9283,2535,125
224698605,224697087,224707319,10232,2536,125
224712966,224711447,224720730,9283,2537,125
224726504,224724769,224734368,9599,2538,125
224740143,224738407,224748640,10233,2539,125
224754485,224752967,224761083,8116,2540,125
224766857,224765122,224774066,8944,2541,125
224779841,224778106,224788654,10548,2542,125
224794493,224792975,224802674,9699,2543,125
224808449,224806713,224816945,10232,2544,125
224822672,224821154,224830536,9382,2545,125
224836310,224834575,224844807,10232,2546,125
224850669,224848934,224857878,8944,2547,125
224863653,224861917,224870863,8946,2548,125
224876420,224874902,224883847,8945,2549,125
224889622,224887886,224896219,8333,2550,125
224901993,224900258,224909857,9599,2551,125
224915415,224913896,224922525,8629,2552,125
224928083,224926564,224936480,9916,2553,125
224942255,224940519,224949464,8945,2554,125
224955238,224953503,224961836,8333,2555,125
224967610,224965875,224974819,8944,2556,125
224980593,224978858,224987803,8945,2557,125
224993577,224991842,225001124,9282,2558,125
225006898,225005163,225014108,8945,2559,125
225019883,225018147,225027430,9283,2560,125
225033206,225031470,225040753,9283,2561,125
225046311,225044792,225054709,9917,2562,125
225060484,225058749,225068348,9599,2563,125
225074124,225072388,225081671,9283,2564,125
225087446,225085711,225094044,8333,2565,125
225099669,225098150,225108166,10016,2566,125
225113813,225112294,225122210,9916,2567,125
225127985,225126250,225136482,10232,2568,125
225142347,225140611,225150211,9600,2569,125
225155851,225154332,225164030,9698,2570,125
225169805,225168070,225176698,8628,2571,125
225182256,225180738,225190337,9599,2572,125
225195970,225194452,225203834,9382,2573,125
225209468,225207949,225217965,10016,2574,125
225223829,225222094,225232010,9916,2575,125
225237786,225236050,225244383,8333,2576,125
225249941,225248423,225256756,8333,2577,125
225262531,225260796,225269424,8628,2578,125
225275200,225273464,225282748,9284,2579,125
225288380,225286861,225294976,8115,2580,125
225300534,225299015,225308615,9600,2581,125
225314390,225312654,225321937,9283,2582,125
225327711,225325976,225334309,8333,2583,125
225339925,225338406,225347472,9066,2584,125
225353029,225351511,225359843,8332,2585,125
225365617,225363882,225372215,8333,2586,125
225377773,225376254,225386487,10233,2587,125
225392350,225390615,225401163,10548,2588,125
225406888,225405369,225415701,10332,2589,125
225421350,225419830,225428460,8630,2590,125
225434105,225432586,225441652,9066,2591,125
225447210,225445691,225454636,8945,2592,125
225460282,225458763,225467828,9065,2593,125
225473386,225471867,225482099,10232,2594,125
225487963,225486227,225494561,8334,2595,125
225500199,225498680,225509013,10333,2596,125
225514726,225513208,225521324,8116,2597,125
225527100,225525364,225535597,10233,2598,125
225541244,225539725,225550275,10550,2599,125
225556139,225554403,225563348,8945,2600,125
225569123,225567388,225577936,10548,2601,125
225583800,225582064,225591664,9600,2602,125
225597439,225595704,225604332,8628,2603,125
225609889,225608371,225618602,10231,2604,125
225624466,225622730,225631675,8945,2605,125
225637235,225635715,225644999,9284,2606,125
225650773,225649038,225657983,8945,2607,125
225663758,225662022,225671621,9599,2608,125
225677397,225675661,225683995,8334,2609,125
225689770,225688035,225696663,8628,2610,125
225702220,225700702,225709035,8333,2611,125
225714809,225713074,225722989,9915,2612,125
225728611,225727092,225736475,9383,2613,125
225742034,225740515,225750748,10233,2614,125
225756460,225754941,225764956,10015,2615,125
225770602,225769084,225778999,9915,2616,125
225784774,225783039,225791667,8628,2617,125
225797442,225795707,225806256,10549,2618,125
225812120,225810384,225819984,9600,2619,125
225825759,225824023,225832651,8628,2620,125
225838425,225836690,225847239,10549,2621,125
225853102,225851367,225860650,9283,2622,125
225866208,225864689,225873951,9262,2623,125
225879593,225878074,225886803,8729,2624,125
225892361,225890843,225899471,8628,2625,125
225905029,225903511,225912792,9281,2626,125
225918568,225916832,225925166,8334,2627,125
225930941,225929205,225937834,8629,2628,125
225943609,225941874,225950819,8945,2629,125
225956377,225954859,225963487,8628,2630,125
225969262,225967527,225977759,10232,2631,125
225983623,225981887,225990833,8946,2632,125
225996392,225994873,226003819,8946,2633,125
226009377,226007859,226018408,10549,2634,125
226024117,226022598,226032298,9700,2635,125
226038074,226036338,226044966,8628,2636,125
226050524,226049006,226059553,10547,2637,125
226065417,226063681,226073281,9600,2638,125
226079056,226077321,226086582,9261,2639,125
226092141,226090622,226099906,9284,2640,125
226105680,226103945,226114176,10231,2641,125
226120040,226118304,226127903,9599,2642,125
226133529,226132010,226140739,8729,2643,125
226146513,226144778,226154377,9599,2644,125
226159935,226158416,226168333,9917,2645,125
226174107,226172372,226181000,8628,2646,125
226186775,226185040,226194954,9914,2647,125
226200730,226198994,226207940,8946,2648,125
226213565,226212046,226221745,9699,2649,125
226227520,226225785,226234412,8627,2650,125
226240188,226238452,226247397,8945,2651,125
226253043,226251524,226259936,8412,2652,125
226265711,226263975,226274524,10549,2653,125
226280387,226278652,226288568,9916,2654,125
226294126,226292608,226301552,8944,2655,125
226307183,226305665,226314076,8411,2656,125
226319634,226318115,226327715,9600,2657,125
226333491,226331755,226340383,8628,2658,125
226346159,226344423,226353052,8629,2659,125
226358697,226357178,226366878,9700,2660,125
226372438,226370918,226380834,9916,2661,125
226386610,226384874,226394791,9917,2662,125
226400349,226398831,226409380,10549,2663,125
226415223,226413704,226422771,9067,2664,125
226428547,226426811,226435145,8334,2665,125
226440703,226439184,226448129,8945,2666,125
226453904,226452169,226462401,10232,2667,125
226468264,226466529,226477078,10549,2668,125
226482942,226481206,226491439,10233,2669,125
226497087,226495568,226505483,9915,2670,125
226511258,226509523,226518151,8628,2671,125
226523926,226522191,226532740,10549,2672,125
226538448,226536930,226545046,8116,2673,125
226550821,226549086,226557418,8332,2674,125
226562977,226561458,226571374,9916,2675,125
226577149,226575414,226585013,9599,2676,125
226590573,226589053,226599604,10551,2677,125
226605462,226603943,226612671,8728,2678,125
226618228,226616710,226625338,8628,2679,125
226631113,226629378,226639926,10548,2680,125
226645790,226644055,226653971,9916,2681,125
226659603,226658084,226666495,8411,2682,125
226672270,226670535,226679818,9283,2683,125
226685593,226683858,226692803,8945,2684,125
226698579,226696843,226705472,8629,2685,125
226711089,226709570,226719902,10332,2686,125
226725767,226724031,226732977,8946,2687,125
226738752,226737017,226745962,8945,2688,125
226751737,226750002,226759600,9598,2689,125
226765376,226763640,226772585,8945,2690,125
226778361,226776625,226786225,9600,2691,125
226792000,226790265,226799864,9599,2692,125
226805501,226803982,226813364,9382,2693,125
226819139,226817404,226826349,8945,2694,125
226831973,226830454,226840154,9700,2695,125
226845928,226844193,226852526,8333,2696,125
226858301,226856566,226866798,10232,2697,125
226872521,226871002,226881334,10332,2698,125
226887054,226885535,226895234,9699,2699,125
226901008,226899273,226908217,8944,2700,125
226913776,226912257,226920590,8333,2701,125
226926365,226924629,226933913,9284,2702,125
226939688,226937953,226947552,9599,2703,125
226953327,226951591,226961508,9917,2704,125
226967066,226965548,226975147,9599,2705,125
226980923,226979187,226987816,8629,2706,125
226993453,226991934,227001950,10016,2707,125
227007653,227006134,227016151,10017,2708,125
227022015,227020496,227029225,8729,2709,125
227034864,227033346,227043361,10015,2710,125
227049226,227047490,227057406,9916,2711,125
227063181,227061446,227071994,10548,2712,125
227077859,227076123,227085069,8946,2713,125
227090844,227089109,227098392,9283,2714,125
227104166,227102431,227111376,8945,2715,125
227116934,227115416,227125014,9598,2716,125
227130789,227129054,227137682,8628,2717,125
227143458,227141722,227150351,8629,2718,125
227155910,227154391,227164624,10233,2719,125
227170489,227168753,227178670,9917,2720,125
227184445,227182710,227191655,8945,2721,125
227197213,227195695,227204028,8333,2722,125
227209662,227208144,227216872,8728,2723,125
227222648,227220912,227230196,9284,2724,125
227235756,227234236,227244153,9917,2725,125
227249790,227248271,227256682,8411,2726,125
227262458,227260722,227270321,9599,2727,125
227275960,227274441,227284140,9699,2728,125
227289698,227288180,227298729,10549,2729,125
227304376,227302857,227312774,9917,2730,125
227318396,227316877,227325944,9067,2731,125
227331582,227330064,227338474,8410,2732,125
227344031,227342513,227351141,8628,2733,125
227356917,227355181,227365098,9917,2734,125
227370656,227369138,227379687,10549,2735,125
227385417,227383897,227392015,8118,2736,125
227397790,227396054,227405653,9599,2737,125
227411427,227409692,227420240,10548,2738,125
227426097,227424578,227434911,10333,2739,125
227440754,227439235,227447647,8412,2740,125
227453422,227451687,227460631,8944,2741,125
227466407,227464671,227475221,10550,2742,125
227481058,227479539,227488267,8728,2743,125
227493825,227492307,227501905,9598,2744,125
227507681,227505945,227514891,8946,2745,125
227520666,227518931,227527264,8333,2746,125
227533040,227531304,227539933,8629,2747,125
227545709,227543973,227554522,10549,2748,125
227560377,227558858,227568241,9383,2749,125
227574017,227572281,227581227,8946,2750,125
227587003,227585267,227595816,10549,2751,125
227601464,227599945,227608574,8629,2752,125
227614132,227612614,227622530,9916,2753,125
227628305,227626570,227637119,10549,2754,125
227642982,227641247,227651163,9916,2755,125
227656939,227655203,227665436,10233,2756,125
227671300,227669565,227678193,8628,2757,125
227683752,227682233,227692466,10233,2758,125
227698330,227696595,227705877,9282,2759,125
227711653,227709917,227718862,8945,2760,125
227724421,227722902,227732502,9600,2761,125
227738278,227736542,227747091,10549,2762,125
227752934,227751415,227760797,9382,2763,125
227766572,227764837,227773465,8628,2764,125
227779240,227777505,227787737,10232,2765,125
227793467,227791950,227800676,8726,2766,125
227806451,227804716,227814947,10231,2767,125
227820811,227819076,227828358,9282,2768,125
227834133,227832398,227840730,8332,2769,125
227846505,227844769,227855319,10550,2770,125
227861160,227859641,227868686,9045,2771,125
227874245,227872726,227882959,10233,2772,125
227888823,227887088,227895716,8628,2773,125
227901274,227899756,227909988,10232,2774,125
227915852,227914333,227924666,10333,2775,125
227930313,227928794,227937127,8333,2776,125
227942903,227941167,227950767,9600,2777,125
227956543,227954807,227965040,10233,2778,125
227970687,227969168,227977501,8333,2779,125
227983276,227981541,227992090,10549,2780,125
227997737,227996219,228004847,8628,2781,125
228010487,228008968,228017379,8411,2782,125
228022937,228021418,228030363,8945,2783,125
228036139,228034403,228044636,10233,2784,125
228050501,228048765,228058998,10233,2785,125
228064713,228063195,228071310,8115,2786,125
228076868,228075350,228084295,8945,2787,125
228090070,228088335,228098884,10549,2788,125
228104747,228103012,228112293,9281,2789,125
228118069,228116333,228126248,9915,2790,125
228131807,228130288,228140204,9916,2791,125
228145979,228144244,228154160,9916,2792,125
228159936,228158200,228168117,9917,2793,125
228173892,228172156,228181756,9600,2794,125
228187532,228185796,228196346,10550,2795,125
228202193,228200674,228208791,8117,2796,125
228214350,228212831,228221777,8946,2797,125
228227553,228225817,228236365,10548,2798,125
228242230,228240494,228248828,8334,2799,125
228254603,228252868,228262784,9916,2800,125
228268560,228266824,228277374,10550,2801,125
228283239,228281503,228289836,8333,2802,125
228295611,228293876,228303475,9599,2803,125
228309250,228307515,228316777,9262,2804,125
228322552,228320817,228330733,9916,2805,125
228336360,228334841,228345172,10331,2806,125
228350819,228349300,228359533,10233,2807,125
228365375,228363857,228373238,9381,2808,125
228379014,228377278,228386877,9599,2809,125
228392652,228390917,228401465,10548,2810,125
228407305,228405786,228415168,9382,2811,125
228420727,228419208,228428153,8945,2812,125
228433928,228432193,228440821,8628,2813,125
228446379,228444861,228453194,8333,2814,125
228458815,228457296,228466361,9065,2815,125
228472137,228470401,228480635,10234,2816,125
228486500,228484764,228493710,8946,2817,125
228499269,228497750,228507350,9600,2818,125
228512983,228511464,228519581,8117,2819,125
228525357,228523621,228533537,9916,2820,125
228539096,228537577,228547494,9917,2821,125
228553270,228551534,228561449,9915,2822,125
228567225,228565489,228575722,10233,2823,125
228581560,228580042,228588770,8728,2824,125
228594546,228592810,228603044,10234,2825,125
228608691,228607173,228616772,9599,2826,125
228622403,228620885,228629001,8116,2827,125
228634560,228633041,228643591,10550,2828,125
228649455,228647720,228657318,9598,2829,125
228663093,228661358,228671906,10548,2830,125
228677771,228676035,228685297,9262,2831,125
228691072,228689337,228699252,9915,2832,125
228704811,228703292,228713524,10232,2833,125
228719388,228717653,228727252,9599,2834,125
228732811,228731292,228739921,8629,2835,125
228745480,228743961,228752907,8946,2836,125
228758681,228756947,228765573,8626,2837,125
228771132,228769613,228778241,8628,2838,125
228783800,228782281,228791227,8946,2839,125
228796848,228795329,228803741,8412,2840,125
228809299,228807781,228817379,9598,2841,125
228823154,228821419,228831968,10549,2842,125
228837694,228836175,228845558,9383,2843,125
228851116,228849598,228858542,8944,2844,125
228864100,228862582,228872813,10231,2845,125
228878461,228876942,228886859,9917,2846,125
228892634,228890899,228899527,8628,2847,125
228905301,228903567,228912511,8944,2848,125
228918138,228916619,228925663,9044,2849,125
228931439,228929703,228938037,8334,2850,125
228943812,228942077,228951676,9599,2851,125
228957452,228955716,228965632,9916,2852,125
228971255,228969737,228978465,8728,2853,125
228984024,228982505,228992105,9600,2854,125
228997880,228996145,229005428,9283,2855,125
229011202,229009468,229019066,9598,2856,125
229024841,229023106,229033022,9916,2857,125
229038797,229037062,229047610,10548,2858,125
229053475,229051739,229060072,8333,2859,125
229065847,229064112,229073711,9599,2860,125
229079342,229077823,229087839,10016,2861,125
229093703,229091968,229102517,10549,2862,125
229108222,229106704,229116086,9382,2863,125
229121861,229120126,229130358,10232,2864,125
229136005,229134486,229143432,8946,2865,125
229149207,229147472,229156734,9262,2866,125
229162509,229160774,229171007,10233,2867,125
229176871,229175136,229185685,10549,2868,125
229191393,229189875,229199890,10015,2869,125
229205537,229204019,229212351,8332,2870,125
229217909,229216391,229226940,10549,2871,125
229232804,229231069,229241301,10232,2872,125
229246949,229245430,229255663,10233,2873,125
229261521,229260002,229268730,8728,2874,125
229274506,229272770,229281399,8629,2875,125
229287174,229285439,229294701,9262,2876,125
229300318,229298799,229309132,10333,2877,125
229314996,229313261,229321594,8333,2878,125
229327152,229325634,229334579,8945,2879,125
229340354,229338619,229346951,8332,2880,125
229352726,229350991,229361539,10548,2881,125
229367186,229365668,229375900,10232,2882,125
229381765,229380029,229390579,10550,2883,125
229396308,229394790,229403518,8728,2884,125
229409076,229407557,229418106,10549,2885,125
229423969,229422234,229430567,8333,2886,125
229436210,229434691,229444391,9700,2887,125
229450166,229448430,229458346,9916,2888,125
229464121,229462385,229471013,8628,2889,125
229476788,229475053,229483386,8333,2890,125
229489161,229487425,229495757,8332,2891,125
229501532,229499797,229508742,8945,2892,125
229514299,229512781,229521112,8331,2893,125
229526671,229525152,229535384,10232,2894,125
229541247,229539512,229548139,8627,2895,125
229553915,229552179,229561125,8946,2896,125
229566682,229565164,229575396,10232,2897,125
229581113,229579595,229589609,10014,2898,125
229595255,229593737,229603336,9599,2899,125
229609110,229607375,229617606,10231,2900,125
229623470,229621735,229631334,9599,2901,125
229637109,229635374,229643707,8333,2902,125
229649353,229647834,229657849,10015,2903,125
229663713,229661978,229672527,10549,2904,125
229678392,229676656,229685939,9283,2905,125
229691496,229689978,229699893,9915,2906,125
229705532,229704014,229713058,9044,2907,125
229718834,229717098,229727331,10233,2908,125
229732977,229731459,229742008,10549,2909,125
229747731,229746212,229754329,8117,2910,125
229760104,229758369,229768917,10548,2911,125
229774782,229773046,229781992,8946,2912,125
229787607,229786089,229796103,10014,2913,125
229801829,229800311,229809039,8728,2914,125
229814814,229813079,229823628,10549,2915,125
229829468,229827949,229837965,10016,2916,125
229843611,229842093,229852007,9914,2917,125
229857781,229856046,229864674,8628,2918,125
229870449,229868714,229877341,8627,2919,125
229883115,229881381,229891612,10231,2920,125
229897476,229895740,229904074,8334,2921,125
229909849,229908114,229917059,8945,2922,125
229922834,229921099,229930698,9599,2923,125
229936474,229934738,229944022,9284,2924,125
229949581,229948062,229956691,8629,2925,125
229962466,229960731,229970647,9916,2926,125
229976284,229974765,229983830,9065,2927,125
229989388,229987870,229996815,8945,2928,125
230002590,230000855,230009799,8944,2929,125
230015575,230013839,230023756,9917,2930,125
230029384,230027866,230036594,8728,2931,125
230042370,230040634,230050233,9599,2932,125
230055865,230054346,230063075,8729,2933,125
230068851,230067115,230076061,8946,2934,125
230081836,230080101,230089384,9283,2935,125
230095159,230093424,230102053,8629,2936,125
230107828,230106093,230115038,8945,2937,125
230120596,230119078,230127706,8628,2938,125
230133264,230131746,230141662,9916,2939,125
230147291,230145773,230154183,8410,2940,125
230159959,230158223,230166853,8630,2941,125
230172629,230170893,230180156,9263,2942,125
230185931,230184196,230193458,9262,2943,125
230199092,230197574,230206956,9382,2944,125
230212731,230210996,230220258,9262,2945,125
230225817,230224298,230232926,8628,2946,125
230238485,230236966,230247516,10550,2947,125
230253376,230251857,230259952,8095,2948,125
230265728,230263992,230272938,8946,2949,125
230278713,230276978,230286577,9599,2950,125
230292352,230290617,230300532,9915,2951,125
230306091,230304572,230314489,9917,2952,125
230320104,230318585,230326997,8412,2953,125
230332772,230331037,230339665,8628,2954,125
230345440,230343705,230353620,9915,2955,125
230359242,230357724,230367739,10015,2956,125
230373385,230371867,230381129,9262,2957,125
230386905,230385169,230393502,8333,2958,125
230399277,230397542,230406171,8629,2959,125
230411947,230410211,230418839,8628,2960,125
230424614,230422878,230431507,8629,2961,125
230437064,230435546,230444173,8627,2962,125
230449948,230448213,230458445,10232,2963,125
230464309,230462573,230473122,10549,2964,125
230478832,230477314,230487644,10330,2965,125
230493508,230491773,230501687,9914,2966,125
230507462,230505727,230514060,8333,2967,125
230519618,230518100,230528649,10549,2968,125
230534296,230532777,230542694,9917,2969,125
230548469,230546734,230556966,10232,2970,125
230562683,230561165,230571497,10332,2971,125
230577144,230575625,230585225,9600,2972,125
230590999,230589264,230597892,8628,2973,125
230603667,230601932,230610264,8332,2974,125
230616039,230614303,230623903,9600,2975,125
230629679,230627943,230637206,9263,2976,125
230642763,230641245,230651477,10232,2977,125
230657340,230655606,230663938,8332,2978,125
230669713,230667978,230678527,10549,2979,125
230684174,230682655,230692572,9917,2980,125
230698130,230696611,230705557,8946,2981,125
230711333,230709597,230718543,8946,2982,125
230724318,230722583,230731211,8628,2983,125
230736985,230735250,230744195,8945,2984,125
230749816,230748298,230756414,8116,2985,125
230762188,230760453,230769714,9261,2986,125
230775488,230773753,230782086,8333,2987,125
230787861,230786126,230794753,8627,2988,125
230800311,230798792,230808391,9599,2989,125
230813948,230812430,230822345,9915,2990,125
230827903,230826384,230835329,8945,2991,125
230840888,230839369,230847703,8334,2992,125
230853348,230851830,230861528,9698,2993,125
230867303,230865567,230874829,9262,2994,125
230880605,230878869,230888153,9284,2995,125
230893770,230892252,230901296,9044,2996,125
230906854,230905335,230914281,8946,2997,125
230919903,230918384,230928717,10333,2998,125
230934580,230932845,230941178,8333,2999,125
230946952,230945217,230953845,8628,3000,125
230959621,230957885,230966513,8628,3001,125
230972289,230970553,230979183,8630,3002,125
230984741,230983223,230992822,9599,3003,125
230998380,230996861,231006460,9599,3004,125
231012236,231010500,231020099,9599,3005,125
231025658,231024139,231034688,10549,3006,125
231040551,231038816,231048098,9282,3007,125
231053872,231052137,231062686,10549,3008,125
231068412,231066893,231076909,10016,3009,125
231082772,231081037,231097114,16077,3010,125
231102978,231101243,231111159,9916,3011,125
231116717,231115199,231125748,10549,3012,125
231131611,231129876,231138820,8944,3013,125
231144596,231142860,231152460,9600,3014,125
231158086,231156567,231164979,8412,3015,125
231170754,231169019,231177351,8332,3016,125
231182908,231181390,231191304,9914,3017,125
231197079,231195343,231205893,10550,3018,125
231211756,231210021,231218965,8944,3019,125
231224740,231223005,231232921,9916,3020,125
231238696,231236961,231245589,8628,3021,125
231251364,231249629,231258890,9261,3022,125
231264449,231262930,231273479,10549,3023,125
231279317,231277798,231286210,8412,3024,125
231291985,231290250,231298583,8333,3025,125
231304358,231302622,231312222,9600,3026,125
231317998,231316262,231326812,10550,3027,125
231332676,231330940,231339273,8333,3028,125
231345048,231343313,231351941,8628,3029,125
231357715,231355980,231366527,10547,3030,125
231372370,231370851,231379580,8729,3031,125
231385355,231383620,231392901,9281,3032,125
231398677,231396941,231405887,8946,3033,125
231411446,231409927,231419527,9600,3034,125
231425301,231423566,231432194,8628,3035,125
231437970,231436234,231445180,8946,3036,125
231450954,231449219,231458164,8945,3037,125
231463940,231462204,231472437,10233,3038,125
231478153,231476635,231486334,9699,3039,125
231492109,231490373,231500605,10232,3040,125
231506469,231504734,231513362,8628,3041,125
231519136,231517401,231526029,8628,3042,125
231531588,231530069,231539014,8945,3043,125
231544789,231543054,231551681,8627,3044,125
231557240,231555721,231564667,8946,3045,125
231570441,231568706,231577334,8628,3046,125
231582892,231581373,231590973,9600,3047,125
231596533,231595013,231609286,14273,3048,125
231614934,231613415,231623015,9600,3049,125
231628791,231627055,231636655,9600,3050,125
231642430,231640695,231649028,8333,3051,125
231654586,231653068,231662983,9915,3052,125
231668542,231667023,231675968,8945,3053,125
231681527,231680008,231690240,10232,3054,125
231695887,231694368,231704916,10548,3055,125
231710779,231709044,231718643,9599,3056,125
231724417,231722682,231731015,8333,3057,125
231736792,231735055,231744655,9600,3058,125
231750213,231748694,231758611,9917,3059,125
231764386,231762651,231772250,9599,3060,125
231778025,231776290,231784622,8332,3061,125
231790398,231788662,231797607,8945,3062,125
231803242,231801724,231812056,10332,3063,125
231817904,231816385,231826401,10016,3064,125
231832048,231830529,231840129,9600,3065,125
231845904,231844168,231853768,9600,3066,125
231859326,231857808,231866139,8331,3067,125
231871763,231870244,231880576,10332,3068,125
231886420,231884902,231894917,10015,3069,125
231900769,231899250,231909266,10016,3070,125
231915129,231913394,231922338,8944,3071,125
231928114,231926378,231935978,9600,3072,125
231941754,231940018,231948647,8629,3073,125
231954291,231952772,231963105,10333,3074,125
231968751,231967233,231976832,9599,3075,125
231982390,231980871,231991421,10550,3076,125
231997069,231995550,232003884,8334,3077,125
232009659,232007923,232016256,8333,3078,125
232022030,232020295,232030527,10232,3079,125
232036390,232034655,232043282,8627,3080,125
232049058,232047322,232056921,9599,3081,125
232062696,232060961,232069293,8332,3082,125
232074852,232073332,232082615,9283,3083,125
232088390,232086655,232095283,8628,3084,125
232101058,232099323,232109555,10232,3085,125
232115418,232113683,232123282,9599,3086,125
232129056,232127321,232137553,10232,3087,125
232143417,232141898,232150627,8729,3088,125
232156402,232154667,232164266,9599,3089,125
232169825,232168306,232177905,9599,3090,125
232183680,232181945,232190278,8333,3091,125
232195835,232194317,232203577,9260,3092,125
232209352,232207616,232216245,8629,3093,125
232222021,232220285,232228913,8628,3094,125
232234689,232232953,232241581,8628,3095,125
232247140,232245621,232255220,9599,3096,125
232260995,232259260,232269491,10231,3097,125
232275138,232273619,232283536,9917,3098,125
232289311,232287576,232295909,8333,3099,125
232301468,232299949,232309548,9599,3100,125
232315106,232313588,232322869,9281,3101,125
232328645,232326909,232337141,10232,3102,125
232342788,232341269,232349603,8334,3103,125
232355377,232353642,232363240,9598,3104,125
232369016,232367280,232376226,8946,3105,125
232382002,232380266,232390183,9917,3106,125
232395958,232394223,232404455,10232,3107,125
232410319,232408583,232416916,8333,3108,125
232422691,232420956,232431505,10549,3109,125
232437369,232435634,232444261,8627,3110,125
232450036,232448301,232458533,10232,3111,125
232464396,232462661,232473209,10548,3112,125
232478857,232477338,232487887,10549,3113,125
232493750,232492015,232502247,10232,3114,125
232508110,232506375,232515320,8945,3115,125
232521096,232519360,232527989,8629,3116,125
232533627,232532108,232541808,9700,3117,125
232547426,232545907,232554024,8117,3118,125
232559799,232558063,232566396,8333,3119,125
232572171,232570436,232579718,9282,3120,125
232585493,232583757,232592091,8334,3121,125
232597650,232596131,232606048,9917,3122,125
232611823,232610088,232619370,9282,3123,125
232624928,232623410,232633959,10549,3124,125
232639811,232638292,232646409,8117,3125,125
232651967,232650449,232660047,9598,3126,125
232665823,232664087,232674003,9916,3127,125
232679562,232678043,232687326,9283,3128,125
232693102,232691366,232699995,8629,3129,125
232705642,232704123,232713505,9382,3130,125
232719280,232717545,232726827,9282,3131,125
232732384,232730866,232739199,8333,3132,125
232744974,232743239,232751572,8333,3133,125
232757129,232755611,232765526,9915,3134,125
232771301,232769565,232777897,8332,3135,125
232783456,232781936,232791220,9284,3136,125
232796995,232795260,232804205,8945,3137,125
232809980,232808245,232818161,9916,3138,125
232823937,232822201,232831483,9282,3139,125
232837259,232835523,232844807,9284,3140,125
232850582,232848846,232859079,10233,3141,125
232864943,232863208,232873440,10232,3142,125
232879304,232877569,232887167,9598,3143,125
232892726,232891207,232901123,9916,3144,125
232906897,232905162,232915710,10548,3145,125
232921425,232919907,232929922,10015,3146,125
232935569,232934051,232942383,8332,3147,125
232947942,232946423,232955052,8629,3148,125
232960827,232959092,232968036,8944,3149,125
232973811,232972076,232981675,9599,3150,125
232987298,232985780,232995795,10015,3151,125
233001658,232999923,233009838,9915,3152,125
233015397,233013878,233023477,9599,3153,125
233029252,233027517,233036462,8945,3154,125
233042020,233040501,233049129,8628,3155,125
233054904,233053169,233062114,8945,3156,125
233067673,233066154,233075753,9599,3157,125
233081527,233079792,233088737,8945,3158,125
233094512,233092777,233102376,9599,3159,125
233108151,233106416,233115698,9282,3160,125
233121473,233119738,233130287,10549,3161,125
233135935,233134416,233144333,9917,3162,125
233149891,233148372,233158605,10233,3163,125
233164252,233162733,233171362,8629,3164,125
233177136,233175401,233185633,10232,3165,125
233191281,233189762,233199995,10233,3166,125
233205723,233204205,233213270,9065,3167,125
233219046,233217310,233225643,8333,3168,125
233231262,233229744,233237859,8115,3169,125
233243634,233241899,233252130,10231,3170,125
233257853,233256334,233266666,10332,3171,125
233272529,233270794,233279739,8945,3172,125
233285298,233283779,233292111,8332,3173,125
233297887,233296151,233306701,10550,3174,125
233312565,233310829,233320744,9915,3175,125
233326519,233324783,233333412,8629,3176,125
233338971,233337452,233345786,8334,3177,125
233351561,233349826,233359425,9599,3178,125
233364984,233363465,233373382,9917,3179,125
233378941,233377422,233386051,8629,3180,125
233391827,233390091,233398424,8333,3181,125
233404199,233402464,233412696,10232,3182,125
233418559,233416824,233426740,9916,3183,125
233432515,233430780,233439112,8332,3184,125
233444888,233443152,233453702,10550,3185,125
233459350,233457831,233466460,8629,3186,125
233472235,233470500,233478833,8333,3187,125
233484608,233482873,233492156,9283,3188,125
233497930,233496195,233506426,10231,3189,125
233512072,233510554,233520786,10232,3190,125
233526650,233524915,233534831,9916,3191,125
233540607,233538871,233547500,8629,3192,125
233553276,233551540,233561773,10233,3193,125
233567482,233565964,233574692,8728,3194,125
233580315,233578796,233587525,8729,3195,125
233593145,233591626,233599743,8117,3196,125
233605518,233603783,233616291,12508,3197,125
233621938,233620419,233629049,8630,3198,125
233634825,233633089,233642372,9283,3199,125
233648147,233646412,233655041,8629,3200,125
233660816,233659080,233668026,8946,3201,125
233673583,233672065,233682615,10550,3202,125
233688329,233686810,233695223,8413,3203,125
233700998,233699262,233708546,9284,3204,125
233714320,233712585,233722502,9917,3205,125
233728276,233726541,233737091,10550,3206,125
233742936,233741418,233750801,9383,3207,125
233756576,233754841,233763469,8628,3208,125
233769028,233767509,233776455,8946,3209,125
233782230,233780495,233789123,8628,3210,125
233794898,233793163,233802446,9283,3211,125
233808221,233806485,233816401,9916,3212,125
233822176,233820440,233828774,8334,3213,125
233834549,233832814,233841148,8334,3214,125
233846706,233845187,233853521,8334,3215,125
233859079,233857561,233868111,10550,3216,125
233873974,233872239,233882789,10550,3217,125
233888652,233886917,233896834,9917,3218,125
233902392,233900873,233911106,10233,3219,125
233916970,233915235,233923864,8629,3220,125
233929639,233927904,233936237,8333,3221,125
233941796,233940277,233948612,8335,3222,125
233954170,233952651,233961935,9284,3223,125
233967553,233966034,233976367,10333,3224,125
233982231,233980495,233988829,8334,3225,125
233994388,233992869,234001815,8946,3226,125
234007372,234005854,234015454,9600,3227,125
234021229,234019494,234029727,10233,3228,125
234035591,234033855,234043455,9600,3229,125
234049014,234047495,234055829,8334,3230,125
234061450,234059931,234069948,10017,3231,125
234075595,234074076,234084627,10551,3232,125
234090491,234088755,234097090,8335,3233,125
234102864,234101129,234109758,8629,3234,125
234115318,234113798,234122133,8335,3235,125
234127691,234126173,234134802,8629,3236,125
234140578,234138842,234147472,8630,3237,125
234153247,234151512,234160796,9284,3238,125
234166572,234164836,234174752,9916,3239,125
234180527,234178792,234188709,9917,3240,125
234194484,234192749,234202982,10233,3241,125
234208630,234207111,234216712,9601,3242,125
234222487,234220752,234230036,9284,3243,125
234235676,234234158,234243857,9699,3244,125
234249632,234247897,234257814,9917,3245,125
234263590,234261854,234271455,9601,3246,125
234277013,234275495,234284124,8629,3247,125
234289899,234288164,234298081,9917,3248,125
234303856,234302121,234311404,9283,3249,125
234316963,234315444,234324389,8945,3250,125
234330164,234328429,234337711,9282,3251,125
234343269,234341751,234350084,8333,3252,125
234355710,234354191,234363892,9701,3253,125
234369451,234367932,234376265,8333,3254,125
234382040,234380305,234389588,9283,3255,125
234395146,234393628,234403861,10233,3256,125
234409724,234407989,234416618,8629,3257,125
234422176,234420658,234429941,9283,3258,125
234435499,234433981,234443581,9600,3259,125
234449355,234447620,234457852,10232,3260,125
234463716,234461981,234471265,9284,3261,125
234477041,234475305,234484906,9601,3262,125
234490465,234488946,234499179,10233,3263,125
234504826,234503308,234512254,8946,3264,125
234518030,234516294,234524628,8334,3265,125
234530405,234528668,234539220,10552,3266,125
234544867,234543348,234553266,9918,3267,125
234558892,234557373,234567390,10017,3268,125
234573254,234571519,234581434,9915,3269,125
234586991,234585473,234595389,9916,3270,125
234600947,234599429,234609346,9917,3271,125
234615121,234613386,234622668,9282,3272,125
234628226,234626708,234635990,9282,3273,125
234641766,234640030,234649630,9600,3274,125
234655188,234653669,234663902,10233,3275,125
234669549,234668031,234677946,9915,3276,125
234683505,234681986,234690616,8630,3277,125
234696392,234694656,234704257,9601,3278,125
234709815,234708296,234716631,8335,3279,125
234722407,234720671,234730272,9601,3280,125
234736047,234734312,234744544,10232,3281,125
234750192,234748673,234758907,10234,3282,125
234764771,234763036,234772319,9283,3283,125
234778094,234776358,234785641,9283,3284,125
234791416,234789681,234799598,9917,3285,125
234805156,234803638,234813871,10233,3286,125
234819735,234818216,234826629,8413,3287,125
234832405,234830669,234839954,9285,3288,125
234845729,234843994,234852623,8629,3289,125
234858398,234856663,234865609,8946,3290,125
234871384,234869649,234878932,9283,3291,125
234884707,234882972,234893205,10233,3292,125
234899068,234897333,234907883,10550,3293,125
234913530,234912011,234920641,8630,3294,125
234926199,234924680,234933015,8335,3295,125
234938790,234937055,234947605,10550,3296,125
234953252,234951733,234960678,8945,3297,125
234966236,234964718,234974001,9283,3298,125
234979560,234978041,234987325,9284,3299,125
234993101,234991365,235001282,9917,3300,125
235007057,235005322,235014922,9600,3301,125
235020697,235018962,235027295,8333,3302,125
235033070,235031335,235041884,10549,3303,125
235047748,235046013,235054641,8628,3304,125
235060417,235058681,235067311,8630,3305,125
235073087,235071351,235081902,10551,3306,125
235087765,235086030,235094658,8628,3307,125
235100434,235098698,235108298,9600,3308,125
235114073,235112338,235121938,9600,3309,125
235127714,235125978,235135263,9285,3310,125
235141038,235139303,235148248,8945,3311,125
235154024,235152288,235161888,9600,3312,125
235167530,235166011,235174741,8730,3313,125
235180300,235178781,235188064,9283,3314,125
235193840,235192104,235202022,9918,3315,125
235207798,235206062,235215663,9601,3316,125
235221438,235219703,235228036,8333,3317,125
235233811,235232076,235240410,8334,3318,125
235245969,235244450,235255001,10551,3319,125
235260865,235259130,235268729,9599,3320,125
235274504,235272769,235282369,9600,3321,125
235288144,235286409,235296009,9600,3322,125
235301783,235300048,235308677,8629,3323,125
235314300,235312781,235322482,9701,3324,125
235328040,235326522,235335467,8945,3325,125
235341242,235339507,235347841,8334,3326,125
235353616,235351881,235360827,8946,3327,125
235366602,235364867,235373496,8629,3328,125
235379055,235377536,235388086,10550,3329,125
235393950,235392215,235400844,8629,3330,125
235406402,235404884,235414483,9599,3331,125
235420258,235418523,235428440,9917,3332,125
235434215,235432480,235442712,10232,3333,125
235448576,235446841,235457074,10233,3334,125
235462938,235461203,235470802,9599,3335,125
235476361,235474842,235483176,8334,3336,125
235488735,235487216,235495551,8335,3337,125
235501327,235499591,235508222,8631,3338,125
235513998,235512262,235522179,9917,3339,125
235527800,235526281,235535665,9384,3340,125
235541439,235539704,235548037,8333,3341,125
235553596,235552077,235560706,8629,3342,125
235566481,235564746,235575296,10550,3343,125
235581159,235579424,235589973,10549,3344,125
235595836,235594101,235604334,10233,3345,125
235610174,235608655,235617385,8730,3346,125
235622943,235621425,235630708,9283,3347,125
235636344,235634826,235644208,9382,3348,125
235649766,235648248,235657848,9600,3349,125
235663623,235661888,235671172,9284,3350,125
235676947,235675212,235684811,9599,3351,125
235690369,235688851,235699400,10549,3352,125
235705046,235703528,235713445,9917,3353,125
235719219,235717485,235727716,10231,3354,125
235733423,235731904,235740318,8414,3355,125
235746092,235744357,235752986,8629,3356,125
235758545,235757026,235767259,10233,3357,125
235773123,235771388,235780671,9283,3358,125
235786230,235784711,235794312,9601,3359,125
235800087,235798352,235808268,9916,3360,125
235814044,235812308,235822858,10550,3361,125
235828585,235827067,235836132,9065,3362,125
235841690,235840172,235850088,9916,3363,125
235855647,235854128,235864677,10549,3364,125
235870396,235868878,235876994,8116,3365,125
235882553,235881034,235891268,10234,3366,125
235897132,235895396,235903730,8334,3367,125
235909506,235907770,235916104,8334,3368,125
235921663,235920144,235929427,9283,3369,125
235934986,235933467,235943700,10233,3370,125
235949564,235947828,235958379,10551,3371,125
235964026,235962507,235972108,9601,3372,125
235977883,235976148,235985747,9599,3373,125
235991385,235989866,235999249,9383,3374,125
236005024,236003289,236013838,10549,3375,125
236019570,236018052,236027750,9698,3376,125
236033526,236031790,236041390,9600,3377,125
236046948,236045429,236055030,9601,3378,125
236060655,236059136,236067549,8413,3379,125
236073325,236071589,236081823,10234,3380,125
236087469,236085951,236096500,10549,3381,125
236102363,236100628,236108961,8333,3382,125
236114735,236113000,236123550,10550,3383,125
236129197,236127678,236137279,9601,3384,125
236143053,236141318,236151234,9916,3385,125
236156792,236155273,236164557,9284,3386,125
236170332,236168596,236178196,9600,3387,125
236183754,236182235,236190864,8629,3388,125
236196503,236194985,236204051,9066,3389,125
236209610,236208091,236217692,9601,3390,125
236223250,236221731,236230360,8629,3391,125
236236136,236234400,236242734,8334,3392,125
236248292,236246773,236257007,10234,3393,125
236262842,236261324,236271657,10333,3394,125
236277520,236275785,236285069,9284,3395,125
236290628,236289109,236298709,9600,3396,125
236304483,236302748,236312031,9283,3397,125
236317806,236316070,236325354,9284,3398,125
236331130,236329394,236338678,9284,3399,125
236344453,236342718,236352635,9917,3400,125
236358280,236356761,236366778,10017,3401,125
236372509,236370991,236379108,8117,3402,125
236384667,236383148,236392432,9284,3403,125
236398208,236396472,236406072,9600,3404,125
236411847,236410112,236420344,10232,3405,125
236425991,236424473,236434705,10232,3406,125
236440570,236438834,236449384,10550,3407,125
236455032,236453512,236463430,9918,3408,125
236469206,236467470,236477071,9601,3409,125
236482847,236481111,236491344,10233,3410,125
236496991,236495473,236505706,10233,3411,125
236511554,236510035,236518765,8730,3412,125
236524539,236522804,236531433,8629,3413,125
236537209,236535473,236546024,10551,3414,125
236551864,236550345,236558463,8118,3415,125
236564238,236562503,236572103,9600,3416,125
236577877,236576142,236586375,10233,3417,125
236592239,236590503,236601053,10550,3418,125
236606916,236605181,236614781,9600,3419,125
236620557,236618821,236628737,9916,3420,125
236634512,236632777,236643009,10232,3421,125
236648873,236647138,236655470,8332,3422,125
236661029,236659510,236668139,8629,3423,125
236673756,236672237,236680648,8411,3424,125
236686425,236684688,236694606,9918,3425,125
236700164,236698646,236707589,8943,3426,125
236713148,236711629,236719963,8334,3427,125
236725738,236724003,236734235,10232,3428,125
236739953,236738434,236746550,8116,3429,125
236752326,236750590,236760823,10233,3430,125
236766688,236764952,236773898,8946,3431,125
236779673,236777938,236787220,9282,3432,125
236792995,236791260,236800204,8944,3433,125
236805979,236804244,236812576,8332,3434,125
236818351,236816615,236825243,8628,3435,125
236830887,236829368,236838434,9066,3436,125
236844209,236842473,236853021,10548,3437,125
236858884,236857149,236865776,8627,3438,125
236871551,236869816,236879415,9599,3439,125
236884973,236883455,236893686,10231,3440,125
236899549,236897814,236906759,8945,3441,125
236912534,236910799,236919131,8332,3442,125
236924905,236923170,236931798,8628,3443,125
236937574,236935838,236946070,10232,3444,125
236951717,236950198,236960748,10550,3445,125
236966612,236964876,236975109,10233,3446,125
236980964,236979445,236988174,8729,3447,125
236993817,236992297,237001364,9067,3448,125
237007139,237005404,237015636,10232,3449,125
237021501,237019765,237029049,9284,3450,125
237034824,237033089,237042034,8945,3451,125
237047809,237046073,237054406,8333,3452,125
237060181,237058446,237066779,8333,3453,125
237072414,237070896,237080911,10015,3454,125
237086558,237085039,237094323,9284,3455,125
237100098,237098363,237107307,8944,3456,125
237113082,237111346,237120292,8946,3457,125
237125923,237124404,237134420,10016,3458,125
237140283,237138548,237147176,8628,3459,125
237152951,237151216,237161765,10549,3460,125
237167412,237165893,237176126,10233,3461,125
237181773,237180255,237189854,9599,3462,125
237195412,237193894,237204125,10231,3463,125
237209838,237208319,237218018,9699,3464,125
237223576,237222058,237232606,10548,3465,125
237238470,237236735,237246651,9916,3466,125
237252427,237250691,237260924,10233,3467,125
237266570,237265052,237274967,9915,3468,125
237280743,237279007,237287635,8628,3469,125
237293410,237291675,237301273,9598,3470,125
237306832,237305313,237314258,8945,3471,125
237319817,237318298,237326631,8333,3472,125
237332407,237330671,237339955,9284,3473,125
237345731,237343995,237352624,8629,3474,125
237358400,237356664,237365947,9283,3475,125
237371506,237369987,237380219,10232,3476,125
237385948,237384430,237393495,9065,3477,125
237399270,237397535,237408084,10549,3478,125
237413924,237412406,237422104,9698,3479,125
237427662,237426144,237435426,9282,3480,125
237441202,237439466,237449383,9917,3481,125
237455004,237453485,237463184,9699,3482,125
237468960,237467224,237476508,9284,3483,125
237482067,237480548,237490464,9916,3484,125
237496239,237494504,237505053,10549,3485,125
237510917,237509182,237517809,8627,3486,125
237523585,237521849,237531133,9284,3487,125
237536908,237535173,237543800,8627,3488,125
237549576,237547840,237556785,8945,3489,125
237562561,237560825,237569455,8630,3490,125
237575231,237573495,237582123,8628,3491,125
237587897,237586162,237596394,10232,3492,125
237602258,237600522,237610438,9916,3493,125
237616213,237614477,237625026,10549,3494,125
237630889,237629154,237638752,9598,3495,125
237644528,237642792,237653341,10549,3496,125
237659204,237657469,237665801,8332,3497,125
237671360,237669841,237678174,8333,3498,125
237683948,237682213,237692128,9915,3499,125
237697768,237696250,237706264,10014,3500,125
237711910,237710392,237719675,9283,3501,125
237725234,237723715,237733314,9599,3502,125
237738873,237737353,237746300,8947,3503,125
237752075,237750340,237759938,9598,3504,125
237765714,237763978,237774526,10548,3505,125
237780390,237778654,237787283,8629,3506,125
237792840,237791322,237799949,8627,3507,125
237805725,237803989,237813589,9600,3508,125
237819365,237817629,237827861,10232,3509,125
237833725,237831990,237841273,9283,3510,125
237847049,237845313,237854597,9284,3511,125
237860372,237858637,237868869,10232,3512,125
237874733,237872997,237882597,9600,3513,125
237888372,237886637,237895581,8944,3514,125
237901356,237899621,237908249,8628,3515,125
237913806,237912288,237922837,10549,3516,125
237928701,237926965,237935594,8629,3517,125
237941152,237939634,237948262,8628,3518,125
237954037,237952302,237962850,10548,3519,125
237968714,237966978,237976894,9916,3520,125
237982669,237980934,237991166,10232,3521,125
237997029,237995294,238004239,8945,3522,125
238009797,238008279,238018827,10548,3523,125
238024541,238023023,238031434,8411,3524,125
238037209,238035474,238044419,8945,3525,125
238050193,238048458,238057087,8629,3526,125
238062862,238061127,238071041,9914,3527,125
238076816,238075081,238085629,10548,3528,125
238091493,238089757,238099357,9600,3529,125
238105132,238103397,238113946,10549,3530,125
238119668,238118149,238128482,10333,3531,125
238134129,238132610,238141893,9283,3532,125
238147668,238145933,238154561,8628,3533,125
238160335,238158600,238167228,8628,3534,125
238173003,238171268,238179895,8627,3535,125
238185670,238183935,238193217,9282,3536,125
238198991,238197256,238207172,9916,3537,125
238212947,238211212,238219841,8629,3538,125
238225616,238223881,238234429,10548,3539,125
238240292,238238557,238248789,10232,3540,125
238254653,238252918,238262517,9599,3541,125
238268140,238266621,238275034,8413,3542,125
238280810,238279074,238288991,9917,3543,125
238294766,238293031,238302630,9599,3544,125
238308406,238306670,238316587,9917,3545,125
238322145,238320627,238328960,8333,3546,125
238334736,238333000,238342284,9284,3547,125
238347843,238346324,238355607,9283,3548,125
238361382,238359647,238367979,8332,3549,125
238373538,238372019,238382569,10550,3550,125
238388433,238386697,238395031,8334,3551,125
238400807,238399071,238407404,8333,3552,125
238413179,238411443,238421676,10233,3553,125
238427541,238425805,238436355,10550,3554,125
238442218,238440483,238449427,8944,3555,125
238455201,238453466,238461799,8333,3556,125
238467574,238465839,238475438,9599,3557,125
238480996,238479478,238488106,8628,3558,125
238493881,238492146,238501090,8944,3559,125
238506864,238505129,238515677,10548,3560,125
238521526,238520007,238528736,8729,3561,125
238534511,238532776,238543008,10232,3562,125
238548656,238547137,238556421,9284,3563,125
238562196,238560461,238571010,10549,3564,125
238576868,238575349,238585365,10016,3565,125
238591229,238589494,238598777,9283,3566,125
238604551,238602816,238612415,9599,3567,125
238618189,238616454,238626053,9599,3568,125
238631829,238630093,238638722,8629,3569,125
238644498,238642762,238652679,9917,3570,125
238658454,238656719,238666002,9283,3571,125
238671560,238670042,238679957,9915,3572,125
238685732,238683997,238693913,9916,3573,125
238699536,238698018,238707717,9699,3574,125
238713275,238711756,238721989,10233,3575,125
238727637,238726118,238736034,9916,3576,125
238741593,238740074,238750307,10233,3577,125
238756171,238754435,238764984,10549,3578,125
238770829,238769311,238777427,8116,3579,125
238783070,238781552,238789964,8412,3580,125
238795523,238794004,238802950,8946,3581,125
238808509,238806990,238816906,9916,3582,125
238822681,238820946,238831495,10549,3583,125
238837359,238835624,238843956,8332,3584,125
238849731,238847996,238858228,10232,3585,125
238864092,238862357,238872905,10548,3586,125
238878552,238877034,238887266,10232,3587,125
238893106,238891588,238901603,10015,3588,125
238907333,238905815,238915514,9699,3589,125
238921289,238919554,238928499,8945,3590,125
238934274,238932539,238941167,8628,3591,125
238946726,238945207,238955124,9917,3592,125
238960899,238959164,238969080,9916,3593,125
238974856,238973120,238983036,9916,3594,125
238988812,238987076,238996360,9284,3595,125
239001992,239000473,239010806,10333,3596,125
239016454,239014935,239023268,8333,3597,125
239029043,239027308,239037222,9914,3598,125
239042780,239041262,239051494,10232,3599,125
239057359,239055623,239064569,8946,3600,125
239070344,239068609,239078841,10232,3601,125
239084489,239082970,239093202,10232,3602,125
239099047,239097529,239106911,9382,3603,125
239112549,239111030,239119441,8411,3604,125
239125216,239123481,239134030,10549,3605,125
239139895,239138159,239147759,9600,3606,125
239153535,239151799,239160428,8629,3607,125
239165987,239164468,239174385,9917,3608,125
239180161,239178425,239188025,9600,3609,125
239193800,239192065,239201010,8945,3610,125
239206786,239205050,239215283,10233,3611,125
239221148,239219412,239229645,10233,3612,125
239235503,239233984,239242101,8117,3613,125
239247876,239246140,239256057,9917,3614,125
239261833,239260097,239269043,8946,3615,125
239274688,239273170,239281581,8411,3616,125
239287208,239285690,239294102,8412,3617,125
239299876,239298141,239307740,9599,3618,125
239313515,239311780,239320408,8628,3619,125
239326182,239324447,239333076,8629,3620,125
239338851,239337116,239346714,9598,3621,125
239352273,239350754,239359087,8333,3622,125
239364862,239363127,239371755,8628,3623,125
239377314,239375795,239386345,10550,3624,125
239391992,239390473,239399101,8628,3625,125
239404876,239403141,239412423,9282,3626,125
239418199,239416463,239426696,10233,3627,125
239432560,239430824,239441373,10549,3628,125
239447020,239445501,239454784,9283,3629,125
239460559,239458824,239469056,10232,3630,125
239474703,239473185,239482468,9283,3631,125
239488243,239486508,239495451,8943,3632,125
239501227,239499491,239509090,9599,3633,125
239514649,239513130,239522076,8946,3634,125
239527852,239526116,239535399,9283,3635,125
239541040,239539520,239548588,9068,3636,125
239554147,239552628,239561574,8946,3637,125
239567350,239565614,239574897,9283,3638,125
239580455,239578937,239588220,9283,3639,125
239593996,239592260,239601859,9599,3640,125
239607635,239605899,239616449,10550,3641,125
239622175,239620656,239629068,8412,3642,125
239634843,239633108,239642391,9283,3643,125
239648018,239646499,239656831,10332,3644,125
239662695,239660960,239670875,9915,3645,125
239676434,239674915,239683543,8628,3646,125
239689101,239687583,239695916,8333,3647,125
239701691,239699956,239710188,10232,3648,125
239716051,239714316,239724864,10548,3649,125
239730728,239728992,239737938,8946,3650,125
239743497,239741978,239751577,9599,3651,125
239757353,239755617,239765534,9917,3652,125
239771309,239769574,239778856,9282,3653,125
239784415,239782896,239792813,9917,3654,125
239798588,239796853,239806136,9283,3655,125
239811778,239810260,239818988,8728,3656,125
239824763,239823028,239833259,10231,3657,125
239839123,239837388,239847937,10549,3658,125
239853669,239852150,239860878,8728,3659,125
239866654,239864918,239875151,10233,3660,125
239881015,239879280,239888225,8945,3661,125
239893855,239892336,239902669,10333,3662,125
239908533,239906798,239916060,9262,3663,125
239921619,239920100,239929700,9600,3664,125
239935475,239933740,239943656,9916,3665,125
239949215,239947696,239957929,10233,3666,125
239963794,239962058,239971658,9600,3667,125
239977433,239975698,239985931,10233,3668,125
239991795,239990059,240000292,10233,3669,125
240006157,240004421,240014654,10233,3670,125
240020516,240018782,240027726,8944,3671,125
240033354,240031835,240042167,10332,3672,125
240047815,240046295,240055896,9601,3673,125
240061455,240059936,240069536,9600,3674,125
240075311,240073575,240083491,9916,3675,125
240089267,240087531,240096160,8629,3676,125
240101782,240100263,240109963,9700,3677,125
240115738,240114003,240123602,9599,3678,125
240129230,240127711,240137410,9699,3679,125
240143185,240141450,240151999,10549,3680,125
240157717,240156198,240166214,10016,3681,125
240172077,240170342,240179287,8945,3682,125
240185062,240183327,240191659,8332,3683,125
240197434,240195699,240205615,9916,3684,125
240211250,240209732,240218797,9065,3685,125
240224572,240222837,240231782,8945,3686,125
240237414,240235895,240245595,9700,3687,125
240251370,240249635,240258579,8944,3688,125
240264138,240262619,240272218,9599,3689,125
240277839,240276321,240286019,9698,3690,125
240291577,240290059,240299658,9599,3691,125
240305433,240303698,240313930,10232,3692,125
240319795,240318059,240327004,8945,3693,125
240332779,240331044,240341593,10549,3694,125
240347455,240345937,240355319,9382,3695,125
240361094,240359359,240368958,9599,3696,125
240374733,240372998,240381330,8332,3697,125
240387106,240385370,240394653,9283,3698,125
240400270,240398751,240408451,9700,3699,125
240414226,240412491,240420824,8333,3700,125
240426440,240424922,240433038,8116,3701,125
240438597,240437078,240447628,10550,3702,125
240453492,240451757,240460385,8628,3703,125
240466160,240464425,240473370,8945,3704,125
240479146,240477410,240487644,10234,3705,125
240493292,240491773,240501056,9283,3706,125
240506831,240505096,240514695,9599,3707,125
240520254,240518735,240527364,8629,3708,125
240533139,240531404,240540032,8628,3709,125
240545673,240544155,240552565,8410,3710,125
240558340,240556605,240565234,8629,3711,125
240570792,240569274,240578555,9281,3712,125
240584113,240582595,240592826,10231,3713,125
240598690,240596955,240605287,8332,3714,125
240611062,240609327,240619559,10232,3715,125
240625207,240623688,240632317,8629,3716,125
240638092,240636357,240646589,10232,3717,125
240652454,240650718,240661268,10550,3718,125
240667109,240665590,240675923,10333,3719,125
240681571,240680052,240689652,9600,3720,125
240695427,240693691,240703607,9916,3721,125
240709165,240707646,240715980,8334,3722,125
240721755,240720020,240728649,8629,3723,125
240734424,240732689,240743238,10549,3724,125
240749101,240747366,240756649,9283,3725,125
240762207,240760689,240770920,10231,3726,125
240776785,240775049,240784331,9282,3727,125
240789889,240788370,240798603,10233,3728,125
240804251,240802732,240812015,9283,3729,125
240817574,240816055,240825971,9916,3730,125
240831529,240830011,240839294,9283,3731,125
240845069,240843334,240853883,10549,3732,125
240859530,240858011,240868243,10232,3733,125
240873959,240872440,240882456,10016,3734,125
240888319,240886584,240895212,8628,3735,125
240900834,240899315,240908698,9383,3736,125
240914474,240912738,240922971,10233,3737,125
240928702,240927183,240935300,8117,3738,125
240940858,240939339,240949255,9916,3739,125
240960370,240958851,240968867,10016,3740,125
240974514,240972995,240983544,10549,3741,125
240989190,240987672,240996953,9281,3742,125
241002729,241000993,241009327,8334,3743,125
241015102,241013367,241023282,9915,3744,125
241028840,241027322,241035949,8627,3745,125
241041724,241039989,241049588,9599,3746,125
241055147,241053628,241063544,9916,3747,125
241069173,241067654,241076721,9067,3748,125
241082279,241080761,241089389,8628,3749,125
241095164,241093429,241102691,9262,3750,125
241108467,241106731,241116964,10233,3751,125
241122827,241121092,241129719,8627,3752,125
241135494,241133759,241142091,8332,3753,125
241147866,241146131,241156680,10549,3754,125
241162384,241160865,241169932,9067,3755,125
241175490,241173972,241182599,8627,3756,125
241188373,241186638,241195266,8628,3757,125
241201042,241199306,241207639,8333,3758,125
241213414,241211679,241221595,9916,3759,125
241227371,241225635,241235868,10233,3760,125
241241730,241239996,241250227,10231,3761,125
241255874,241254355,241262984,8629,3762,125
241268760,241267024,241276623,9599,3763,125
241282181,241280663,241290578,9915,3764,125
241296353,241294618,241303245,8627,3765,125
241308877,241307358,241316740,9382,3766,125
241322515,241320780,241330062,9282,3767,125
241335837,241334102,241344017,9915,3768,125
241349792,241348057,241356685,8628,3769,125
241362244,241360725,241371275,10550,3770,125
241377139,241375403,241384349,8946,3771,125
241389968,241388449,241398465,10016,3772,125
241404323,241402805,241412187,9382,3773,125
241417963,241416227,241426144,9917,3774,125
241431702,241430184,241439783,9599,3775,125
241445558,241443823,241453422,9599,3776,125
241459043,241457525,241467224,9699,3777,125
241473000,241471264,241481497,10233,3778,125
241487361,241485625,241494909,9284,3779,125
241500684,241498949,241509497,10548,3780,125
241515361,241513626,241521958,8332,3781,125
241527733,241525997,241534626,8629,3782,125
241540265,241538745,241546862,8117,3783,125
241552638,241550902,241559235,8333,3784,125
241564793,241563275,241572220,8945,3785,125
241577779,241576260,241585206,8946,3786,125
241590765,241589246,241598192,8946,3787,125
241603967,241602232,241612781,10549,3788,125
241618428,241616910,241627552,10642,3789,125
241633416,241631681,241641913,10232,3790,125
241647777,241646042,241654987,8945,3791,125
241660763,241659027,241668626,9599,3792,125
241674401,241672666,241682265,9599,3793,125
241688040,241686305,241696536,10231,3794,125
241702183,241700664,241710581,9917,3795,125
241716356,241714620,241723249,8629,3796,125
241728808,241727289,241737522,10233,3797,125
241743170,241741651,241750279,8628,3798,125
241756054,241754319,241762652,8333,3799,125
241768426,241766691,241776605,9914,3800,125
241782381,241780645,241789274,8629,3801,125
241795049,241793314,241802912,9598,3802,125
241808687,241806952,241816235,9283,3803,125
241822010,241820275,241828607,8332,3804,125
241834248,241832729,241840845,8116,3805,125
241846621,241844885,241853218,8333,3806,125
241858993,241857258,241865886,8628,3807,125
241871662,241869926,241880476,10550,3808,125
241886339,241884604,241894520,9916,3809,125
241900078,241898560,241909108,10548,3810,125
241914972,241913237,241923153,9916,3811,125
241928929,241927193,241937743,10550,3812,125
241943391,241941871,241951472,9601,3813,125
241957247,241955512,241966061,10549,3814,125
241971925,241970190,241979134,8944,3815,125
241984909,241983174,241992772,9598,3816,125
241998547,241996812,242005144,8332,3817,125
242010920,242009184,242017813,8629,3818,125
242023371,242021853,242031135,9282,3819,125
242036910,242035175,242043803,8628,3820,125
242049361,242047843,242057442,9599,3821,125
242063001,242061482,242071398,9916,3822,125
242077173,242075438,242084720,9282,3823,125
242090338,242088820,242097231,8411,3824,125
242103006,242101271,242111186,9915,3825,125
242116816,242115297,242124363,9066,3826,125
242129922,242128403,242138636,10233,3827,125
242144500,242142765,242151098,8333,3828,125
242156874,242155138,242164401,9263,3829,125
242170176,242168441,242178673,10232,3830,125
242184319,242182801,242193350,10549,3831,125
242199213,242197478,242207077,9599,3832,125
242212697,242211179,242219590,8411,3833,125
242225365,242223630,242233545,9915,3834,125
242239104,242237585,242246869,9284,3835,125
242252644,242250909,242259853,8944,3836,125
242265494,242263976,242273992,10016,3837,125
242279639,242278121,242287065,8944,3838,125
242292706,242291187,242300887,9700,3839,125
242306662,242304927,242314525,9598,3840,125
242320301,242318565,242328798,10233,3841,125
242334663,242332927,242343160,10233,3842,125
242349015,242347496,242357512,10016,3843,125
242363365,242361847,242370913,9066,3844,125
242376555,242375036,242383765,8729,3845,125
242389324,242387805,242396139,8334,3846,125
242401698,242400179,242409778,9599,3847,125
242415553,242413818,242424367,10549,3848,125
242430231,242428495,242437440,8945,3849,125
242443215,242441480,242450109,8629,3850,125
242455884,242454149,242464065,9916,3851,125
242469840,242468105,242476734,8629,3852,125
242482292,242480774,242491322,10548,3853,125
242497170,242495652,242503768,8116,3854,125
242509542,242507807,242516435,8628,3855,125
242522210,242520475,242529757,9282,3856,125
242535533,242533797,242544346,10549,3857,125
242550210,242548475,242556807,8332,3858,125
242562582,242560847,242570446,9599,3859,125
242576004,242574485,242583768,9283,3860,125
242589327,242587808,242598041,10233,3861,125
242603885,242602366,242612065,9699,3862,125
242617840,242616104,242624438,8334,3863,125
242629997,242628478,242638077,9599,3864,125
242643853,242642117,242651063,8946,3865,125
242656622,242655103,242663435,8332,3866,125
242669210,242667475,242676758,9283,3867,125
242682317,242680798,242690081,9283,3868,125
242695639,242694121,242703720,9599,3869,125
242709495,242707760,242718309,10549,3870,125
242724172,242722437,242732986,10549,3871,125
242738633,242737114,242745447,8333,3872,125
242751005,242749487,242759718,10231,3873,125
242765582,242763846,242774079,10233,3874,125
242779925,242778407,242788422,10015,3875,125
242794272,242792753,242802768,10015,3876,125
242808632,242806897,242816178,9281,3877,125
242821735,242820217,242830765,10548,3878,125
242836412,242834893,242844492,9599,3879,125
242850268,242848532,242857477,8945,3880,125
242863252,242861517,242869850,8333,3881,125
242875624,242873889,242883487,9598,3882,125
242889262,242887527,242896472,8945,3883,125
242902247,242900512,242909141,8629,3884,125
242914917,242913181,242922781,9600,3885,125
242928340,242926821,242937054,10233,3886,125
242942898,242941379,242949496,8117,3887,125
242955273,242953536,242963770,10234,3888,125
242969417,242967898,242977182,9284,3889,125
242982957,242981222,242990505,9283,3890,125
242996281,242994545,243005095,10550,3891,125
243010959,243009224,243019773,10549,3892,125
243025637,243023901,243032234,8333,3893,125
243038010,243036274,243044903,8629,3894,125
243050678,243048943,243057888,8945,3895,125
243063446,243061928,243070872,8944,3896,125
243076516,243074997,243083409,8412,3897,125
243089184,243087449,243097365,9916,3898,125
243103141,243101405,243111322,9917,3899,125
243117097,243115362,243124307,8945,3900,125
243129939,243128420,243137486,9066,3901,125
243143261,243141526,243152075,10549,3902,125
243157939,243156203,243165802,9599,3903,125
243171577,243169842,243178175,8333,3904,125
243183808,243182289,243192622,10333,3905,125
243198487,243196751,243206985,10234,3906,125
243212849,243211114,243219742,8628,3907,125
243225300,243223782,243232410,8628,3908,125
243238186,243236450,243245732,9282,3909,125
243251507,243249772,243258716,8944,3910,125
243264491,243262756,243272988,10232,3911,125
243278833,243277315,243286697,9382,3912,125
243292328,243290809,243300825,10016,3913,125
243306473,243304954,243315187,10233,3914,125
243321052,243319316,243328262,8946,3915,125
243333819,243332301,243342533,10232,3916,125
243348397,243346662,243356261,9599,3917,125
243361820,243360301,243370850,10549,3918,125
243376714,243374978,243385527,10549,3919,125
243391173,243389655,243400203,10548,3920,125
243406067,243404331,243414881,10550,3921,125
243420744,243419009,243428924,9915,3922,125
243434699,243432964,243442246,9282,3923,125
243448021,243446285,243455884,9599,3924,125
243461660,243459924,243468258,8334,3925,125
243473816,243472297,243481897,9600,3926,125
243487672,243485937,243494882,8945,3927,125
243500657,243498922,243507866,8944,3928,125
243513425,243511906,243522138,10232,3929,125
243527990,243526472,243536487,10015,3930,125
243542352,243540616,243550533,9917,3931,125
243556308,243554573,243565122,10549,3932,125
243570985,243569250,243578849,9599,3933,125
243584408,243582889,243591223,8334,3934,125
243596998,243595263,243604546,9283,3935,125
243610322,243608586,243618186,9600,3936,125
243623745,243622226,243631172,8946,3937,125
243636947,243635212,243644811,9599,3938,125
243650586,243648851,243658450,9599,3939,125
243664224,243662489,243671771,9282,3940,125
243677546,243675811,243686359,10548,3941,125
243692223,243690488,243700086,9598,3942,125
243705862,243704126,243712459,8333,3943,125
243718017,243716499,243726098,9599,3944,125
243731874,243730138,243739738,9600,3945,125
243745512,243743777,243754326,10549,3946,125
243760175,243758656,243767068,8412,3947,125
243772689,243771170,243780869,9699,3948,125
243786427,243784909,243794825,9916,3949,125
243800600,243798865,243807492,8627,3950,125
243813268,243811532,243821449,9917,3951,125
243827224,243825488,243834770,9282,3952,125
243840546,243838810,243847439,8629,3953,125
243853081,243851562,243861578,10016,3954,125
243867303,243865785,243873900,8115,3955,125
243879675,243877940,243886273,8333,3956,125
243892047,243890312,243900228,9916,3957,125
243906003,243904268,243912895,8627,3958,125
243918671,243916935,243926534,9599,3959,125
243932162,243930643,243939054,8411,3960,125
243944831,243943094,243953644,10550,3961,125
243959508,243957773,243966401,8628,3962,125
243972176,243970441,243980040,9599,3963,125
243985598,243984080,243994312,10232,3964,125
244000175,243998440,244008038,9598,3965,125
244013598,244012078,244020413,8335,3966,125
244026187,244024452,244034051,9599,3967,125
244039825,244038090,244048322,10232,3968,125
244054186,244052451,244062999,10548,3969,125
244068647,244067128,244077361,10233,3970,125
244083225,244081490,244091089,9599,3971,125
244096865,244095129,244103758,8629,3972,125
244109317,244107798,244118347,10549,3973,125
244124211,244122476,244132391,9915,3974,125
244138167,244136431,244145060,8629,3975,125
244150619,244149100,244158383,9283,3976,125
244164158,244162423,244172022,9599,3977,125
244177655,244176136,244185519,9383,3978,125
244191295,244189559,244197893,8334,3979,125
244203668,244201933,244210876,8943,3980,125
244216652,244214916,244225149,10233,3981,125
244230870,244229351,244237763,8412,3982,125
244243539,244241803,244251403,9600,3983,125
244257178,244255443,244264071,8628,3984,125
244269846,244268111,244278027,9916,3985,125
244283648,244282130,244291512,9382,3986,125
244297071,244295552,244306101,10549,3987,125
244311748,244310230,244318858,8628,3988,125
244324633,244322898,244333447,10549,3989,125
244339094,244337576,244345909,8333,3990,125
244351467,244349949,244360497,10548,3991,125
244366217,244364699,244372815,8116,3992,125
244378591,244376855,244385188,8333,3993,125
244390747,244389228,244399145,9917,3994,125
244404920,244403185,244411518,8333,3995,125
244417076,244415558,244425790,10232,3996,125
244431654,244429919,244438252,8333,3997,125
244444028,244442292,244452525,10233,3998,125
244458390,244456654,244465937,9283,3999,125
244471712,244469977,244479893,9916,4000,125
244485524,244484006,244492417,8411,4001,125
244498192,244496456,244507006,10550,4002,125
244512860,244511342,244521674,10332,4003,125
244527390,244525872,244534283,8411,4004,125
244539914,244538396,244548411,10015,4005,125
244554269,244552751,244561162,8411,4006,125
244566937,244565202,244575117,9915,4007,125
244580735,244579217,244587628,8411,4008,125
244593187,244591668,244600613,8945,4009,125
244606232,244604714,244613126,8412,4010,125
244618901,244617166,244627082,9916,4011,125
244632641,244631122,244641671,10549,4012,125
244647534,244645799,244654426,8627,4013,125
244660201,244658466,244668382,9916,4014,125
244674026,244672507,244682839,10332,4015,125
244688703,244686968,244697516,10548,4016,125
244703381,244701645,244711245,9600,4017,125
244716803,244715285,244723913,8628,4018,125
244729688,244727953,244738184,10231,4019,125
244744048,244742313,244751595,9282,4020,125
244757370,244755635,244764917,9282,4021,125
244770692,244768957,244779506,10549,4022,125
244785361,244783842,244791959,8117,4023,125
244797518,244795999,244805916,9917,4024,125
244811692,244809956,244818289,8333,4025,125
244824064,244822328,244831274,8946,4026,125
244837049,244835314,244843647,8333,4027,125
244849423,244847687,244856633,8946,4028,125
244862408,244860673,244871222,10549,4029,125
244876869,244875351,244885583,10232,4030,125
244891447,244889712,244900260,10548,4031,125
244906124,244904388,244914305,9917,4032,125
244919939,244918421,244927149,8728,4033,125
244932766,244931247,244940630,9383,4034,125
244946260,244944742,244955074,10332,4035,125
244960722,244959203,244969753,10550,4036,125
244975616,244973881,244984113,10232,4037,125
244989976,244988241,244998790,10549,4038,125
245004437,245002918,245012201,9283,4039,125
245017977,245016241,245024574,8333,4040,125
245030349,245028614,245038847,10233,4041,125
245044711,245042976,245052892,9916,4042,125
245058667,245056932,245067480,10548,4043,125
245073344,245071609,245080554,8945,4044,125
245086329,245084594,245094510,9916,4045,125
245100286,245098550,245107495,8945,4046,125
245113271,245111535,245120165,8630,4047,125
245125941,245124205,245132835,8630,4048,125
245138393,245136875,245145503,8628,4049,125
245151279,245149543,245159776,10233,4050,125
245165481,245163963,245173029,9066,4051,125
245178804,245177069,245185401,8332,4052,125
245191176,245189441,245198070,8629,4053,125
245203628,245202110,245211709,9599,4054,125
245217484,245215749,245224082,8333,4055,125
245229858,245228122,245238355,10233,4056,125
245244219,245242484,245252399,9915,4057,125
245258176,245256439,245266673,10234,4058,125
245272537,245270802,245281034,10232,4059,125
245286764,245285245,245295578,10333,4060,125
245301429,245299909,245308323,8414,4061,125
245313940,245312421,245321803,9382,4062,125
245327578,245325843,245335441,9598,4063,125
245341216,245339481,245350029,10548,4064,125
245355883,245354365,245364381,10016,4065,125
245370100,245368582,245378913,10331,4066,125
245384765,245383247,245391658,8411,4067,125
245397434,245395698,245404031,8333,4068,125
245409807,245408071,245418620,10549,4069,125
245424485,245422749,245431695,8946,4070,125
245437253,245435735,245444068,8333,4071,125
245449844,245448108,245458658,10550,4072,125
245464521,245462786,245473018,10232,4073,125
245478882,245477147,245486430,9283,4074,125
245492205,245490470,245500702,10232,4075,125
245506567,245504831,245514431,9600,4076,125
245520207,245518471,245527754,9283,4077,125
245533529,245531794,245542027,10233,4078,125
245547674,245546156,245556705,10549,4079,125
245562568,245560833,245571382,10549,4080,125
245577223,245575704,245583821,8117,4081,125
245589596,245587861,245598409,10548,4082,125
245604057,245602538,245611821,9283,4083,125
245617464,245615945,245626278,10333,4084,125
245631991,245630473,245639856,9383,4085,125
245645631,245643896,245652524,8628,4086,125
245658299,245656564,245664897,8333,4087,125
245670672,245668937,245678852,9915,4088,125
245684628,245682892,245692176,9284,4089,125
245697734,245696216,245705499,9283,4090,125
245711057,245709539,245719138,9599,4091,125
245724913,245723178,245732123,8945,4092,125
245737898,245736163,245745762,9599,4093,125
245751538,245749802,245758136,8334,4094,125
245763911,245762176,245772725,10549,4095,125
245778571,245777052,245787385,10333,4096,125
245793031,245791512,245800794,9282,4097,125
245806351,245804833,245813164,8331,4098,125
245818721,245817203,245825831,8628,4099,125
245831389,245829870,245839469,9599,4100,125
245845245,245843509,245853108,9599,4101,125
245858882,245857147,245866745,9598,4102,125
245872520,245870784,245880068,9284,4103,125
245885842,245884107,245893052,8945,4104,125
245898827,245897092,245907008,9916,4105,125
245912783,245911048,245919676,8628,4106,125
245925452,245923715,245932662,8947,4107,125
245938437,245936701,245945647,8946,4108,125
245951421,245949686,245959918,10232,4109,125
245965782,245964046,245974596,10550,4110,125
245980242,245978724,245987352,8628,4111,125
245993127,245991391,245999724,8333,4112,125
246005500,246003764,246013681,9917,4113,125
246019456,246017721,246027635,9914,4114,125
246033410,246031675,246040619,8944,4115,125
246046395,246044659,246055209,10550,4116,125
246060857,246059338,246068283,8945,4117,125
246073841,246072323,246082871,10548,4118,125
246088735,246086999,246096916,9917,4119,125
246102691,246100956,246110555,9599,4120,125
246116330,246114595,246123540,8945,4121,125
246129314,246127579,246136207,8628,4122,125
246141983,246140247,246150164,9917,4123,125
246155939,246154204,246163148,8944,4124,125
246168923,246167188,246177737,10549,4125,125
246183384,246181865,246192415,10550,4126,125
246198278,246196543,246206775,10232,4127,125
246212638,246210903,246219848,8945,4128,125
246225624,246223888,246233487,9599,4129,125
246239262,246237527,246248076,10549,4130,125
246253780,246252261,246261327,9066,4131,125
246267102,246265367,246273700,8333,4132,125
246279476,246277740,246287657,9917,4133,125
246293294,246291775,246302107,10332,4134,125
246307824,246306305,246315688,9383,4135,125
246321463,246319728,246328061,8333,4136,125
246333836,246332101,246341384,9283,4137,125
246347160,246345424,246354054,8630,4138,125
246359613,246358094,246367377,9283,4139,125
246373152,246371417,246379749,8332,4140,125
246385379,246383860,246392927,9067,4141,125
246398568,246397049,246405460,8411,4142,125
246411235,246409500,246418128,8628,4143,125
246423902,246422167,246430499,8332,4144,125
246436274,246434538,246443484,8946,4145,125
246449109,246447590,246457289,9699,4146,125
246463063,246461328,246470273,8945,4147,125
246476048,246474313,246484544,10231,4148,125
246490191,246488672,246498905,10233,4149,125
246504768,246503033,246511977,8944,4150,125
246517536,246516017,246526250,10233,4151,125
246532114,246530378,246539006,8628,4152,125
246544780,246543045,246552328,9283,4153,125
246557886,246556367,246565313,8946,4154,125
246570872,246569353,246578953,9600,4155,125
246584729,246582993,246591939,8946,4156,125
246597497,246595979,246604607,8628,4157,125
246610228,246608709,246617121,8412,4158,125
246622897,246621161,246630106,8945,4159,125
246635881,246634145,246643408,9263,4160,125
246648967,246647448,246656731,9283,4161,125
246662348,246660829,246670528,9699,4162,125
246676086,246674567,246684166,9599,4163,125
246689940,246688205,246698437,10232,4164,125
246704301,246702566,246711510,8944,4165,125
246717147,246715628,246725643,10015,4166,125
246731507,246729771,246738399,8628,4167,125
246744174,246742439,246751721,9282,4168,125
246757279,246755760,246765360,9600,4169,125
246771135,246769400,246778344,8944,4170,125
246784119,246782384,246791012,8628,4171,125
246796655,246795136,246803865,8729,4172,125
246809641,246807905,246816850,8945,4173,125
246822624,246820889,246829517,8628,4174,125
246835077,246833557,246843790,10233,4175,125
246849630,246848111,246857494,9383,4176,125
246863268,246861533,246870816,9283,4177,125
246876591,246874856,246884454,9598,4178,125
246890228,246888494,246898407,9913,4179,125
246904028,246902510,246911238,8728,4180,125
246916795,246915277,246924221,8944,4181,125
246929996,246928261,246938809,10548,4182,125
246944455,246942937,246953169,10232,4183,125
246959032,246957297,246965924,8627,4184,125
246971699,246969964,246979247,9283,4185,125
246984806,246983287,246993837,10550,4186,125
246999701,246997966,247006594,8628,4187,125
247012369,247010634,247021183,10549,4188,125
247026830,247025312,247035860,10548,4189,125
247041725,247039989,247048322,8333,4190,125
247054098,247052362,247061646,9284,4191,125
247067286,247065767,247073883,8116,4192,125
247079658,247077922,247088471,10549,4193,125
247094117,247092599,247101880,9281,4194,125
247107654,247105919,247115834,9915,4195,125
247121609,247119874,247128207,8333,4196,125
247133982,247132246,247141846,9600,4197,125
247147622,247145886,247155486,9600,4198,125
247161045,247159526,247168155,8629,4199,125
247173931,247172195,247182111,9916,4200,125
247187886,247186151,247195096,8945,4201,125
247200655,247199136,247208419,9283,4202,125
247214194,247212459,247222375,9916,4203,125
247227933,247226415,247236646,10231,4204,125
247242510,247240774,247250058,9284,4205,125
247255833,247254098,247262429,8331,4206,125
247268204,247266469,247275096,8627,4207,125
247280871,247279136,247288734,9598,4208,125
247294509,247292774,247302057,9283,4209,125
247307616,247306097,247314726,8629,4210,125
247320370,247318852,247327580,8728,4211,125
247333356,247331620,247340566,8946,4212,125
247346341,247344606,247355154,10548,4213,125
247360802,247359283,247368229,8946,4214,125
247374004,247372269,247380602,8333,4215,125
247386239,247384720,247393133,8413,4216,125
247398908,247397173,247406455,9282,4217,125
247412014,247410495,247419123,8628,4218,125
247424898,247423163,247432761,9598,4219,125
247438536,247436801,247445133,8332,4220,125
247450907,247449172,247458117,8945,4221,125
247463893,247462157,247472073,9916,4222,125
247477848,247476113,247485058,8945,4223,125
247490834,247489098,247497727,8629,4224,125
247503286,247501767,247510101,8334,4225,125
247515877,247514141,247523740,9599,4226,125
247529515,247527780,247536407,8627,4227,125
247542183,247540447,247550996,10549,4228,125
247556728,247555209,247563620,8411,4229,125
247569254,247567735,247577435,9700,4230,125
247582993,247581475,247591707,10232,4231,125
247597571,247595836,247604781,8945,4232,125
247610339,247608821,247617153,8332,4233,125
247622712,247621193,247630138,8945,4234,125
247635914,247634178,247642512,8334,4235,125
247648288,247646552,247655835,9283,4236,125
247661610,247659875,247668208,8333,4237,125
247673766,247672248,247680581,8333,4238,125
247686139,247684621,247695170,10549,4239,125
247701034,247699299,247709847,10548,4240,125
247715711,247714192,247722605,8413,4241,125
247728164,247726645,247735274,8629,4242,125
247741051,247739314,247749230,9916,4243,125
247754787,247753269,247762867,9598,4244,125
247768508,247766990,247777321,10331,4245,125
247783186,247781450,247789783,8333,4246,125
247795342,247793823,247803423,9600,4247,125
247809198,247807463,247816091,8628,4248,125
247821867,247820131,247828464,8333,4249,125
247834023,247832504,247841449,8945,4250,125
247847225,247845489,247856038,10549,4251,125
247861900,247860382,247869763,9381,4252,125
247875538,247873803,247884352,10549,4253,125
247890215,247888480,247899029,10549,4254,125
247904893,247903157,247911785,8628,4255,125
247917560,247915825,247924158,8333,4256,125
247929934,247928198,247938115,9917,4257,125
247943891,247942155,247951101,8946,4258,125
247956717,247955198,247964581,9383,4259,125
247970356,247968621,247977566,8945,4260,125
247983342,247981606,247990236,8630,4261,125
247995794,247994276,248003221,8945,4262,125
248008996,248007261,248015593,8332,4263,125
248021151,248019632,248029549,9917,4264,125
248035324,248033588,248042871,9283,4265,125
248048646,248046911,248056194,9283,4266,125
248061969,248060233,248069494,9261,4267,125
248075053,248073534,248082163,8629,4268,125
248087937,248086203,248095485,9282,4269,125
248101261,248099525,248108809,9284,4270,125
248114367,248112848,248123081,10233,4271,125
248128729,248127210,248137760,10550,4272,125
248143475,248141956,248150685,8729,4273,125
248156243,248154725,248164956,10231,4274,125
248170605,248169085,248178370,9285,4275,125
248184145,248182410,248192008,9598,4276,125
248197783,248196048,248204676,8628,4277,125
248210295,248208776,248219109,10333,4278,125
248224973,248223237,248232837,9600,4279,125
248238613,248236877,248247110,10233,4280,125
248252758,248251239,248260523,9284,4281,125
248266083,248264563,248273509,8946,4282,125
248279068,248277549,248287466,9917,4283,125
248293242,248291506,248299840,8334,4284,125
248305485,248303966,248313348,9382,4285,125
248318906,248317388,248327936,10548,4286,125
248333800,248332065,248342614,10549,4287,125
248348261,248346742,248355688,8946,4288,125
248361332,248359813,248367930,8117,4289,125
248373488,248371970,248380915,8945,4290,125
248386691,248384955,248395187,10232,4291,125
248401052,248399316,248407945,8629,4292,125
248413720,248411985,248420930,8945,4293,125
248426706,248424970,248433599,8629,4294,125
248439158,248437639,248446922,9283,4295,125
248452697,248450962,248459295,8333,4296,125
248465071,248463335,248472935,9600,4297,125
248478709,248476974,248487206,10232,4298,125
248493071,248491335,248501885,10550,4299,125
248507722,248506203,248514616,8413,4300,125
248520392,248518656,248528256,9600,4301,125
248533814,248532295,248540924,8629,4302,125
248546700,248544964,248554246,9282,4303,125
248560022,248558286,248566619,8333,4304,125
248572394,248570659,248578992,8333,4305,125
248584551,248583032,248593581,10549,4306,125
248599444,248597709,248606990,9281,4307,125
248612765,248611030,248620312,9282,4308,125
248625870,248624352,248634900,10548,4309,125
248640548,248639029,248647658,8629,4310,125
248653434,248651698,248662248,10550,4311,125
248668111,248666376,248675004,8628,4312,125
248680779,248679044,248688327,9283,4313,125
248694103,248692367,248701312,8945,4314,125
248706871,248705352,248714636,9284,4315,125
248720411,248718676,248727008,8332,4316,125
248732644,248731126,248740825,9699,4317,125
248746600,248744864,248753198,8334,4318,125
248758974,248757238,248765572,8334,4319,125
248771348,248769612,248778558,8946,4320,125
248784334,248782598,248791544,8946,4321,125
248797319,248795584,248805182,9598,4322,125
248810957,248809222,248818167,8945,4323,125
248823793,248822274,248831973,9699,4324,125
248837748,248836013,248844641,8628,4325,125
248850273,248848754,248857821,9067,4326,125
248863596,248861861,248872094,10233,4327,125
248877943,248876424,248885807,9383,4328,125
248891582,248889847,248899445,9598,4329,125
248905220,248903485,248913084,9599,4330,125
248918859,248917124,248927040,9916,4331,125
248932815,248931080,248940363,9283,4332,125
248945922,248944403,248954319,9916,4333,125
248960094,248958359,248968590,10231,4334,125
248974454,248972719,248982951,10232,4335,125
248988788,248987269,248996336,9067,4336,125
249002112,249000376,249009976,9600,4337,125
249015751,249014016,249024565,10549,4338,125
249030415,249028896,249037624,8728,4339,125
249043400,249041664,249049998,8334,4340,125
249055557,249054038,249062666,8628,4341,125
249068440,249066705,249075038,8333,4342,125
249080596,249079078,249088359,9281,4343,125
249093916,249092398,249101343,8945,4344,125
249107118,249105383,249113715,8332,4345,125
249119273,249117754,249127354,9600,4346,125
249132911,249131393,249140338,8945,4347,125
249145897,249144378,249154294,9916,4348,125
249160070,249158334,249166668,8334,4349,125
249172444,249170708,249180625,9917,4350,125
249186242,249184723,249193789,9066,4351,125
249199347,249197829,249207745,9916,4352,125
249213521,249211785,249220413,8628,4353,125
249226188,249224453,249234369,9916,4354,125
249240144,249238409,249248957,10548,4355,125
249254604,249253085,249261419,8334,4356,125
249267038,249265520,249273931,8411,4357,125
249279707,249277971,249288204,10233,4358,125
249294067,249292332,249300664,8332,4359,125
249306307,249304788,249313517,8729,4360,125
249319076,249317557,249326841,9284,4361,125
249332470,249330951,249340967,10016,4362,125
249346830,249345096,249353427,8331,4363,125
249359202,249357467,249367383,9916,4364,125
249373158,249371423,249380051,8628,4365,125
249385826,249384091,249392719,8628,4366,125
249398494,249396759,249405091,8332,4367,125
249410734,249409215,249419231,10016,4368,125
249424878,249423359,249433909,10550,4369,125
249439773,249438255,249446983,8728,4370,125
249452760,249451023,249461573,10550,4371,125
249467275,249465757,249474485,8728,4372,125
249480107,249478588,249487971,9383,4373,125
249493746,249492011,249500640,8629,4374,125
249506415,249504680,249513624,8944,4375,125
249519183,249517664,249528214,10550,4376,125
249533862,249532343,249542893,10550,4377,125
249548757,249547022,249555967,8945,4378,125
249561743,249560007,249569924,9917,4379,125
249575559,249574041,249582157,8116,4380,125
249587716,249586197,249594529,8332,4381,125
249600304,249598569,249606901,8332,4382,125
249612460,249610941,249619274,8333,4383,125
249625049,249623314,249631942,8628,4384,125
249637718,249635982,249644316,8334,4385,125
249650092,249648356,249658273,9917,4386,125
249664049,249662313,249671913,9600,4387,125
249677688,249675953,249685869,9916,4388,125
249691644,249689909,249698537,8628,4389,125
249704313,249702577,249711522,8945,4390,125
249717080,249715561,249725478,9917,4391,125
249731252,249729517,249739749,10232,4392,125
249745613,249743878,249752506,8628,4393,125
249758066,249756546,249764881,8335,4394,125
249770656,249768921,249777865,8944,4395,125
249783424,249781905,249791505,9600,4396,125
249797281,249795545,249805461,9916,4397,125
249811236,249809501,249817834,8333,4398,125
249823610,249821874,249832107,10233,4399,125
249837972,249836236,249844569,8333,4400,125
249850128,249848609,249858525,9916,4401,125
249864300,249862565,249872164,9599,4402,125
249877722,249876204,249884831,8627,4403,125
249890389,249888870,249897499,8629,4404,125
249903273,249901538,249911454,9916,4405,125
249917230,249915494,249925410,9916,4406,125
249930969,249929450,249939682,10232,4407,125
249945545,249943810,249952143,8333,4408,125
249957919,249956183,249965783,9600,4409,125
249971558,249969823,249979422,9599,4410,125
249984981,249983462,249992745,9283,4411,125
249998521,249996785,250006068,9283,4412,125
250011705,250010187,250020202,10015,4413,125
250026065,250024330,250033613,9283,4414,125
250039389,250037653,250046599,8946,4415,125
250052158,250050639,250061188,10549,4416,125
250066835,250065316,250075233,9917,4417,125
250081008,250079273,250089822,10549,4418,125
250095468,250093950,250103211,9261,4419,125
250108828,250107309,250115425,8116,4420,125
250121199,250119464,250128091,8627,4421,125
250133866,250132131,250141729,9598,4422,125
250147357,250145837,250154566,8729,4423,125
250160124,250158606,250167551,8945,4424,125
250173326,250171591,250179924,8333,4425,125
250185699,250183964,250192592,8628,4426,125
250198368,250196632,250206864,10232,4427,125
250212728,250210993,250219937,8944,4428,125
250225582,250224064,250234395,10331,4429,125
250240260,250238524,250248440,9916,4430,125
250254215,250252480,250260812,8332,4431,125
250266371,250264852,250275402,10550,4432,125
250281050,250279531,250288476,8945,4433,125
250294250,250292515,250300847,8332,4434,125
250306406,250304887,250313516,8629,4435,125
250319292,250317556,250326839,9283,4436,125
250332398,250330879,250341429,10550,4437,125
250347139,250345621,250354349,8728,4438,125
250360124,250358389,250367650,9261,4439,125
250373426,250371690,250380319,8629,4440,125
250385956,250384438,250394453,10015,4441,125
250400317,250398582,250407210,8628,4442,125
250412768,250411250,250420849,9599,4443,125
250426473,250424954,250435286,10332,4444,125
250440934,250439415,250448361,8946,4445,125
250453919,250452401,250461028,8627,4446,125
250466804,250465068,250474668,9600,4447,125
250480443,250478708,250487336,8628,4448,125
250492895,250491376,250500005,8629,4449,125
250505780,250504045,250512378,8333,4450,125
250517937,250516418,250526966,10548,4451,125
250532829,250531094,250541009,9915,4452,125
250546784,250545049,250554331,9282,4453,125
250560107,250558371,250568604,10233,4454,125
250574251,250572733,250581066,8333,4455,125
250586842,250585106,250595023,9917,4456,125
250600798,250599063,250609295,10232,4457,125
250615160,250613424,250622052,8628,4458,125
250627684,250626165,250634281,8116,4459,125
250640056,250638321,250647265,8944,4460,125
250652823,250651305,250660249,8944,4461,125
250665809,250664289,250673573,9284,4462,125
250679349,250677613,250686896,9283,4463,125
250692672,250690936,250700852,9916,4464,125
250706628,250704892,250714175,9283,4465,125
250719950,250718215,250728446,10231,4466,125
250734093,250732575,250741203,8628,4467,125
250746978,250745243,250755474,10231,4468,125
250761339,250759603,250770152,10549,4469,125
250775799,250774281,250784196,9915,4470,125
250789971,250788236,250798468,10232,4471,125
250804334,250802597,250812831,10234,4472,125
250818696,250816960,250826560,9600,4473,125
250832335,250830600,250839545,8945,4474,125
250845320,250843585,250852214,8629,4475,125
250857989,250856254,250866486,10232,4476,125
250872333,250870814,250879542,8728,4477,125
250885318,250883582,250891915,8333,4478,125
250897471,250895954,250904285,8331,4479,125
250910060,250908325,250918874,10549,4480,125
250924739,250923003,250931632,8629,4481,125
250937408,250935672,250944955,9283,4482,125
250950729,250948994,250957326,8332,4483,125
250963102,250961366,250969700,8334,4484,125
250975474,250973739,250983020,9281,4485,125
250988795,250987060,250997608,10548,4486,125
251003472,251001736,251011020,9284,4487,125
251016796,251015060,251023394,8334,4488,125
251029169,251027434,251036062,8628,4489,125
251041837,251040102,251049047,8945,4490,125
251054681,251053162,251061574,8412,4491,125
251067351,251065614,251073948,8334,4492,125
251079506,251077987,251088536,10549,4493,125
251094399,251092664,251102580,9916,4494,125
251108138,251106620,251117169,10549,4495,125
251122895,251121376,251129788,8412,4496,125
251135347,251133828,251143428,9600,4497,125
251148987,251147468,251156096,8628,4498,125
251161872,251160136,251168765,8629,4499,125
251174383,251172865,251181593,8728,4500,125
251187151,251185633,251194915,9282,4501,125
251200690,251198955,251208216,9261,4502,125
251213991,251212256,251220589,8333,4503,125
251226147,251224629,251234543,9914,4504,125
251240188,251238669,251247398,8729,4505,125
251253174,251251438,251261355,9917,4506,125
251267131,251265395,251274995,9600,4507,125
251280770,251279035,251289583,10548,4508,125
251295447,251293712,251304260,10548,4509,125
251309981,251308462,251318478,10016,4510,125
251324342,251322607,251331890,9283,4511,125
251337665,251335930,251346478,10548,4512,125
251352343,251350607,251359891,9284,4513,125
251365667,251363931,251373848,9917,4514,125
251379407,251377888,251388121,10233,4515,125
251393769,251392250,251402166,9916,4516,125
251407941,251406206,251415805,9599,4517,125
251421363,251419845,251429761,9916,4518,125
251435319,251433801,251443717,9916,4519,125
251449276,251447757,251456091,8334,4520,125
251461867,251460131,251470364,10233,4521,125
251476220,251474701,251483767,9066,4522,125
251489542,251487807,251498040,10233,4523,125
251503688,251502169,251510798,8629,4524,125
251516573,251514838,251524121,9283,4525,125
251529897,251528161,251537760,9599,4526,125
251543318,251541800,251551082,9282,4527,125
251556858,251555122,251564068,8946,4528,125
251569843,251568108,251576441,8333,4529,125
251582216,251580481,251589109,8628,4530,125
251594668,251593149,251604532,11383,4531,125
251610179,251608660,251617944,9284,4532,125
251623719,251621984,251630612,8628,4533,125
251636171,251634652,251645201,10549,4534,125
251650849,251649330,251658929,9599,4535,125
251664704,251662969,251672250,9281,4536,125
251678025,251676290,251684623,8333,4537,125
251690397,251688662,251699211,10549,4538,125
251705074,251703339,251713570,10231,4539,125
251719285,251717767,251726178,8411,4540,125
251731952,251730217,251740132,9915,4541,125
251745770,251744252,251753634,9382,4542,125
251759409,251757674,251767590,9916,4543,125
251773366,251771630,251781863,10233,4544,125
251787570,251786051,251794168,8117,4545,125
251799943,251798207,251807152,8945,4546,125
251812927,251811192,251820475,9283,4547,125
251826251,251824515,251832848,8333,4548,125
251838622,251836887,251847118,10231,4549,125
251852981,251851246,251861162,9916,4550,125
251866721,251865202,251875435,10233,4551,125
251881083,251879564,251888192,8628,4552,125
251893967,251892232,251901830,9598,4553,125
251907388,251905870,251915784,9914,4554,125
251921560,251919824,251929107,9283,4555,125
251934881,251933146,251943378,10232,4556,125
251949232,251947713,251955830,8117,4557,125
251961606,251959870,251968499,8629,4558,125
251974274,251972539,251981483,8944,4559,125
251987259,251985523,251994151,8628,4560,125
251999927,251998191,252008740,10549,4561,125
252014387,252012868,252021814,8946,4562,125
252027371,252025853,252036402,10549,4563,125
252042266,252040530,252049813,9283,4564,125
252055587,252053852,252062185,8333,4565,125
252067961,252066225,252074559,8334,4566,125
252080333,252078599,252088512,9913,4567,125
252094287,252092552,252101179,8627,4568,125
252106738,252105219,252115136,9917,4569,125
252120911,252119176,252128121,8945,4570,125
252133897,252132161,252142394,10233,4571,125
252148232,252146714,252156728,10014,4572,125
252162376,252160857,252171090,10233,4573,125
252176736,252175218,252183845,8627,4574,125
252189621,252187885,252197802,9917,4575,125
252203441,252201922,252212254,10332,4576,125
252217970,252216452,252226149,9697,4577,125
252231923,252230188,252240737,10549,4578,125
252246601,252244865,252253494,8629,4579,125
252259053,252257534,252265868,8334,4580,125
252271644,252269908,252279191,9283,4581,125
252284966,252283231,252292829,9598,4582,125
252298387,252296869,252305813,8944,4583,125
252311588,252309853,252319134,9281,4584,125
252324909,252323174,252332119,8945,4585,125
252337894,252336159,252346075,9916,4586,125
252351632,252350114,252358447,8333,4587,125
252364222,252362487,252371431,8944,4588,125
252376988,252375470,252384415,8945,4589,125
252390053,252388535,252397600,9065,4590,125
252403375,252401640,252411872,10232,4591,125
252417519,252416001,252426550,10549,4592,125
252432396,252430878,252438994,8116,4593,125
252444552,252443034,252453265,10231,4594,125
252458987,252457468,252467800,10332,4595,125
252473524,252472005,252480416,8411,4596,125
252486190,252484455,252494687,10232,4597,125
252500550,252498815,252509047,10232,4598,125
252514911,252513176,252522120,8944,4599,125
252527679,252526160,252536710,10550,4600,125
252542573,252540838,252550119,9281,4601,125
252555678,252554159,252564709,10550,4602,125
252570572,252568837,252577465,8628,4603,125
252583240,252581505,252591736,10231,4604,125
252597600,252595865,252606414,10549,4605,125
252612275,252610756,252619821,9065,4606,125
252625596,252623861,252632806,8945,4607,125
252638440,252636921,252645649,8728,4608,125
252651291,252649773,252659788,10015,4609,125
252665653,252663917,252673832,9915,4610,125
252679607,252677872,252687787,9915,4611,125
252693346,252691827,252700161,8334,4612,125
252705937,252704201,252712535,8334,4613,125
252718311,252716575,252726492,9917,4614,125
252732267,252730532,252739814,9282,4615,125
252745589,252743854,252753453,9599,4616,125
252759011,252757493,252766776,9283,4617,125
252772550,252770815,252780414,9599,4618,125
252786060,252784541,252794241,9700,4619,125
252800016,252798281,252808513,10232,4620,125
252814376,252812641,252821924,9283,4621,125
252827482,252825964,252836196,10232,4622,125
252841843,252840324,252850239,9915,4623,125
252856014,252854279,252864511,10232,4624,125
252870374,252868639,252878238,9599,4625,125
252884013,252882278,252890907,8629,4626,125
252896682,252894947,252905179,10232,4627,125
252910827,252909308,252917641,8333,4628,125
252923417,252921681,252930015,8334,4629,125
252935574,252934055,252942684,8629,4630,125
252948243,252946724,252956956,10232,4631,125
252962820,252961085,252970368,9283,4632,125
252975926,252974407,252983036,8629,4633,125
252988655,252987135,252996202,9067,4634,125
253001977,253000242,253010158,9916,4635,125
253015934,253014198,253022827,8629,4636,125
253028603,253026867,253036466,9599,4637,125
253042025,253040506,253050105,9599,4638,125
253055664,253054145,253062774,8629,4639,125
253068549,253066814,253076729,9915,4640,125
253082287,253080769,253089101,8332,4641,125
253094876,253093141,253102740,9599,4642,125
253108516,253106780,253116380,9600,4643,125
253122155,253120420,253129365,8945,4644,125
253134987,253133468,253142851,9383,4645,125
253148625,253146890,253156173,9283,4646,125
253161948,253160213,253169812,9599,4647,125
253175371,253173852,253184401,10549,4648,125
253190265,253188529,253196863,8334,4649,125
253202496,253200978,253209389,8411,4650,125
253215164,253213429,253221761,8332,4651,125
253227536,253225801,253234429,8628,4652,125
253240204,253238469,253248068,9599,4653,125
253253843,253252107,253260736,8629,4654,125
253266512,253264776,253274693,9917,4655,125
253280252,253278733,253287361,8628,4656,125
253293137,253291401,253300684,9283,4657,125
253306459,253304724,253314323,9599,4658,125
253320099,253318363,253327963,9600,4659,125
253333521,253332003,253341918,9915,4660,125
253347693,253345958,253355240,9282,4661,125
253361015,253359280,253368225,8945,4662,125
253374000,253372265,253382497,10232,4663,125
253388145,253386626,253396859,10233,4664,125
253402723,253400988,253411536,10548,4665,125
253417400,253415665,253424293,8628,4666,125
253429851,253428333,253438564,10231,4667,125
253444403,253442884,253452900,10016,4668,125
253458628,253457110,253467442,10332,4669,125
253473088,253471570,253481802,10232,4670,125
253487650,253486131,253496463,10332,4671,125
253502328,253500592,253508926,8334,4672,125
253514701,253512966,253522249,9283,4673,125
253527879,253526360,253534476,8116,4674,125
253540251,253538516,253547798,9282,4675,125
253553357,253551838,253560467,8629,4676,125
253566242,253564507,253573789,9282,4677,125
253579347,253577828,253587428,9600,4678,125
253593203,253591468,253602017,10549,4679,125
253607881,253606146,253615090,8944,4680,125
253620866,253619130,253628076,8946,4681,125
253633635,253632116,253641399,9283,4682,125
253646958,253645439,253653773,8334,4683,125
253659548,253657813,253667096,9283,4684,125
253672653,253671135,253680080,8945,4685,125
253685639,253684120,253692748,8628,4686,125
253698524,253696788,253707338,10550,4687,125
253713202,253711466,253721382,9916,4688,125
253727157,253725422,253735021,9599,4689,125
253740796,253739061,253747690,8629,4690,125
253753466,253751730,253760358,8628,4691,125
253766134,253764398,253773027,8629,4692,125
253778586,253777067,253785696,8629,4693,125
253791472,253789736,253799653,9917,4694,125
253805427,253803693,253812975,9282,4695,125
253818534,253817015,253827563,10548,4696,125
253833427,253831691,253841924,10233,4697,125
253847572,253846053,253855969,9916,4698,125
253861615,253860096,253869162,9066,4699,125
253874937,253873202,253881830,8628,4700,125
253887388,253885870,253894815,8945,4701,125
253900590,253898855,253908770,9915,4702,125
253914545,253912810,253922725,9915,4703,125
253928501,253926765,253936680,9915,4704,125
253942455,253940720,253950636,9916,4705,125
253956411,253954676,253963009,8333,4706,125
253968783,253967048,253976964,9916,4707,125
253982602,253981083,253991099,10016,4708,125
253996962,253995227,254005459,10232,4709,125
254011106,254009588,254019187,9599,4710,125
254024746,254023227,254033460,10233,4711,125
254039107,254037589,254047821,10232,4712,125
254053686,254051950,254060578,8628,4713,125
254066136,254064618,254073563,8945,4714,125
254079339,254077603,254087202,9599,4715,125
254092761,254091242,254100841,9599,4716,125
254106471,254104952,254113680,8728,4717,125
254119324,254117805,254126872,9067,4718,125
254132431,254130912,254140196,9284,4719,125
254145972,254144236,254152865,8629,4720,125
254158641,254156905,254165534,8629,4721,125
254171309,254169574,254179489,9915,4722,125
254185264,254183529,254193127,9598,4723,125
254198902,254197167,254205795,8628,4724,125
254211570,254209835,254220067,10232,4725,125
254225916,254224398,254233779,9381,4726,125
254239413,254237894,254247911,10017,4727,125
254253559,254252040,254260374,8334,4728,125
254266149,254264414,254274646,10232,4729,125
254280509,254278774,254288373,9599,4730,125
254294148,254292413,254300746,8333,4731,125
254306305,254304786,254314070,9284,4732,125
254319628,254318110,254326443,8333,4733,125
254332002,254330483,254339429,8946,4734,125
254345205,254343469,254353702,10233,4735,125
254359561,254358042,254367742,9700,4736,125
254373518,254371782,254382332,10550,4737,125
254388046,254386527,254394939,8412,4738,125
254400714,254398979,254407924,8945,4739,125
254413482,254411964,254420296,8332,4740,125
254425854,254424336,254434883,10547,4741,125
254440747,254439011,254447345,8334,4742,125
254453121,254451385,254459718,8333,4743,125
254465276,254463758,254472701,8943,4744,125
254478476,254476741,254486973,10232,4745,125
254492697,254491179,254499293,8114,4746,125
254504852,254503333,254513882,10549,4747,125
254519747,254518011,254526345,8334,4748,125
254531904,254530385,254539013,8628,4749,125
254544788,254543053,254551998,8945,4750,125
254557631,254556113,254565178,9065,4751,125
254570953,254569218,254579767,10549,4752,125
254585609,254584090,254594106,10016,4753,125
254599754,254598235,254607181,8946,4754,125
254612739,254611221,254620820,9599,4755,125
254626463,254624944,254633356,8412,4756,125
254639132,254637396,254647629,10233,4757,125
254653276,254651758,254661356,9598,4758,125
254666915,254665396,254674025,8629,4759,125
254679583,254678065,254686397,8332,4760,125
254691955,254690437,254700668,10231,4761,125
254706512,254704994,254713110,8116,4762,125
254718885,254717150,254727065,9915,4763,125
254732711,254731193,254739920,8727,4764,125
254745479,254743960,254753559,9599,4765,125
254759335,254757599,254767516,9917,4766,125
254773148,254771629,254780041,8412,4767,125
254785816,254784081,254793026,8945,4768,125
254798652,254797133,254806516,9383,4769,125
254812075,254810556,254818890,8334,4770,125
254824448,254822930,254831875,8945,4771,125
254837651,254835915,254846464,10549,4772,125
254852112,254850593,254860193,9600,4773,125
254865751,254864233,254874465,10232,4774,125
254880197,254878678,254888061,9383,4775,125
254893836,254892101,254900433,8332,4776,125
254906209,254904473,254915023,10550,4777,125
254920887,254919152,254929701,10549,4778,125
254935566,254933830,254943747,9917,4779,125
254949306,254947787,254957703,9916,4780,125
254963479,254961743,254971660,9917,4781,125
254977436,254975700,254984033,8333,4782,125
254989591,254988073,254997355,9282,4783,125
255003129,255001394,255011626,10232,4784,125
255017273,255015755,255025037,9282,4785,125
255030595,255029077,255038676,9599,4786,125
255044452,255042716,255052949,10233,4787,125
255058812,255057077,255067309,10232,4788,125
255072956,255071438,255081986,10548,4789,125
255087850,255086115,255094448,8333,4790,125
255100076,255098557,255108257,9700,4791,125
255114033,255112297,255121243,8946,4792,125
255127018,255125283,255133912,8629,4793,125
255139687,255137952,255146284,8332,4794,125
255152059,255150324,255160873,10549,4795,125
255166727,255165208,255174275,9067,4796,125
255179834,255178315,255187261,8946,4797,125
255193037,255191301,255201216,9915,4798,125
255206991,255205256,255213589,8333,4799,125
255219365,255217629,255227862,10233,4800,125
255233726,255231991,255241272,9281,4801,125
255247047,255245312,255254256,8944,4802,125
255260031,255258296,255268212,9916,4803,125
255273829,255272311,255280427,8116,4804,125
255286202,255284467,255295016,10549,4805,125
255300881,255299145,255307478,8333,4806,125
255313110,255311591,255319708,8117,4807,125
255325483,255323748,255333979,10231,4808,125
255339712,255338193,255346605,8412,4809,125
255352238,255350719,255361051,10332,4810,125
255366772,255365253,255375586,10333,4811,125
255381451,255379715,255389314,9599,4812,125
255394873,255393354,255403271,9917,4813,125
255409046,255407311,255417860,10549,4814,125
255423723,255421988,255430617,8629,4815,125
255436176,255434657,255445207,10550,4816,125
255451067,255449549,255459880,10331,4817,125
255465529,255464009,255473294,9285,4818,125
255479069,255477334,255486279,8945,4819,125
255491837,255490319,255499264,8945,4820,125
255505039,255503304,255512903,9599,4821,125
255518462,255516943,255525889,8946,4822,125
255531664,255529929,255539528,9599,4823,125
255545303,255543568,255553167,9599,4824,125
255558794,255557276,255567607,10331,4825,125
255573471,255571736,255581969,10233,4826,125
255587617,255586098,255596331,10233,4827,125
255602194,255600675,255611008,10333,4828,125
255616655,255615136,255623469,8333,4829,125
255629244,255627509,255637107,9598,4830,125
255642883,255641147,255651697,10550,4831,125
255657560,255655825,255665740,9915,4832,125
255671515,255669780,255678113,8333,4833,125
255683889,255682153,255692069,9916,4834,125
255697844,255696109,255704442,8333,4835,125
255710218,255708482,255718716,10234,4836,125
255724581,255722845,255732445,9600,4837,125
255738004,255736485,255746084,9599,4838,125
255751860,255750124,255760357,10233,4839,125
255766221,255764486,255774402,9916,4840,125
255780177,255778442,255787070,8628,4841,125
255792845,255791110,255801342,10232,4842,125
255806989,255805470,255814415,8945,4843,125
255820190,255818455,255828053,9598,4844,125
255833829,255832093,255842326,10233,4845,125
255847974,255846455,255856688,10233,4846,125
255862416,255860897,255869626,8729,4847,125
255875185,255873666,255882000,8334,4848,125
255887776,255886040,255894986,8946,4849,125
255900761,255899026,255909575,10549,4850,125
255915439,255913920,255922037,8117,4851,125
255927812,255926077,255936626,10549,4852,125
255942350,255940832,255949875,9043,4853,125
255955650,255953915,255964148,10233,4854,125
255970012,255968277,255978826,10549,4855,125
255984474,255982955,255991289,8334,4856,125
255996847,255995329,256005878,10549,4857,125
256011742,256010007,256020556,10549,4858,125
256026420,256024902,256034283,9381,4859,125
256039915,256038396,256047124,8728,4860,125
256052771,256051252,256060319,9067,4861,125
256066095,256064360,256073643,9283,4862,125
256079418,256077683,256087599,9916,4863,125
256093376,256091640,256101874,10234,4864,125
256107738,256106003,256114631,8628,4865,125
256120189,256118671,256127004,8333,4866,125
256132563,256131045,256141278,10233,4867,125
256146926,256145408,256155324,9916,4868,125
256160884,256159365,256169914,10549,4869,125
256175757,256174238,256184570,10332,4870,125
256190434,256188699,256197643,8944,4871,125
256203418,256201683,256210015,8332,4872,125
256215575,256214056,256223972,9916,4873,125
256229531,256228013,256236346,8333,4874,125
256242123,256240387,256249987,9600,4875,125
256255763,256254027,256262656,8629,4876,125
256268431,256266696,256276296,9600,4877,125
256281940,256280422,256290438,10016,4878,125
256296086,256294567,256303197,8630,4879,125
256308973,256307237,256317153,9916,4880,125
256322712,256321193,256330793,9600,4881,125
256336568,256334833,256343462,8629,4882,125
256349237,256347502,256356447,8945,4883,125
256362223,256360488,256368820,8332,4884,125
256374595,256372860,256382776,9916,4885,125
256388336,256386817,256396101,9284,4886,125
256401718,256400200,256409899,9699,4887,125
256415675,256413939,256424172,10233,4888,125
256430037,256428301,256438535,10234,4889,125
256444399,256442664,256451947,9283,4890,125
256457723,256455988,256466537,10549,4891,125
256472402,256470666,256479950,9284,4892,125
256485509,256483991,256492619,8628,4893,125
256498179,256496660,256507210,10550,4894,125
256513074,256511339,256521887,10548,4895,125
256527536,256526017,256535301,9284,4896,125
256540861,256539342,256547971,8629,4897,125
256553530,256552012,256561927,9915,4898,125
256567487,256565968,256574301,8333,4899,125
256579925,256578407,256587135,8728,4900,125
256592912,256591176,256601409,10233,4901,125
256607057,256605539,256615772,10233,4902,125
256621419,256619901,256628234,8333,4903,125
256633794,256632275,256640609,8334,4904,125
256646386,256644650,256653934,9284,4905,125
256659710,256657975,256668207,10232,4906,125
256674046,256672528,256681256,8728,4907,125
256686814,256685296,256695212,9916,4908,125
256700987,256699252,256707585,8333,4909,125
256713361,256711626,256720909,9283,4910,125
256726469,256724950,256734866,9916,4911,125
256740642,256738907,256748189,9282,4912,125
256753965,256752230,256760562,8332,4913,125
256766339,256764603,256774836,10233,4914,125
256780484,256778966,256787299,8333,4915,125
256793075,256791340,256799674,8334,4916,125
256805450,256803715,256813947,10232,4917,125
256819812,256818077,256828626,10549,4918,125
256834356,256832837,256840955,8118,4919,125
256846515,256844996,256855546,10550,4920,125
256861193,256859675,256869590,9915,4921,125
256875367,256873631,256883548,9917,4922,125
256889108,256887589,256897506,9917,4923,125
256903283,256901547,256911147,9600,4924,125
256916922,256915187,256925735,10548,4925,125
256931465,256929947,256939646,9699,4926,125
256945205,256943687,256952020,8333,4927,125
256957796,256956060,256966610,10550,4928,125
256972331,256970813,256980196,9383,4929,125
256985972,256984237,256992570,8333,4930,125
256998347,256996611,257007161,10550,4931,125
257012880,257011361,257021693,10332,4932,125
257027557,257025822,257035422,9600,4933,125
257040980,257039462,257049377,9915,4934,125
257055152,257053417,257062699,9282,4935,125
257068475,257066740,257075073,8333,4936,125
257080849,257079113,257089030,9917,4937,125
257094807,257093071,257101405,8334,4938,125
257106965,257105446,257115996,10550,4939,125
257121862,257120126,257129072,8946,4940,125
257134632,257133113,257142059,8946,4941,125
257147618,257146100,257154433,8333,4942,125
257160209,257158474,257169023,10549,4943,125
257174671,257173152,257182751,9599,4944,125
257188527,257186792,257196708,9916,4945,125
257202485,257200749,257210350,9601,4946,125
257216126,257214391,257223020,8629,4947,125
257228796,257227061,257236323,9262,4948,125
257242099,257240364,257250913,10549,4949,125
257256777,257255042,257264958,9916,4950,125
257270734,257268999,257278915,9916,4951,125
257284474,257282956,257292555,9599,4952,125
257298113,257296595,257306827,10232,4953,125
257312476,257310957,257319290,8333,4954,125
257324848,257323330,257332275,8945,4955,125
257337834,257336316,257344944,8628,4956,125
257350721,257348985,257358902,9917,4957,125
257364679,257362943,257371277,8334,4958,125
257377053,257375317,257383652,8335,4959,125
257389428,257387692,257397609,9917,4960,125
257403385,257401650,257411566,9916,4961,125
257417342,257415607,257424551,8944,4962,125
257430183,257428664,257437730,9066,4963,125
257443290,257441771,257451054,9283,4964,125
257456830,257455095,257465011,9916,4965,125
257470571,257469052,257477998,8946,4966,125
257483774,257482039,257490372,8333,4967,125
257496149,257494413,257503360,8947,4968,125
257509136,257507401,257516029,8628,4969,125
257521588,257520070,257528699,8629,4970,125
257534259,257532740,257543289,10549,4971,125
257549145,257547626,257557959,10333,4972,125
257563606,257562088,257572321,10233,4973,125
257578175,257576656,257586355,9699,4974,125
257592130,257590395,257600311,9916,4975,125
257605870,257604351,257612980,8629,4976,125
257618755,257617020,257627569,10549,4977,125
257633434,257631698,257641932,10234,4978,125
257647580,257646061,257654691,8630,4979,125
257660468,257658732,257668965,10233,4980,125
257674829,257673094,257682694,9600,4981,125
257688470,257686735,257696335,9600,4982,125
257702110,257700375,257710924,10549,4983,125
257716571,257715053,257723998,8945,4984,125
257729558,257728039,257736984,8945,4985,125
257742760,257741024,257751574,10550,4986,125
257757438,257755703,257765302,9599,4987,125
257771079,257769343,257777678,8335,4988,125
257783238,257781719,257790349,8630,4989,125
257796125,257794390,257803335,8945,4990,125
257809112,257807376,257817292,9916,4991,125
257823068,257821333,257830616,9283,4992,125
257836392,257834657,257844257,9600,4993,125
257849816,257848298,257858530,10232,4994,125
257864178,257862660,257870993,8333,4995,125
257876770,257875034,257885268,10234,4996,125
257890987,257889468,257898534,9066,4997,125
257904311,257902575,257912492,9917,4998,125
257918268,257916533,257925161,8628,4999,125
257930938,257929202,257938803,9601,5000,125
257944878,257942844,257952485,9641,1,150
257958073,257956256,257965463,9207,2,150
257971051,257969234,257978241,9007,3,150
257983829,257982012,257992941,10929,4,150
257998619,257996801,258007213,10412,5,150
258013107,258011073,258020714,9641,6,150
258026302,258024485,258034643,10158,7,150
258040537,258038503,258047510,9007,8,150
258053100,258051282,258060924,9642,9,150
258066512,258064695,258074336,9641,10,150
258080013,258078196,258087519,9323,11,150
258093413,258091379,258101674,10295,12,150
258107439,258105622,258114946,9324,13,150
258120840,258118806,258129735,10929,14,150
258135718,258133684,258144613,10929,15,150
258150379,258148562,258157886,9324,16,150
258163780,258161746,258172358,10612,17,150
258178341,258176307,258186265,9958,18,150
258192159,258190125,258198817,8692,19,150
258204712,258202677,258212320,9643,20,150
258217997,258216180,258226476,10296,21,150
258232243,258230425,258240732,10307,22,150
258246715,258244681,258254639,9958,23,150
258260533,258258499,258267507,9008,24,150
258273185,258271367,258282094,10727,25,150
258287861,258286043,258296002,9959,26,150
258301679,258299862,258310157,10295,27,150
258316140,258314106,258325035,10929,28,150
258330801,258328984,258338023,9039,29,150
258343699,258341883,258350373,8490,30,150
258356051,258354234,258363242,9008,31,150
258369136,258367103,258377715,10612,32,150
258383481,258381664,258390672,9008,33,150
258396350,258394533,258405577,11044,34,150
258411561,258409527,258418536,9009,35,150
258424214,258422397,258432039,9642,36,150
258437933,258435899,258446194,10295,37,150
258452177,258450143,258460755,10612,38,150
258466739,258464704,258473713,9009,39,150
258479606,258477573,258487868,10295,40,150
258493635,258491817,258500857,9040,41,150
258506751,258504717,258514359,9642,42,150
258520254,258518220,258526911,8691,43,150
258532590,258530772,258539579,8807,44,150
258545257,258543439,258552448,9009,45,150
258558342,258556308,258566266,9958,46,150
258572160,258570126,258578817,8691,47,150
258584495,258582677,258591801,9124,48,150
258597695,258595661,258605619,9958,49,150
258611514,258609480,258620092,10612,50,150
258626074,258624041,258633997,9956,51,150
258639891,258637857,258647182,9325,52,150
258653076,258651042,258661655,10613,53,150
258667638,258665604,258676216,10612,54,150
258682199,258680165,258691093,10928,55,150
258696859,258695042,258705685,10643,56,150
258711451,258709634,258719937,10303,57,150
258725703,258723886,258733241,9355,58,150
258739135,258737101,258745793,8692,59,150
258751687,258749653,258759611,9958,60,150
258765506,258763472,258772163,8691,61,150
258778058,258776024,258786953,10929,62,150
258792936,258790902,258801515,10613,63,150
258807498,258805464,258814155,8691,64,150
258820050,258818016,258827974,9958,65,150
258833651,258831834,258841791,9957,66,150
258847687,258845652,258856266,10614,67,150
258862248,258860215,258871142,10927,68,150
258876908,258875091,258883782,8691,69,150
258889676,258887642,258897600,9958,70,150
258903494,258901460,258911417,9957,71,150
258917095,258915277,258925035,9758,72,150
258930928,258928895,258937903,9008,73,150
258943580,258941763,258951202,9439,74,150
258956880,258955062,258964185,9123,75,150
258970079,258968045,258976736,8691,76,150
258982630,258980596,258991208,10612,77,150
258996974,258995157,259005115,9958,78,150
259011008,259008975,259019587,10612,79,150
259025571,259023536,259033833,10297,80,150
259039599,259037782,259047424,9642,81,150
259053318,259051285,259060609,9324,82,150
259066505,259064470,259073480,9010,83,150
259079374,259077340,259087636,10296,84,150
259093619,259091585,259101880,10295,85,150
259107863,259105829,259114521,8692,86,150
259120197,259118381,259129309,10928,87,150
259135075,259133258,259142583,9325,88,150
259148259,259146443,259155881,9438,89,150
259161775,259159741,259168433,8692,90,150
259174327,259172293,259181618,9325,91,150
259187513,259185479,259194171,8692,92,150
259199849,259198032,259206839,8807,93,150
259212517,259210699,259221090,10391,94,150
259227073,259225039,259234681,9642,95,150
259240575,259238541,259249153,10612,96,150
259254919,259253102,259261825,8723,97,150
259267502,259265685,259275757,10072,98,150
259281523,259279706,259289695,9989,99,150
259295372,259293555,259304167,10612,100,150
259310239,259308205,259317530,9325,101,150
259323296,259321479,259331774,10295,102,150
259337846,259335812,259345137,9325,103,150
259351120,259349086,259360014,10928,104,150
259365869,259364052,259374348,10296,105,150
259380203,259378386,259388679,10293,106,150
259394751,259392717,259402675,9958,107,150
259408441,259406624,259416296,9672,108,150
259422279,259420245,259430203,9958,109,150
259436187,259434152,259445081,10929,110,150
259451154,259449119,259459731,10612,111,150
259465803,259463769,259474065,10296,112,150
259480137,259478103,259488399,10296,113,150
259494255,259492437,259503050,10613,114,150
259508905,259507088,259517046,9958,115,150
259522814,259520996,259530005,9009,116,150
259535987,259533954,259543277,9323,117,150
259549044,259547226,259558186,10960,118,150
259564258,259562224,259572182,9958,119,150
259577947,259576131,259586426,10295,120,150
259592498,259590464,259599473,9009,121,150
259605239,259603422,259611827,8405,122,150
259617809,259615776,259625099,9323,123,150
259631082,259629048,259638372,9324,124,150
259644355,259642321,259653250,10929,125,150
259659322,259657288,259668217,10929,126,150
259674072,259672255,259682475,10220,127,150
259688330,259686513,259696470,9957,128,150
259702454,259700419,259711031,10612,129,150
259716886,259715069,259724971,9902,130,150
259730737,259728920,259739532,10612,131,150
259745604,259743570,259753528,9958,132,150
259759295,259757477,259766170,8693,133,150
259772154,259770120,259778812,8692,134,150
259784579,259782761,259791801,9040,135,150
259797568,259795750,259804443,8693,136,150
259810426,259808392,259819004,10612,137,150
259824859,259823042,259831733,8691,138,150
259837500,259835682,259845978,10296,139,150
259852052,259850016,259859343,9327,140,150
259865109,259863292,259873934,10642,141,150
259880006,259877972,259886980,9008,142,150
259892746,259890929,259899967,9038,143,150
259905950,259903916,259914212,10296,144,150
259920068,259918250,259927576,9326,145,150
259933342,259931525,259941167,9642,146,150
259946933,259945116,259953836,8720,147,150
259959602,259957785,259966477,8692,148,150
259972244,259970426,259980385,9959,149,150
259986369,259984334,259993027,8693,150,150
259999011,259996977,260005669,8692,151,150
260011652,260009618,260019259,9641,152,150
260025243,260023208,260041588,18380,153,150
260047661,260045627,260056556,10929,154,150
260062411,260060594,260070551,9957,155,150
260076317,260074500,260085142,10642,156,150
260090998,260089180,260098189,9009,157,150
260104172,260102138,260112434,10296,158,150
260118288,260116471,260127398,10927,159,150
260133254,260131436,260140129,8693,160,150
260145896,260144079,260153435,9356,161,150
260159419,260157385,260167343,9958,162,150
260173110,260171293,260181280,9987,163,150
260187264,260185230,260195842,10612,164,150
260201698,260199881,260210493,10612,165,150
260216349,260214532,260225144,10612,166,150
260231217,260229183,260238192,9009,167,150
260244176,260242142,260253071,10929,168,150
260259144,260257110,260267723,10613,169,150
260273578,260271761,260280484,8723,170,150
260286469,260284434,260294393,9959,171,150
260300377,260298343,260308955,10612,172,150
260315026,260312993,260323921,10928,173,150
260329994,260327960,260337602,9642,174,150
260343586,260341552,260350560,9008,175,150
260356544,260354510,260364468,9958,176,150
260370236,260368418,260377775,9357,177,150
260383542,260381725,260390417,8692,178,150
260396401,260394367,260404009,9642,179,150
260409777,260407959,260418920,10961,180,150
260424777,260422959,260433519,10560,181,150
260439375,260437558,260446566,9008,182,150
260452550,260450516,260460158,9642,183,150
260466142,260464108,260473750,9642,184,150
260479734,260477700,260486392,8692,185,150
260492160,260490342,260500649,10307,186,150
260506722,260504688,260513380,8692,187,150
260519148,260517330,260527288,9958,188,150
260533270,260531238,260540877,9639,189,150
260546861,260544827,260553519,8692,190,150
260559287,260557469,260567143,9674,191,150
260573127,260571093,260581706,10613,192,150
260587779,260585745,260596041,10296,193,150
260601897,260600080,260609088,9008,194,150
260615072,260613038,260623967,10929,195,150
260630040,260628006,260637648,9642,196,150
260643416,260641598,260651557,9959,197,150
260657540,260655507,260665802,10295,198,150
260671875,260669841,260680770,10929,199,150
260686626,260684809,260694134,9325,200,150
260699901,260698084,260708727,10643,201,150
260714800,260712766,260723062,10296,202,150
260728918,260727101,260736456,9355,203,150
260742224,260740407,260751367,10960,204,150
260757223,260755406,260764044,8638,205,150
260770028,260767995,260778923,10928,206,150
260784997,260782963,260793892,10929,207,150
260799748,260797931,260808226,10295,208,150
260814082,260812265,260821273,9008,209,150
260827040,260825223,260834548,9325,210,150
260840532,260838498,260848456,9958,211,150
260854223,260852406,260863335,10929,212,150
260869408,260867374,260876383,9009,213,150
260882366,260880333,260889024,8691,214,150
260895008,260892974,260903903,10929,215,150
260909760,260907942,260918871,10929,216,150
260924728,260922910,260932814,9904,217,150
260938582,260936764,260945803,9039,218,150
260951788,260949754,260958763,9009,219,150
260964747,260962713,260973009,10296,220,150
260978865,260977048,260987342,10294,221,150
260993199,260991381,261000074,8693,222,150
261005841,261004024,261014667,10643,223,150
261020523,261018706,261029635,10929,224,150
261035491,261033674,261044317,10643,225,150
261050390,261048356,261057048,8692,226,150
261062815,261060998,261069689,8691,227,150
261075674,261073639,261083281,9642,228,150
261089265,261087231,261097189,9958,229,150
261103173,261101140,261111096,9956,230,150
261116863,261115046,261125974,10928,231,150
261131830,261130013,261140338,10325,232,150
261146194,261144377,261155251,10874,233,150
261161324,261159290,261170219,10929,234,150
261176076,261174258,261184585,10327,235,150
261190658,261188624,261198581,9957,236,150
261204349,261202532,261211540,9008,237,150
261217523,261215490,261225131,9641,238,150
261230898,261229081,261239038,9957,239,150
261244806,261242989,261252660,9671,240,150
261258643,261256610,261266567,9957,241,150
261272551,261270517,261279209,8692,242,150
261285192,261283159,261293115,9956,243,150
261299100,261297065,261305757,8692,244,150
261311742,261309707,261320320,10613,245,150
261326393,261324359,261334000,9641,246,150
261339767,261337950,261346958,9008,247,150
261352943,261350908,261361205,10297,248,150
261367061,261365244,261374283,9039,249,150
261380051,261378234,261387558,9324,250,150
261393543,261391508,261400517,9009,251,150
261406502,261404468,261415397,10929,252,150
261421254,261419436,261429395,9959,253,150
261435378,261433345,261443957,10612,254,150
261450030,261447996,261457637,9641,255,150
261463622,261461587,261471545,9958,256,150
261477530,261475496,261484188,8692,257,150
261489955,261488138,261498781,10643,258,150
261504855,261502820,261512779,9959,259,150
261518547,261516730,261526086,9356,260,150
261532071,261530037,261539362,9325,261,150
261545130,261543312,261553301,9989,262,150
261559069,261557252,261567558,10306,263,150
261573631,261571597,261581239,9642,264,150
261587223,261585189,261595801,10612,265,150
261601874,261599840,261609798,9958,266,150
261615565,261613749,261626122,12373,267,150
261631979,261630162,261639486,9324,268,150
261645254,261643437,261652762,9325,269,150
261658748,261656713,261666356,9643,270,150
261672340,261670306,261678998,8692,271,150
261684767,261682949,261692275,9326,272,150
261698259,261696226,261705234,9008,273,150
261711218,261709184,261717875,8691,274,150
261723643,261721826,261730231,8405,275,150
261735999,261734182,261745110,10928,276,150
261751184,261749150,261758791,9641,277,150
261764777,261762742,261771434,8692,278,150
261777418,261775384,261785995,10611,279,150
261792068,261790034,261798725,8691,280,150
261804492,261802675,261811080,8405,281,150
261817065,261815031,261824673,9642,282,150
261830657,261828623,261838919,10296,283,150
261844992,261842958,261851650,8692,284,150
261857418,261855601,261865243,9642,285,150
261871012,261869194,261877918,8724,286,150
261883903,261881869,261892165,10296,287,150
261898022,261896205,261905529,9324,288,150
261911514,261909480,261919437,9957,289,150
261925204,261923387,261932395,9008,290,150
261938163,261936346,261945988,9642,291,150
261951755,261949938,261960867,10929,292,150
261966724,261964906,261974810,9904,293,150
261980578,261978761,261987453,8692,294,150
261993221,261991404,262001075,9671,295,150
262007059,262005026,262014350,9324,296,150
262020119,262018301,262027024,8723,297,150
262033009,262030975,262041587,10612,298,150
262047444,262045627,262054983,9356,299,150
262060751,262058934,262069863,10929,300,150
262075720,262073903,262084230,10327,301,150
262090303,262088269,262099198,10929,302,150
262105271,262103238,262112878,9640,303,150
262118646,262116829,262125521,8692,304,150
262131290,262129472,262139462,9990,305,150
262145230,262143413,262152452,9039,306,150
262158437,262156402,262165095,8693,307,150
262171079,262169045,262179657,10612,308,150
262185515,262183696,262193656,9960,309,150
262199640,262197606,262208535,10929,310,150
262214392,262212574,262220981,8407,311,150
262226748,262224931,262234888,9957,312,150
262240656,262238838,262249451,10613,313,150
262255523,262253489,262262180,8691,314,150
262267948,262266130,262275139,9009,315,150
262281122,262279089,262290017,10928,316,150
262295873,262294055,262303095,9040,317,150
262309079,262307045,262316053,9008,318,150
262322037,262320003,262330299,10296,319,150
262336155,262334338,262344632,10294,320,150
262350705,262348671,262358966,10295,321,150
262365038,262363005,262373299,10294,322,150
262379155,262377338,262386346,9008,323,150
262392330,262390296,262399937,9641,324,150
262405705,262403887,262414499,10612,325,150
262420571,262418538,262428833,10295,326,150
262434688,262432871,262441878,9007,327,150
262447862,262445828,262455470,9642,328,150
262461454,262459420,262468427,9007,329,150
262474194,262472377,262481701,9324,330,150
262487685,262485651,262494659,9008,331,150
262500426,262498609,262508567,9958,332,150
262514550,262512517,262522473,9956,333,150
262528239,262526423,262536717,10294,334,150
262542789,262540755,262550395,9640,335,150
262556380,262554345,262563354,9009,336,150
262569338,262567303,262578232,10929,337,150
262584304,262582270,262593199,10929,338,150
262599272,262597238,262605930,8692,339,150
262611914,262609880,262619522,9642,340,150
262625289,262623472,262632164,8692,341,150
262637930,262636114,262646071,9957,342,150
262652055,262650021,262660950,10929,343,150
262667023,262664989,262675601,10612,344,150
262681673,262679639,262690567,10928,345,150
262696422,262694605,262703928,9323,346,150
262709912,262707878,262718807,10929,347,150
262724663,262722846,262732201,9355,348,150
262737969,262736151,262745476,9325,349,150
262751460,262749426,262758751,9325,350,150
262764736,262762701,262772998,10297,351,150
262779071,262777037,262786045,9008,352,150
262791812,262789995,262800300,10305,353,150
262806156,262804338,262813927,9589,354,150
262819694,262817877,262827866,9989,355,150
262833633,262831816,262840824,9008,356,150
262846808,262844774,262855703,10929,357,150
262861559,262859742,262868148,8406,358,150
262873915,262872098,262881106,9008,359,150
262887090,262885056,262895351,10295,360,150
262901424,262899390,262908399,9009,361,150
262914383,262912349,262921991,9642,362,150
262927975,262925941,262936870,10929,363,150
262942944,262940909,262949602,8693,364,150
262955586,262953552,262963847,10295,365,150
262969919,262967885,262976577,8692,366,150
262982561,262980527,262991455,10928,367,150
262997528,262995494,263004819,9325,368,150
263010803,263008769,263018093,9324,369,150
263023860,263022043,263031715,9672,370,150
263037482,263035665,263045335,9670,371,150
263051320,263049285,263060214,10929,372,150
263066287,263064253,263073578,9325,373,150
263079345,263077528,263086884,9356,374,150
263092651,263090834,263099872,9038,375,150
263105640,263103822,263112830,9008,376,150
263118598,263116780,263125473,8693,377,150
263131240,263129423,263139727,10304,378,150
263145584,263143766,263153353,9587,379,150
263159121,263157303,263165995,8692,380,150
263171762,263169946,263179932,9986,381,150
263185699,263183882,263192573,8691,382,150
263198557,263196523,263207452,10929,383,150
263213525,263211491,263220498,9007,384,150
263226482,263224448,263235060,10612,385,150
263241134,263239099,263248741,9642,386,150
263254508,263252691,263261412,8721,387,150
263267396,263265362,263274687,9325,388,150
263280455,263278637,263289281,10644,389,150
263295355,263293320,263303933,10613,390,150
263309789,263307972,263318584,10612,391,150
263324441,263322623,263332212,9589,392,150
263338196,263336162,263345171,9009,393,150
263350938,263349121,263358160,9039,394,150
263364145,263362110,263372723,10613,395,150
263378579,263376762,263386719,9957,396,150
263392703,263390669,263400310,9641,397,150
263406294,263404260,263412952,8692,398,150
263418719,263416902,263425910,9008,399,150
263431677,263429860,263439184,9324,400,150
263445168,263443134,263453430,10296,401,150
263459504,263457469,263468399,10930,402,150
263474255,263472438,263482078,9640,403,150
263487845,263486028,263495067,9039,404,150
263501050,263499017,263507707,8690,405,150
263513474,263511657,263520982,9325,406,150
263526966,263524932,263535861,10929,407,150
263541717,263539900,263548592,8692,408,150
263554359,263552542,263562215,9673,409,150
263568199,263566165,263576122,9957,410,150
263581889,263580072,263589397,9325,411,150
263595164,263593347,263602703,9356,412,150
263608687,263606653,263617582,10929,413,150
263623654,263621621,263631578,9957,414,150
263637562,263635528,263645486,9958,415,150
263651470,263649436,263659731,10295,416,150
263665804,263663770,263672461,8691,417,150
263678445,263676411,263686707,10296,418,150
263692781,263690746,263700072,9326,419,150
263706056,263704022,263714318,10296,420,150
263720174,263718357,263727365,9008,421,150
263733350,263731315,263740007,8692,422,150
263745775,263743957,263754570,10613,423,150
263760426,263758609,263769167,10558,424,150
263775240,263773206,263782213,9007,425,150
263788197,263786164,263796459,10295,426,150
263802315,263800498,263809823,9325,427,150
263815590,263813773,263822781,9008,428,150
263828549,263826731,263836088,9357,429,150
263841856,263840038,263849364,9326,430,150
263855132,263853314,263863620,10306,431,150
263869476,263867659,263878301,10642,432,150
263884158,263882340,263892950,10610,433,150
263899023,263896989,263906947,9958,434,150
263912714,263910897,263919589,8692,435,150
263925356,263923539,263933834,10295,436,150
263939907,263937873,263947198,9325,437,150
263952965,263951148,263961759,10611,438,150
263967615,263965798,263975123,9325,439,150
263981107,263979073,263989686,10613,440,150
263995760,263993725,264002417,8692,441,150
264008401,264006367,264015059,8692,442,150
264020826,264019009,264027415,8406,443,150
264033399,264031365,264041323,9958,444,150
264047090,264045273,264055916,10643,445,150
264061773,264059955,264069280,9325,446,150
264075048,264073230,264081952,8722,447,150
264087720,264085902,264094594,8692,448,150
264100361,264098544,264108185,9641,449,150
264113952,264112135,264123095,10960,450,150
264129167,264127133,264137091,9958,451,150
264143074,264141041,264150998,9957,452,150
264156764,264154948,264164302,9354,453,150
264170069,264168252,264176975,8723,454,150
264182960,264180925,264189618,8693,455,150
264195602,264193568,264202893,9325,456,150
264208877,264206843,264217137,10294,457,150
264222993,264221175,264230184,9009,458,150
264235951,264234134,264244745,10611,459,150
264250817,264248784,264258740,9956,460,150
264264507,264262690,264273617,10927,461,150
264279472,264277655,264288297,10642,462,150
264294369,264292336,264302947,10611,463,150
264309020,264306986,264315993,9007,464,150
264321760,264319943,264329930,9987,465,150
264335696,264333880,264342599,8719,466,150
264348583,264346549,264355558,9009,467,150
264361542,264359508,264369803,10295,468,150
264375876,264373842,264383483,9641,469,150
264389250,264387433,264396440,9007,470,150
264402424,264400390,264409397,9007,471,150
264415380,264413347,264423959,10612,472,150
264429816,264427998,264438326,10328,473,150
264444182,264442365,264451635,9270,474,150
264457403,264455585,264466515,10930,475,150
264472588,264470554,264481165,10611,476,150
264487021,264485204,264495762,10558,477,150
264501836,264499801,264510098,10297,478,150
264515954,264514137,264523145,9008,479,150
264529129,264527095,264537391,10296,480,150
264543463,264541430,264551724,10294,481,150
264557798,264555763,264566376,10613,482,150
264572232,264570415,264578821,8406,483,150
264584588,264582771,264593730,10959,484,150
264599586,264597769,264607410,9641,485,150
264613178,264611360,264621318,9958,486,150
264627303,264625268,264636198,10930,487,150
264642271,264640237,264651165,10928,488,150
264657238,264655204,264665816,10612,489,150
264671672,264669855,264679211,9356,490,150
264684979,264683161,264692518,9357,491,150
264698286,264696468,264705793,9325,492,150
264711561,264709743,264718782,9039,493,150
264724766,264722732,264731740,9008,494,150
264737724,264735690,264746618,10928,495,150
264752692,264750657,264759983,9326,496,150
264765751,264763934,264772656,8722,497,150
264778639,264776606,264787533,10927,498,150
264793606,264791572,264800579,9007,499,150
264806345,264804529,264813220,8691,500,150
264818987,264817170,264826494,9324,501,150
264832261,264830444,264839451,9007,502,150
264845435,264843401,264854013,10612,503,150
264859869,264858052,264866744,8692,504,150
264872512,264870694,264880367,9673,505,150
264886134,264884317,264894612,10295,506,150
264900468,264898651,264908239,9588,507,150
264914006,264912189,264922495,10306,508,150
264928568,264926534,264936830,10296,509,150
264942686,264940869,264949876,9007,510,150
264955860,264953826,264964755,10929,511,150
264970828,264968794,264978752,9958,512,150
264984518,264982702,264993006,10304,513,150
264999079,264997045,265005737,8692,514,150
265011504,265009687,265020615,10928,515,150
265026471,265024654,265035580,10926,516,150
265041436,265039619,265049838,10219,517,150
265055910,265053877,265063200,9323,518,150
265069184,265067150,265075842,8692,519,150
265081826,265079792,265088801,9009,520,150
265094569,265092751,265102108,9357,521,150
265108092,265106058,265116015,9957,522,150
265121782,265119965,265128657,8692,523,150
265134424,265132607,265142933,10326,524,150
265148789,265146972,265156961,9989,525,150
265162945,265160911,265170552,9641,526,150
265176318,265174502,265183509,9007,527,150
265189493,265187459,265197755,10296,528,150
265203828,265201794,265212090,10296,529,150
265218163,265216129,265226425,10296,530,150
265232281,265230463,265239471,9008,531,150
265245237,265243421,265252112,8691,532,150
265257879,265256062,265265070,9008,533,150
265271054,265269020,265278028,9008,534,150
265284013,265281978,265290987,9009,535,150
265296754,265294937,265303944,9007,536,150
265309929,265307894,265317537,9643,537,150
265323521,265321487,265331783,10296,538,150
265337856,265335822,265346750,10928,539,150
265352605,265350789,265359743,8954,540,150
265365510,265363693,265373988,10295,541,150
265380061,265378027,265388956,10929,542,150
265394813,265392995,265402320,9325,543,150
265408305,265406271,265424017,17746,544,150
265430091,265428057,265437381,9324,545,150
265443148,265441331,265459075,17744,546,150
265465149,265463115,265474044,10929,547,150
265479901,265478083,265491470,13387,548,150
265497543,265495509,265505151,9642,549,150
265510918,265509101,265519712,10611,550,150
265525785,265523751,265534047,10296,551,150
265539903,265538086,265547673,9587,552,150
265553440,265551623,265561949,10326,553,150
265567804,265565988,265575659,9671,554,150
265581643,265579609,265589249,9640,555,150
265595233,265593199,265602208,9009,556,150
265608192,265606158,265617087,10929,557,150
265623160,265621126,265631084,9958,558,150
265637068,265635034,265643726,8692,559,150
265649493,265647676,265663501,15825,560,150
265669357,265667540,265677498,9958,561,150
265683265,265681448,265690456,9008,562,150
265696440,265694406,265703731,9325,563,150
265709498,265707681,265716373,8692,564,150
265722357,265720323,265730619,10296,565,150
265736475,265734658,265743063,8405,566,150
265748830,265747013,265756021,9008,567,150
265761788,265759971,265770275,10304,568,150
265776348,265774314,265783322,9008,569,150
265789307,265787272,265797569,10297,570,150
265803425,265801608,265811511,9903,571,150
265817278,265815461,265824469,9008,572,150
265830237,265828419,265838747,10328,573,150
265844604,265842786,265853716,10930,574,150
265859572,265857755,265866763,9008,575,150
265872530,265870713,265881642,10929,576,150
265887498,265885681,265894953,9272,577,150
265900720,265898903,265909199,10296,578,150
265915272,265913238,265923534,10296,579,150
265929391,265927573,265936899,9326,580,150
265942666,265940849,265950838,9989,581,150
265956605,265954788,265965084,10296,582,150
265970939,265969123,265977813,8690,583,150
265983580,265981763,265992692,10929,584,150
265998548,265996731,266005369,8638,585,150
266011354,266009320,266018644,9324,586,150
266024412,266022594,266033524,10930,587,150
266039380,266037563,266047859,10296,588,150
266053932,266051898,266061856,9958,589,150
266067625,266065807,266074499,8692,590,150
266080484,266078450,266088091,9641,591,150
266093858,266092041,266102346,10305,592,150
266108203,266106385,266115711,9326,593,150
266121479,266119661,266130589,10928,594,150
266136446,266134628,266145241,10613,595,150
266151314,266149280,266159575,10295,596,150
266165431,266163614,266173603,9989,597,150
266179587,266177553,266187849,10296,598,150
266193705,266191888,266202500,10612,599,150
266208357,266206539,266217415,10876,600,150
266223272,266221455,266230724,9269,601,150
266236707,266234674,266243681,9007,602,150
266249666,266247631,266257273,9642,603,150
266263040,266261223,266270262,9039,604,150
266276246,266274212,266282903,8691,605,150
266288888,266286853,266297149,10296,606,150
266303221,266301187,266311483,10296,607,150
266317556,266315522,266326134,10612,608,150
266331990,266330173,266339127,8954,609,150
266344895,266343077,266352433,9356,610,150
266358200,266356383,266367312,10929,611,150
266373168,266371351,266380676,9325,612,150
266386443,266384626,266394931,10305,613,150
266400787,266398970,266408295,9325,614,150
266414062,266412245,266422234,9989,615,150
266428217,266426184,266436794,10610,616,150
266442650,266440833,266449524,8691,617,150
266455509,266453474,266464087,10613,618,150
266469943,266468126,266477134,9008,619,150
266483117,266481084,266490408,9324,620,150
266496175,266494358,266503079,8721,621,150
266509062,266507029,266515719,8690,622,150
266521703,266519669,266529626,9957,623,150
266535610,266533576,266542585,9009,624,150
266548352,266546535,266556523,9988,625,150
266562507,266560473,266570431,9958,626,150
266576198,266574381,266584685,10304,627,150
266590542,266588724,266598080,9356,628,150
266603848,266602030,266612989,10959,629,150
266618846,266617028,266626353,9325,630,150
266632338,266630303,266638994,8691,631,150
266644978,266642944,266651635,8691,632,150
266657619,266655585,266666514,10929,633,150
266672369,266670553,266680772,10219,634,150
266686628,266684811,266694136,9325,635,150
266699903,266698086,266707411,9325,636,150
266713179,266711361,266722321,10960,637,150
266728394,266726360,266737288,10928,638,150
266743361,266741327,266752256,10929,639,150
266758112,266756295,266765936,9641,640,150
266771920,266769886,266779844,9958,641,150
266785828,266783794,266793752,9958,642,150
266799519,266797702,266806740,9038,643,150
266812724,266810690,266819382,8692,644,150
266825366,266823332,266832972,9640,645,150
266838739,266836922,266845645,8723,646,150
266851412,266849595,266858316,8721,647,150
266864300,266862266,266873195,10929,648,150
266879268,266877234,266887192,9958,649,150
266892960,266891142,266901439,10297,650,150
266907512,266905478,266914802,9324,651,150
266920786,266918752,266928076,9324,652,150
266934059,266932026,266941349,9323,653,150
266947332,266945299,266955255,9956,654,150
266961239,266959205,266968529,9324,655,150
266974297,266972479,266981835,9356,656,150
266987819,266985785,266994794,9009,657,150
267000778,266998744,267009357,10613,658,150
267015214,267013396,267024008,10612,659,150
267030081,267028047,267038005,9958,660,150
267043990,267041956,267051914,9958,661,150
267057682,267055864,267064903,9039,662,150
267070887,267068854,267079781,10927,663,150
267085638,267083820,267093146,9326,664,150
267099131,267097096,267106737,9641,665,150
267112504,267110687,267120992,10305,666,150
267127065,267125031,267135326,10295,667,150
267141399,267139365,267150294,10929,668,150
267156149,267154333,267164943,10610,669,150
267170799,267168982,267178939,9957,670,150
267184707,267182889,267191929,9040,671,150
267197697,267195879,267205837,9958,672,150
267211605,267209787,267220113,10326,673,150
267225969,267224152,267234443,10291,674,150
267240516,267238482,267248778,10296,675,150
267254634,267252817,267261825,9008,676,150
267267809,267265775,267274467,8692,677,150
267280234,267278417,267288722,10305,678,150
267294795,267292761,267303372,10611,679,150
267309445,267307411,267317707,10296,680,150
267323563,267321746,267331966,10220,681,150
267337822,267336005,267345962,9957,682,150
267351729,267349912,267360555,10643,683,150
267366411,267364594,267374498,9904,684,150
267380265,267378448,267386853,8405,685,150
267392621,267390803,267401446,10643,686,150
267407518,267405485,267414492,9007,687,150
267420259,267418442,267427797,9355,688,150
267433781,267431747,267442358,10611,689,150
267448431,267446397,267457009,10612,690,150
267462866,267461048,267470636,9588,691,150
267476620,267474586,267483277,8691,692,150
267489044,267487227,267496898,9671,693,150
267502883,267500848,267510807,9959,694,150
267516791,267514757,267524082,9325,695,150
267529850,267528032,267538674,10642,696,150
267544531,267542713,267553010,10297,697,150
267559083,267557049,267567977,10928,698,150
267573833,267572016,267581973,9957,699,150
267587740,267585923,267595279,9356,700,150
267601262,267599229,267610156,10927,701,150
267616014,267614195,267624100,9905,702,150
267629867,267628050,267636771,8721,703,150
267642538,267640721,267649760,9039,704,150
267655744,267653710,267662402,8692,705,150
267668385,267666352,267677279,10927,706,150
267683135,267681318,267690959,9641,707,150
267696943,267694909,267705521,10612,708,150
267711593,267709560,267718568,9008,709,150
267724335,267722518,267731239,8721,710,150
267737006,267735189,267744197,9008,711,150
267750181,267748147,267757787,9640,712,150
267763554,267761737,267772666,10929,713,150
267778522,267776705,267786925,10220,714,150
267792998,267790964,267800605,9641,715,150
267806372,267804555,267813594,9039,716,150
267819578,267817544,267828155,10611,717,150
267834011,267832194,267843117,10923,718,150
267848973,267847156,267856476,9320,719,150
267862243,267860426,267870720,10294,720,150
267876576,267874759,267885371,10612,721,150
267891227,267889410,267899082,9672,722,150
267905066,267903032,267912990,9958,723,150
267918974,267916940,267926264,9324,724,150
267932031,267930214,267940857,10643,725,150
267946713,267944896,267954853,9957,726,150
267960620,267958803,267968445,9642,727,150
267974428,267972395,267983006,10611,728,150
267989079,267987045,267995737,8692,729,150
268001504,267999687,268009043,9356,730,150
268015027,268012993,268022002,9009,731,150
268027985,268025952,268036879,10927,732,150
268042953,268040918,268049928,9010,733,150
268055912,268053878,268063836,9958,734,150
268069820,268067786,268078399,10613,735,150
268084472,268082438,268091762,9324,736,150
268097745,268095712,268106007,10295,737,150
268112079,268110046,268119687,9641,738,150
268125671,268123637,268134249,10612,739,150
268140105,268138288,268147924,9636,740,150
268153691,268151874,268161515,9641,741,150
268167283,268165465,268174790,9325,742,150
268180774,268178740,268188698,9958,743,150
268194682,268192648,268203261,10613,744,150
268209118,268207300,268217597,10297,745,150
268223454,268221636,268231594,9958,746,150
268237579,268235545,268246473,10928,747,150
268252329,268250512,268260153,9641,748,150
268265920,268264103,268273427,9324,749,150
268279194,268277377,268286069,8692,750,150
268292052,268290019,268300946,10927,751,150
268306803,268304985,268314943,9958,752,150
268320927,268318893,268328850,9957,753,150
268334834,268332800,268343729,10929,754,150
268349802,268347768,268357410,9642,755,150
268363394,268361360,268370052,8692,756,150
268375819,268374002,268384614,10612,757,150
268390687,268388653,268398949,10296,758,150
268405022,268402988,268412313,9325,759,150
268418298,268416264,268424955,8691,760,150
268430723,268428905,268439201,10296,761,150
268445058,268443240,268453567,10327,762,150
268459424,268457606,268467564,9958,763,150
268473548,268471514,268480523,9009,764,150
268486290,268484473,268495085,10612,765,150
268501158,268499124,268509736,10612,766,150
268515592,268513775,268523764,9989,767,150
268529530,268527714,268538325,10611,768,150
268544182,268542364,268552924,10560,769,150
268558997,268556963,268567892,10929,770,150
268573748,268571931,268581889,9958,771,150
268587873,268585839,268596135,10296,772,150
268601991,268600174,268608865,8691,773,150
268614632,268612815,268621536,8721,774,150
268627304,268625487,268635445,9958,775,150
268641430,268639396,268648405,9009,776,150
268654389,268652355,268662651,10296,777,150
268668508,268666690,268676016,9326,778,150
268682000,268679966,268690579,10613,779,150
268696435,268694618,268704576,9958,780,150
268710560,268708526,268717534,9008,781,150
268723302,268721484,268730175,8691,782,150
268736159,268734125,268743133,9008,783,150
268748900,268747083,268755773,8690,784,150
268761540,268759723,268770049,10326,785,150
268776122,268774088,268783413,9325,786,150
268789397,268787363,268796688,9325,787,150
268802456,268800638,268810310,9672,788,150
268816077,268814260,268823901,9641,789,150
268829668,268827851,268838463,10612,790,150
268844535,268842502,268851509,9007,791,150
268857494,268855459,268864152,8693,792,150
268870135,268868102,268877109,9007,793,150
268882877,268881059,268889751,8692,794,150
268895735,268893701,268902392,8691,795,150
268908160,268906342,268915667,9325,796,150
268921651,268919617,268930546,10929,797,150
268936402,268934585,268944226,9641,798,150
268949994,268948176,268957849,9673,799,150
268963617,268961799,268972442,10643,800,150
268978298,268976481,268987409,10928,801,150
268993265,268991447,269000718,9271,802,150
269006702,269004668,269013359,8691,803,150
269019343,269017309,269027921,10612,804,150
269033995,269031960,269041601,9641,805,150
269047585,269045551,269054560,9009,806,150
269060544,269058510,269068150,9640,807,150
269073917,269072100,269080821,8721,808,150
269086805,269084771,269093463,8692,809,150
269099448,269097413,269108026,10613,810,150
269114099,269112065,269121706,9641,811,150
269127473,269125656,269135960,10304,812,150
269142032,269139999,269150294,10295,813,150
269156150,269154333,269162739,8406,814,150
269168723,269166689,269175381,8692,815,150
269181148,269179331,269188370,9039,816,150
269194354,269192320,269201644,9324,817,150
269207627,269205594,269215889,10295,818,150
269221745,269219928,269228566,8638,819,150
269234549,269232516,269242157,9641,820,150
269247924,269246107,269255431,9324,821,150
269261415,269259381,269268073,8692,822,150
269274057,269272023,269281981,9958,823,150
269287965,269285931,269294939,9008,824,150
269300923,269298889,269308214,9325,825,150
269313982,269312164,269322808,10644,826,150
269328880,269326846,269335854,9008,827,150
269341838,269339804,269349129,9325,828,150
269355113,269353079,269361770,8691,829,150
269367754,269365720,269374412,8692,830,150
269380179,269378362,269387053,8691,831,150
269393036,269391003,269399694,8691,832,150
269405678,269403644,269414256,10612,833,150
269420330,269418295,269427938,9643,834,150
269433705,269431888,269440926,9038,835,150
269446693,269444876,269454546,9670,836,150
269460313,269458496,269469455,10959,837,150
269475311,269473494,269484052,10558,838,150
269489909,269488091,269501963,13872,839,150
269508036,269506002,269522777,16775,840,150
269528635,269526817,269537424,10607,841,150
269543280,269541463,269551759,10296,842,150
269557615,269555798,269566673,10875,843,150
269572746,269570712,269581640,10928,844,150
269587713,269585679,269595003,9324,845,150
269600987,269598953,269609565,10612,846,150
269615638,269613604,269622296,8692,847,150
269628063,269626246,269637175,10929,848,150
269643249,269641214,269651173,9959,849,150
269657157,269655123,269665419,10296,850,150
269671276,269669458,269678467,9009,851,150
269684451,269682417,269691108,8691,852,150
269697092,269695058,269705016,9958,853,150
269710783,269708966,269718924,9958,854,150
269724690,269722874,269732861,9987,855,150
269738628,269736811,269746769,9958,856,150
269752753,269750719,269761332,10613,857,150
269767405,269765371,269776300,10929,858,150
269782373,269780339,269789980,9641,859,150
269795963,269793930,269803570,9640,860,150
269809555,269807520,269816213,8693,861,150
269822197,269820163,269830121,9958,862,150
269835888,269834071,269843713,9642,863,150
269849481,269847663,269856356,8693,864,150
269862340,269860306,269870602,10296,865,150
269876675,269874641,269885253,10612,866,150
269891326,269889292,269898933,9641,867,150
269904917,269902883,269913179,10296,868,150
269919035,269917218,269927123,9905,869,150
269932891,269931073,269941062,9989,870,150
269946830,269945013,269954971,9958,871,150
269960739,269958922,269968594,9672,872,150
269974578,269972544,269982501,9957,873,150
269988485,269986451,269996091,9640,874,150
270001859,270000042,270010031,9989,875,150
270016015,270013981,270022673,8692,876,150
270028440,270026623,270035978,9355,877,150
270041745,270039928,270050254,10326,878,150
270056327,270054293,270063935,9642,879,150
270069919,270067885,270077210,9325,880,150
270083194,270081160,270090801,9641,881,150
270096569,270094751,270103474,8723,882,150
270109241,270107424,270118383,10959,883,150
270124456,270122422,270132379,9957,884,150
270138363,270136329,270145021,8692,885,150
270151004,270148971,270158928,9957,886,150
270164696,270162879,270172837,9958,887,150
270178821,270176787,270185794,9007,888,150
270191561,270189744,270200673,10929,889,150
270206529,270204712,270215324,10612,890,150
270221397,270219363,270229974,10611,891,150
270235830,270234013,270243337,9324,892,150
270249105,270247287,270257612,10325,893,150
270263469,270261651,270272263,10612,894,150
270278337,270276302,270286916,10614,895,150
270292772,270290955,270299647,8692,896,150
270305630,270303597,270312288,8691,897,150
270318272,270316238,270325880,9642,898,150
270331865,270329831,270340127,10296,899,150
270345983,270344166,270354460,10294,900,150
270360316,270358499,270367824,9325,901,150
270373809,270371774,270381733,9959,902,150
270387500,270385683,270395008,9325,903,150
270400992,270398958,270407650,8692,904,150
270413634,270411600,270420925,9325,905,150
270426693,270424875,270435172,10297,906,150
270441244,270439211,270448218,9007,907,150
270454201,270452168,270462779,10611,908,150
270468853,270466818,270476144,9326,909,150
270482128,270480094,270489101,9007,910,150
270495085,270493051,270503009,9958,911,150
270508776,270506959,270517264,10305,912,150
270523121,270521303,270530574,9271,913,150
270536558,270534524,270545136,10612,914,150
270550992,270549175,270559470,10295,915,150
270565327,270563509,270574069,10560,916,150
270580142,270578108,270587749,9641,917,150
270593732,270591699,270601340,9641,918,150
270607107,270605290,270614614,9324,919,150
270620381,270618564,270627571,9007,920,150
270633338,270631521,270640560,9039,921,150
270646544,270644510,270653202,8692,922,150
270658969,270657152,270668081,10929,923,150
270674154,270672120,270681445,9325,924,150
270687430,270685395,270696324,10929,925,150
270702181,270700363,270709056,8693,926,150
270715040,270713006,270723617,10611,927,150
270729691,270727656,270737615,9959,928,150
270743382,270741565,270751206,9641,929,150
270757190,270755156,270764796,9640,930,150
270770779,270768746,270777754,9008,931,150
270783737,270781704,270791344,9640,932,150
270797111,270795294,270804966,9672,933,150
270810733,270808916,270819221,10305,934,150
270825294,270823260,270832901,9641,935,150
270838886,270836851,270847147,10296,936,150
270853220,270851186,270861144,9958,937,150
270866912,270865094,270875052,9958,938,150
270881036,270879002,270888643,9641,939,150
270894627,270892593,270902551,9958,940,150
270908534,270906501,270917429,10928,941,150
270923502,270921468,270931110,9642,942,150
270937096,270935061,270944704,9643,943,150
270950688,270948654,270959265,10611,944,150
270965338,270963304,270972312,9008,945,150
270978081,270976263,270985620,9357,946,150
270991604,270989570,271000182,10612,947,150
271006039,271004221,271013494,9273,948,150
271019260,271017444,271025849,8405,949,150
271031616,271029799,271040442,10643,950,150
271046515,271044481,271054123,9642,951,150
271060107,271058073,271066765,8692,952,150
271072749,271070715,271080357,9642,953,150
271086124,271084307,271095267,10960,954,150
271101340,271099306,271107998,8692,955,150
271113765,271111948,271120640,8692,956,150
271126624,271124590,271134885,10295,957,150
271140741,271138924,271147877,8953,958,150
271153645,271151827,271161500,9673,959,150
271167267,271165450,271175408,9958,960,150
271181392,271179358,271189971,10613,961,150
271196045,271194010,271203019,9009,962,150
271208787,271206969,271217582,10613,963,150
271223438,271221621,271231917,10296,964,150
271237773,271235956,271246567,10611,965,150
271252424,271250606,271260247,9641,966,150
271266014,271264197,271273205,9008,967,150
271279189,271277155,271285846,8691,968,150
271291614,271289797,271298837,9040,969,150
271304605,271302787,271313400,10613,970,150
271319257,271317439,271327028,9589,971,150
271333013,271330979,271339987,9008,972,150
271345754,271343937,271354896,10959,973,150
271360752,271358935,271368576,9641,974,150
271374560,271372526,271382168,9642,975,150
271388152,271386118,271394809,8691,976,150
271400576,271398759,271407481,8722,977,150
271413465,271411431,271422359,10928,978,150
271428433,271426398,271436041,9643,979,150
271442025,271439991,271450602,10611,980,150
271456458,271454641,271464881,10240,981,150
271470737,271468920,271477875,8955,982,150
271483859,271481825,271491466,9641,983,150
271497233,271495416,271505374,9958,984,150
271511141,271509324,271518966,9642,985,150
271524734,271522916,271532926,10010,986,150
271538999,271536965,271546607,9642,987,150
271552374,271550557,271561169,10612,988,150
271567025,271565208,271574848,9640,989,150
271580832,271578798,271589727,10929,990,150
271595583,271593766,271607343,13577,991,150
271613199,271611382,271622025,10643,992,150
271628098,271626064,271636360,10296,993,150
271642433,271640399,271650357,9958,994,150
271656124,271654307,271662997,8690,995,150
271668764,271666948,271676935,9987,996,150
271682702,271680885,271689608,8723,997,150
271695375,271693558,271702280,8722,998,150
271708265,271706230,271715873,9643,999,150
271721642,271719824,271730468,10644,1000,150
271736413,271734596,271743466,8870,1001,150
271749539,271747505,271756514,9009,1002,150
271762586,271760553,271770848,10295,1003,150
271777010,271774976,271783984,9008,1004,150
271789839,271788023,271798634,10611,1005,150
271804579,271802762,271813553,10791,1006,150
271819499,271817681,271828610,10929,1007,150
271834773,271832738,271841431,8693,1008,150
271847504,271845470,271854479,9009,1009,150
271860552,271858518,271867210,8692,1010,150
271873066,271871249,271881808,10559,1011,150
271887753,271885936,271896726,10790,1012,150
271902672,271900854,271911467,10613,1013,150
271917628,271915595,271926206,10611,1014,150
271932151,271930334,271939025,8691,1015,150
271944881,271943064,271952705,9641,1016,150
271958560,271956744,271967039,10295,1017,150
271973201,271971167,271980491,9324,1018,150
271986347,271984530,271995173,10643,1019,150
272001118,271999301,272008942,9641,1020,150
272015015,272012981,272023910,10929,1021,150
272029854,272028037,272038333,10296,1022,150
272044496,272042461,272051470,9009,1023,150
272057327,272055509,272065152,9643,1024,150
272071225,272069191,272080119,10928,1025,150
272086065,272084247,272094544,10297,1026,150
272100489,272098672,272107680,9008,1027,150
272113537,272111719,272121962,10243,1028,150
272128124,272126090,272136048,9958,1029,150
272142121,272140087,272151015,10928,1030,150
272156961,272155143,272165755,10612,1031,150
272171700,272169883,272178891,9008,1032,150
272184965,272182930,272193227,10297,1033,150
272199390,272197355,272207314,9959,1034,150
272213387,272211353,272221649,10296,1035,150
272227810,272225776,272236072,10296,1036,150
272242232,272240199,272250156,9957,1037,150
272256012,272254195,272263148,8953,1038,150
272269221,272267187,272277144,9957,1039,150
272283000,272281183,272291795,10612,1040,150
272297741,272295923,272306219,10296,1041,150
272312164,272310347,272321276,10929,1042,150
272327221,272325404,272334412,9008,1043,150
272340269,272338451,272347459,9008,1044,150
272353315,272351498,272360769,9271,1045,150
272366625,272364808,272373816,9008,1046,150
272379888,272377855,272386546,8691,1047,150
272392402,272390585,272401143,10558,1048,150
272407088,272405270,272415567,10297,1049,150
272421512,272419695,272428565,8870,1050,150
272434638,272432604,272441613,9009,1051,150
272447686,272445652,272454977,9325,1052,150
272460832,272459016,272469889,10873,1053,150
272476051,272474017,272484312,10295,1054,150
272490474,272488440,272498419,9979,1055,150
272504275,272502458,272513386,10928,1056,150
272519331,272517514,272527671,10157,1057,150
272533834,272531799,272540492,8693,1058,150
272546565,272544531,272553538,9007,1059,150
272559394,272557577,272566902,9325,1060,150
272572975,272570941,272580583,9642,1061,150
272586657,272584622,272594602,9980,1062,150
272600458,272598641,272608620,9979,1063,150
272614476,272612659,272623587,10928,1064,150
272629749,272627715,272636407,8692,1065,150
272642480,272640446,272650403,9957,1066,150
272656259,272654441,272664999,10558,1067,150
272671160,272669126,272679422,10296,1068,150
272685367,272683549,272693191,9642,1069,150
272699264,272697230,272708159,10929,1070,150
272714104,272712286,272722898,10612,1071,150
272729059,272727026,272736983,9957,1072,150
272742839,272741022,272751318,10296,1073,150
272757264,272755446,272764634,9188,1074,150
272770489,272768673,272778967,10294,1075,150
272784913,272783095,272792737,9642,1076,150
272798810,272796776,272807705,10929,1077,150
272813867,272811833,272821790,9957,1078,150
272827863,272825829,272836125,10296,1079,150
272842068,272840252,272849258,9006,1080,150
272855114,272853297,272862567,9270,1081,150
272868423,272866606,272877217,10611,1082,150
272883162,272881345,272892273,10928,1083,150
272898217,272896400,272905091,8691,1084,150
272911164,272909130,272920059,10929,1085,150
272926004,272924186,272932878,8692,1086,150
272938734,272936917,272946242,9325,1087,150
272952098,272950281,272961155,10874,1088,150
272967101,272965283,272973836,8553,1089,150
272979908,272977875,272988486,10611,1090,150
272994430,272992613,273001303,8690,1091,150
273007376,273005342,273016270,10928,1092,150
273022215,273020398,273028951,8553,1093,150
273035024,273032990,273042315,9325,1094,150
273048170,273046354,273054991,8637,1095,150
273061064,273059030,273069643,10613,1096,150
273075587,273073771,273083411,9640,1097,150
273089484,273087450,273097092,9642,1098,150
273103165,273101131,273110455,9324,1099,150
273116528,273114494,273124790,10296,1100,150
273130951,273128918,273138558,9640,1101,150
273144414,273142597,273151604,9007,1102,150
273157460,273155643,273165601,9958,1103,150
273171458,273169640,273179861,10221,1104,150
273185806,273183989,273192681,8692,1105,150
273198755,273196721,273207332,10611,1106,150
273213493,273211460,273220467,9007,1107,150
273226324,273224506,273234148,9642,1108,150
273240221,273238187,273248144,9957,1109,150
273254218,273252183,273261508,9325,1110,150
273267364,273265547,273275504,9957,1111,150
273281576,273279543,273288234,8691,1112,150
273294090,273292273,273301598,9325,1113,150
273307671,273305637,273315932,10295,1114,150
273321877,273320060,273329701,9641,1115,150
273335558,273333740,273343696,9956,1116,150
273349551,273347735,273357405,9670,1117,150
273363478,273361444,273371402,9958,1118,150
273377475,273375441,273385083,9642,1119,150
273390940,273389122,273399081,9959,1120,150
273404937,273403120,273413415,10295,1121,150
273419359,273417543,273427499,9956,1122,150
273433572,273431538,273440863,9325,1123,150
273446936,273444902,273454227,9325,1124,150
273460083,273458266,273468877,10611,1125,150
273475039,273473005,273482014,9009,1126,150
273488086,273486053,273495694,9641,1127,150
273501767,273499733,273508741,9008,1128,150
273514598,273512780,273522368,9588,1129,150
273528440,273526407,273537017,10610,1130,150
273543179,273541145,273550153,9008,1131,150
273556010,273554192,273563548,9356,1132,150
273569404,273567587,273576279,8692,1133,150
273582354,273580319,273590278,9959,1134,150
273596135,273594317,273604614,10297,1135,150
273610776,273608742,273617434,8692,1136,150
273623507,273621473,273631768,10295,1137,150
273637930,273635896,273645854,9958,1138,150
273651928,273649893,273659536,9643,1139,150
273665609,273663575,273672583,9008,1140,150
273678656,273676622,273687551,10929,1141,150
273693496,273691679,273702153,10474,1142,150
273708315,273706281,273715606,9325,1143,150
273721463,273719645,273728916,9271,1144,150
273734772,273732955,273741909,8954,1145,150
273747981,273745948,273756559,10611,1146,150
273762503,273760686,273771160,10474,1147,150
273777322,273775288,273784295,9007,1148,150
273790150,273788334,273798005,9671,1149,150
273804077,273802044,273812339,10295,1150,150
273818500,273816467,273825791,9324,1151,150
273831647,273829830,273839470,9640,1152,150
273845543,273843509,273853467,9958,1153,150
273859540,273857506,273866514,9008,1154,150
273872370,273870553,273879245,8692,1155,150
273885317,273883284,273892607,9323,1156,150
273898680,273896646,273906288,9642,1157,150
273912361,273910327,273919969,9642,1158,150
273926043,273924009,273933649,9640,1159,150
273939506,273937688,273947331,9643,1160,150
273953404,273951370,273961982,10612,1161,150
273967926,273966109,273975750,9641,1162,150
273981824,273979789,273990402,10613,1163,150
273996563,273994529,274004171,9642,1164,150
274010245,274008210,274018822,10612,1165,150
274024984,274022950,274032907,9957,1166,150
274038980,274036946,274045637,8691,1167,150
274051493,274049676,274059001,9325,1168,150
274065074,274063040,274073968,10928,1169,150
274080130,274078096,274088054,9958,1170,150
274094127,274092093,274102389,10296,1171,150
274108551,274106517,274116159,9642,1172,150
274122232,274120198,274131127,10929,1173,150
274137289,274135255,274144896,9641,1174,150
274150970,274148935,274159548,10613,1175,150
274165493,274163676,274172367,8691,1176,150
274178224,274176406,274186365,9959,1177,150
274192221,274190404,274199096,8692,1178,150
274205169,274203135,274214063,10928,1179,150
274220224,274218191,274228485,10294,1180,150
274234647,274232612,274242570,9958,1181,150
274248426,274246609,274256566,9957,1182,150
274262423,274260605,274271534,10929,1183,150
274277697,274275662,274285305,9643,1184,150
274291161,274289344,274298986,9642,1185,150
274305058,274303025,274312982,9957,1186,150
274319056,274317022,274325714,8692,1187,150
274331787,274329753,274340366,10613,1188,150
274346528,274344494,274354789,10295,1189,150
274360951,274358917,274369213,10296,1190,150
274375374,274373341,274384268,10927,1191,150
274390213,274388396,274398869,10473,1192,150
274404813,274402997,274413607,10610,1193,150
274419552,274417735,274428209,10474,1194,150
274434370,274432337,274441661,9324,1195,150
274447517,274445700,274455996,10296,1196,150
274462158,274460124,274470736,10612,1197,150
274476681,274474864,274485793,10929,1198,150
274491954,274489920,274498928,9008,1199,150
274504784,274502967,274512291,9324,1200,150
274518148,274516330,274525686,9356,1201,150
274531542,274529725,274538733,9008,1202,150
274544590,274542772,274551496,8724,1203,150
274557353,274555535,274565494,9959,1204,150
274571567,274569533,274578223,8690,1205,150
274584296,274582262,274592874,10612,1206,150
274598819,274597002,274606820,9818,1207,150
274612894,274610859,274621156,10297,1208,150
274627317,274625284,274635240,9956,1209,150
274641096,274639279,274649237,9958,1210,150
274655310,274653276,274661968,8692,1211,150
274667824,274666007,274675965,9958,1212,150
274682038,274680004,274689646,9642,1213,150
274695502,274693685,274703273,9588,1214,150
274709346,274707312,274717608,10296,1215,150
274723770,274721736,274730745,9009,1216,150
274736819,274734784,274745714,10930,1217,150
274751659,274749842,274758534,8692,1218,150
274764607,274762573,274772531,9958,1219,150
274778603,274776570,274786527,9957,1220,150
274792383,274790566,274800858,10292,1221,150
274806804,274804986,274814945,9959,1222,150
274820801,274818984,274829204,10220,1223,150
274835366,274833332,274843944,10612,1224,150
274850106,274848072,274857079,9007,1225,150
274862934,274861118,274870441,9323,1226,150
274876297,274874480,274885092,10612,1227,150
274891037,274889220,274899177,9957,1228,150
274905034,274903216,274912857,9641,1229,150
274918930,274916896,274926854,9958,1230,150
274932927,274930893,274940851,9958,1231,150
274946924,274944890,274954848,9958,1232,150
274960921,274958887,274968212,9325,1233,150
274974068,274972251,274982209,9958,1234,150
274988067,274986249,274995891,9642,1235,150
275001747,274999930,275009602,9672,1236,150
275015460,275013641,275023316,9675,1237,150
275029389,275027356,275037313,9957,1238,150
275043168,275041352,275050389,9037,1239,150
275056246,275054428,275065358,10930,1240,150
275071520,275069486,275080415,10929,1241,150
275086576,275084543,275095471,10928,1242,150
275101633,275099599,275109240,9641,1243,150
275115096,275113279,275122604,9325,1244,150
275128460,275126643,275135651,9008,1245,150
275141509,275139691,275149984,10293,1246,150
275156147,275154112,275162805,8693,1247,150
275168879,275166844,275177774,10930,1248,150
275183935,275181902,275192197,10295,1249,150
275198143,275196325,275206939,10614,1250,150
275212884,275211067,275220391,9324,1251,150
275226247,275224430,275234650,10220,1252,150
275240595,275238778,275249073,10295,1253,150
275255019,275253201,275264131,10930,1254,150
275270075,275268258,275278870,10612,1255,150
275284814,275282997,275293293,10296,1256,150
275299237,275297420,275306607,9187,1257,150
275312463,275310646,275319971,9325,1258,150
275325828,275324010,275334623,10613,1259,150
275340784,275338750,275348392,9642,1260,150
275354464,275352431,275362072,9641,1261,150
275367929,275366111,275376407,10296,1262,150
275382352,275380535,275391147,10612,1263,150
275397091,275395274,275404281,9007,1264,150
275410354,275408320,275417012,8692,1265,150
275422868,275421051,275431347,10296,1266,150
275437509,275435475,275444484,9009,1267,150
275450557,275448523,275458480,9957,1268,150
275464336,275462519,275471211,8692,1269,150
275477284,275475250,275485208,9958,1270,150
275491064,275489247,275498602,9355,1271,150
275504458,275502641,275513515,10874,1272,150
275519460,275517643,275528571,10928,1273,150
275534733,275532699,275542656,9957,1274,150
275548512,275546695,275557623,10928,1275,150
275563568,275561751,275570304,8553,1276,150
275576376,275574343,275584637,10294,1277,150
275590581,275588764,275597771,9007,1278,150
275603626,275601810,275610501,8691,1279,150
275616574,275614540,275624498,9958,1280,150
275630571,275628537,275637862,9325,1281,150
275643718,275641901,275650622,8721,1282,150
275656479,275654661,275663068,8407,1283,150
275668924,275667107,275676432,9325,1284,150
275682289,275680471,275689163,8692,1285,150
275695019,275693202,275701924,8722,1286,150
275707781,275705963,275715605,9642,1287,150
275721460,275719643,275730255,10612,1288,150
275736417,275734383,275745312,10929,1289,150
275751257,275749440,275759398,9958,1290,150
275765471,275763437,275773732,10295,1291,150
275779895,275777860,275788789,10929,1292,150
275794733,275792917,275803051,10134,1293,150
275808996,275807179,275817791,10612,1294,150
275823953,275821919,275832214,10295,1295,150
275838376,275836342,275846300,9958,1296,150
275852372,275850339,275860950,10611,1297,150
275866896,275865078,275874403,9325,1298,150
275880258,275878442,275888398,9956,1299,150
275894254,275892437,275903049,10612,1300,150
275908994,275907177,275916048,8871,1301,150
275922122,275920087,275930046,9959,1302,150
275936119,275934085,275944697,10612,1303,150
275950642,275948825,275959120,10295,1304,150
275965065,275963248,275972118,8870,1305,150
275978191,275976157,275985482,9325,1306,150
275991555,275989521,275998212,8691,1307,150
276004285,276002251,276011260,9009,1308,150
276017333,276015299,276025910,10611,1309,150
276031854,276030037,276040648,10611,1310,150
276046811,276044776,276054419,9643,1311,150
276060492,276058458,276068753,10295,1312,150
276074914,276072881,276083808,10927,1313,150
276089970,276087936,276098865,10929,1314,150
276104811,276102993,276113784,10791,1315,150
276119946,276117912,276126604,8692,1316,150
276132461,276130643,276139914,9271,1317,150
276145770,276143953,276154510,10557,1318,150
276160672,276158638,276167646,9008,1319,150
276173502,276171685,276181980,10295,1320,150
276187925,276186108,276197037,10929,1321,150
276203200,276201165,276211461,10296,1322,150
276217406,276215589,276226517,10928,1323,150
276232462,276230645,276239970,9325,1324,150
276246044,276244009,276253967,9958,1325,150
276259823,276258006,276266698,8692,1326,150
276272771,276270737,276280379,9642,1327,150
276286452,276284418,276294376,9958,1328,150
276300233,276298415,276307055,8640,1329,150
276312911,276311094,276319785,8691,1330,150
276325858,276323824,276333149,9325,1331,150
276339005,276337188,276345880,8692,1332,150
276351954,276349919,276359879,9960,1333,150
276365735,276363918,276374530,10612,1334,150
276380692,276378658,276387350,8692,1335,150
276393424,276391389,276402003,10614,1336,150
276408165,276406131,276415455,9324,1337,150
276421312,276419494,276436270,16776,1338,150
276442433,276440399,276450357,9958,1339,150
276456430,276454396,276463403,9007,1340,150
276469259,276467442,276476451,9009,1341,150
276482525,276480491,276490787,10296,1342,150
276496948,276494914,276505526,10612,1343,150
276511687,276509653,276518978,9325,1344,150
276524835,276523017,276532658,9641,1345,150
276538514,276536697,276546284,9587,1346,150
276552141,276550323,276559648,9325,1347,150
276565504,276563687,276572377,8690,1348,150
276578448,276576415,276585422,9007,1349,150
276591278,276589461,276602193,12732,1350,150
276608355,276606321,276616278,9957,1351,150
276622135,276620317,276629959,9642,1352,150
276635815,276633998,276644324,10326,1353,150
276650486,276648451,276659380,10929,1354,150
276665541,276663507,276674119,10612,1355,150
276680281,276678247,276686939,8692,1356,150
276693012,276690978,276700303,9325,1357,150
276706376,276704342,276715271,10929,1358,150
276721433,276719399,276728724,9325,1359,150
276734581,276732763,276743055,10292,1360,150
276749000,276747183,276756824,9641,1361,150
276762897,276760863,276771159,10296,1362,150
276777320,276775287,276784927,9640,1363,150
276791000,276788966,276801309,12343,1364,150
276807471,276805437,276815733,10296,1365,150
276821678,276819860,276836952,17092,1366,150
276843114,276841080,276850088,9008,1367,150
276855944,276854127,276862819,8692,1368,150
276868891,276866858,276875866,9008,1369,150
276881722,276879905,276890833,10928,1370,150
276896994,276894960,276905572,10612,1371,150
276911733,276909700,276919657,9957,1372,150
276925730,276923696,276932388,8692,1373,150
276938462,276936427,276946723,10296,1374,150
276952885,276950851,276959858,9007,1375,150
276965932,276963897,276972907,9010,1376,150
276978763,276976946,276987242,10296,1377,150
276993402,276991369,277000692,9323,1378,150
277006764,277004731,277013738,9007,1379,150
277019594,277017777,277028070,10293,1380,150
277034015,277032198,277041206,9008,1381,150
277047279,277045245,277054254,9009,1382,150
277060109,277058293,277066984,8691,1383,150
277073057,277071023,277080980,9957,1384,150
277087053,277085019,277094661,9642,1385,150
277100517,277098700,277109628,10928,1386,150
277115574,277113756,277122447,8691,1387,150
277128520,277126486,277135811,9325,1388,150
277141884,277139850,277148859,9009,1389,150
277154716,277152898,277163825,10927,1390,150
277169771,277167953,277177456,9503,1391,150
277183312,277181495,277190851,9356,1392,150
277196923,277194890,277205817,10927,1393,150
277211979,277209945,277220557,10612,1394,150
277226502,277224685,277234010,9325,1395,150
277239866,277238049,277246455,8406,1396,150
277252528,277250494,277260136,9642,1397,150
277266209,277264175,277272867,8692,1398,150
277278724,277276906,277285598,8692,1399,150
277291671,277289637,277298961,9324,1400,150
277305033,277303000,277313612,10612,1401,150
277319556,277317739,277328033,10294,1402,150
277334195,277332161,277342773,10612,1403,150
277348935,277346901,277357830,10929,1404,150
277363775,277361958,277371145,9187,1405,150
277377218,277375184,277384826,9642,1406,150
277390682,277388865,277398189,9324,1407,150
277404262,277402228,277412523,10295,1408,150
277418469,277416651,277427580,10929,1409,150
277433743,277431708,277440716,9008,1410,150
277446789,277444755,277455051,10296,1411,150
277460996,277459179,277467733,8554,1412,150
277473806,277471772,277482701,10929,1413,150
277488863,277486829,277497758,10929,1414,150
277503703,277501886,277510756,8870,1415,150
277516612,277514795,277523200,8405,1416,150
277529273,277527239,277537534,10295,1417,150
277543479,277541662,277550533,8871,1418,150
277556389,277554572,277564212,9640,1419,150
277570285,277568251,277578546,10295,1420,150
277584706,277582673,277592967,10294,1421,150
277598913,277597095,277606600,9505,1422,150
277612673,277610639,277620935,10296,1423,150
277626881,277625063,277635022,9959,1424,150
277641095,277639061,277649673,10612,1425,150
277655619,277653801,277663759,9958,1426,150
277669834,277667799,277678096,10297,1427,150
277684259,277682224,277691867,9643,1428,150
277697723,277695906,277705810,9904,1429,150
277711668,277709850,277718489,8639,1430,150
277724562,277722528,277732170,9642,1431,150
277738025,277736209,277745247,9038,1432,150
277751103,277749286,277758009,8723,1433,150
277763867,277762049,277772377,10328,1434,150
277778323,277776505,277785198,8693,1435,150
277791270,277789237,277798877,9640,1436,150
277804950,277802916,277813211,10295,1437,150
277819157,277817339,277826032,8693,1438,150
277831888,277830071,277840060,9989,1439,150
277845916,277844099,277853686,9587,1440,150
277859543,277857725,277868601,10876,1441,150
277874547,277872729,277882888,10159,1442,150
277889049,277887015,277895706,8691,1443,150
277901562,277899745,277908382,8637,1444,150
277914238,277912421,277920826,8405,1445,150
277926898,277924865,277934821,9956,1446,150
277940678,277938860,277947551,8691,1447,150
277953624,277951590,277960599,9009,1448,150
277966673,277964638,277975250,10612,1449,150
277981412,277979378,277989020,9642,1450,150
277994877,277993059,278002330,9271,1451,150
278008404,278006370,278017298,10928,1452,150
278023460,278021426,278031722,10296,1453,150
278037884,278035850,278045174,9324,1454,150
278051030,278049213,278058168,8955,1455,150
278064240,278062207,278070897,8690,1456,150
278076970,278074936,278085232,10296,1457,150
278091394,278089360,278098368,9008,1458,150
278104225,278102407,278111733,9326,1459,150
278117589,278115772,278126067,10295,1460,150
278132229,278130195,278138887,8692,1461,150
278144960,278142926,278153855,10929,1462,150
278160017,278157983,278166675,8692,1463,150
278172748,278170714,278181010,10296,1464,150
278186955,278185138,278195117,9979,1465,150
278201190,278199156,278208165,9009,1466,150
278214238,278212204,278221845,9641,1467,150
278227918,278225884,278235209,9325,1468,150
278241282,278239248,278249205,9957,1469,150
278255061,278253244,278262569,9325,1470,150
278268425,278266608,278277251,10643,1471,150
278283197,278281379,278292308,10929,1472,150
278298470,278296436,278305445,9009,1473,150
278311518,278309484,278318175,8691,1474,150
278324248,278322214,278330905,8691,1475,150
278336761,278334944,278345503,10559,1476,150
278351449,278349631,278358640,9009,1477,150
278364713,278362679,278371687,9008,1478,150
278377760,278375726,278385684,9958,1479,150
278391757,278389723,278400336,10613,1480,150
278406498,278404464,278413789,9325,1481,150
278419862,278417828,278427470,9642,1482,150
278433543,278431509,278440201,8692,1483,150
278446056,278444240,278454193,9953,1484,150
278460050,278458232,278468137,9905,1485,150
278473993,278472176,278483105,10929,1486,150
278489051,278487233,278496735,9502,1487,150
278502808,278500774,278511702,10928,1488,150
278517864,278515830,278526125,10295,1489,150
278532070,278530253,278539123,8870,1490,150
278545196,278543162,278553458,10296,1491,150
278559404,278557586,278566774,9188,1492,150
278572631,278570813,278580086,9273,1493,150
278585943,278584125,278593134,9009,1494,150
278598990,278597173,278606126,8953,1495,150
278612199,278610165,278619173,9008,1496,150
278625246,278623212,278632220,9008,1497,150
278638293,278636259,278645901,9642,1498,150
278651973,278649940,278658631,8691,1499,150
278664704,278662670,278672966,10296,1500,150
278678912,278677094,278685965,8871,1501,150
278691821,278690004,278698726,8722,1502,150
278704799,278702765,278712090,9325,1503,150
278718163,278716129,278725453,9324,1504,150
278731526,278729492,278738500,9008,1505,150
278744573,278742539,278751546,9007,1506,150
278757402,278755585,278765538,9953,1507,150
278771395,278769577,278777984,8407,1508,150
278783841,278782023,278791982,9959,1509,150
278798055,278796021,278805661,9640,1510,150
278811733,278809700,278819657,9957,1511,150
278825730,278823696,278832388,8692,1512,150
278838461,278836427,278846067,9640,1513,150
278851923,278850106,278859694,9588,1514,150
278865550,278863733,278872687,8954,1515,150
278878543,278876726,278885364,8638,1516,150
278891221,278889403,278898096,8693,1517,150
278903953,278902135,278912432,10297,1518,150
278918595,278916560,278926201,9641,1519,150
278932057,278930240,278940198,9958,1520,150
278946271,278944237,278953879,9642,1521,150
278959735,278957918,278968846,10928,1522,150
278975008,278972974,278981982,9008,1523,150
278988055,278986021,278996317,10296,1524,150
279002263,279000445,279010425,9980,1525,150
279016497,279014464,279023155,8691,1526,150
279029011,279027194,279037806,10612,1527,150
279043752,279041934,279051913,9979,1528,150
279057769,279055952,279065593,9641,1529,150
279071666,279069632,279078641,9009,1530,150
279084498,279082680,279091372,8692,1531,150
279097228,279095411,279105369,9958,1532,150
279111443,279109408,279119050,9642,1533,150
279124906,279123089,279132097,9008,1534,150
279138169,279136136,279145776,9640,1535,150
279151632,279149815,279159402,9587,1536,150
279165258,279163441,279172766,9325,1537,150
279178839,279176805,279185496,8691,1538,150
279191569,279189535,279199830,10295,1539,150
279205992,279203958,279214570,10612,1540,150
279220515,279218697,279229627,10930,1541,150
279235789,279233755,279242447,8692,1542,150
279248521,279246486,279256465,9979,1543,150
279262537,279260504,279270799,10295,1544,150
279276744,279274927,279284746,9819,1545,150
279290819,279288785,279299714,10929,1546,150
279305658,279303841,279313026,9185,1547,150
279319099,279317065,279327023,9958,1548,150
279333096,279331062,279341675,10613,1549,150
279347838,279345803,279355128,9325,1550,150
279361202,279359167,279368493,9326,1551,150
279374567,279372532,279381858,9326,1552,150
279387931,279385897,279395539,9642,1553,150
279401612,279399578,279409219,9641,1554,150
279415075,279413258,279423870,10612,1555,150
279430032,279427998,279437007,9009,1556,150
279443080,279441046,279450688,9642,1557,150
279456544,279454727,279465022,10295,1558,150
279471185,279469150,279478792,9642,1559,150
279484648,279482831,279493759,10928,1560,150
279499921,279497887,279507845,9958,1561,150
279513918,279511884,279521842,9958,1562,150
279527698,279525881,279534836,8955,1563,150
279540692,279538875,279548832,9957,1564,150
279554688,279552871,279563483,10612,1565,150
279569645,279567610,279576620,9010,1566,150
279582476,279580659,279591271,10612,1567,150
279597433,279595399,279605041,9642,1568,150
279611114,279609080,279619693,10613,1569,150
279625639,279623821,279634295,10474,1570,150
279640456,279638423,279647431,9008,1571,150
279653505,279651470,279660163,8693,1572,150
279666019,279664202,279673527,9325,1573,150
279679600,279677566,279686258,8692,1574,150
279692331,279690297,279699305,9008,1575,150
279705377,279703344,279712035,8691,1576,150
279718108,279716074,279725083,9009,1577,150
279730940,279729122,279737529,8407,1578,150
279743385,279741568,279750204,8636,1579,150
279756277,279754243,279764201,9958,1580,150
279770057,279768240,279777510,9270,1581,150
279783366,279781549,279791507,9958,1582,150
279797365,279795547,279805190,9643,1583,150
279811047,279809230,279818502,9272,1584,150
279824359,279822541,279831813,9272,1585,150
279837670,279835852,279845811,9959,1586,150
279851668,279849850,279860147,10297,1587,150
279866092,279864275,279875066,10791,1588,150
279881229,279879194,279888837,9643,1589,150
279894694,279892876,279902781,9905,1590,150
279908639,279906821,279917465,10644,1591,150
279923627,279921593,279932205,10612,1592,150
279938150,279936333,279946808,10475,1593,150
279952754,279950936,279961391,10455,1594,150
279967553,279965519,279976131,10612,1595,150
279982076,279980259,279991188,10929,1596,150
279997351,279995316,280004009,8693,1597,150
280009865,280008048,280017403,9355,1598,150
280023259,280021442,280030767,9325,1599,150
280036840,280034806,280044763,9957,1600,150
280050620,280048803,280057495,8692,1601,150
280063352,280061535,280072409,10874,1602,150
280078572,280076538,280086179,9641,1603,150
280092253,280090219,280100177,9958,1604,150
280106034,280104217,280115092,10875,1605,150
280121255,280119221,280128229,9008,1606,150
280134086,280132269,280140907,8638,1607,150
280146981,280144947,280153639,8692,1608,150
280159714,280157679,280166687,9008,1609,150
280172761,280170727,280179736,9009,1610,150
280185810,280183776,280193100,9324,1611,150
280199174,280197140,280207098,9958,1612,150
280212953,280211137,280219828,8691,1613,150
280225685,280223868,280233773,9905,1614,150
280239630,280237813,280246817,9004,1615,150
280252891,280250857,280260815,9958,1616,150
280266673,280264855,280273864,9009,1617,150
280279938,280277904,280287862,9958,1618,150
280293936,280291902,280301860,9958,1619,150
280307717,280305900,280315573,9673,1620,150
280321430,280319613,280329201,9588,1621,150
280335059,280333241,280341964,8723,1622,150
280347821,280346004,280355329,9325,1623,150
280361185,280359368,280369926,10558,1624,150
280376090,280374055,280384668,10613,1625,150
280390831,280388797,280398439,9642,1626,150
280404513,280402479,280412121,9642,1627,150
280417979,280416161,280426488,10327,1628,150
280432434,280430617,280440436,9819,1629,150
280446510,280444476,280455405,10929,1630,150
280461351,280459534,280469176,9642,1631,150
280475034,280473216,280484090,10874,1632,150
280490036,280488219,280498335,10116,1633,150
280504281,280502464,280512422,9958,1634,150
280518496,280516461,280527390,10929,1635,150
280533336,280531519,280540704,9185,1636,150
280546562,280544744,280555357,10613,1637,150
280561519,280559485,280569443,9958,1638,150
280575517,280573483,280582491,9008,1639,150
280588565,280586531,280597142,10611,1640,150
280603304,280601270,280610278,9008,1641,150
280616135,280614318,280624538,10220,1642,150
280630485,280628667,280639119,10452,1643,150
280645282,280643248,280652572,9324,1644,150
280658646,280656612,280665937,9325,1645,150
280672010,280669977,280680271,10294,1646,150
280686433,280684399,280693407,9008,1647,150
280699264,280697447,280708090,10643,1648,150
280714036,280712219,280723148,10929,1649,150
280729310,280727277,280736918,9641,1650,150
280742775,280740958,280750281,9323,1651,150
280756138,280754321,280763992,9671,1652,150
280770066,280768032,280777357,9325,1653,150
280783430,280781397,280790404,9007,1654,150
280796262,280794444,280805374,10930,1655,150
280811537,280809503,280820432,10929,1656,150
280826379,280824561,280834381,9820,1657,150
280840238,280838421,280848061,9640,1658,150
280854134,280852100,280861109,9009,1659,150
280866967,280865149,280874158,9009,1660,150
280880015,280878198,280886889,8691,1661,150
280892963,280890929,280901857,10928,1662,150
280907803,280905986,280916913,10927,1663,150
280922859,280921042,280930050,9008,1664,150
280936124,280934090,280944702,10612,1665,150
280950866,280948831,280957524,8693,1666,150
280963381,280961564,280971859,10295,1667,150
280978022,280975988,280986917,10929,1668,150
280992861,280991045,281000231,9186,1669,150
281006088,281004271,281015200,10929,1670,150
281021364,281019329,281028972,9643,1671,150
281034829,281033012,281042367,9355,1672,150
281048441,281046407,281057335,10928,1673,150
281063498,281061464,281070473,9009,1674,150
281076547,281074513,281083522,9009,1675,150
281089596,281087562,281098490,10928,1676,150
281104436,281102619,281111172,8553,1677,150
281117246,281115212,281124221,9009,1678,150
281130295,281128261,281136953,8692,1679,150
281142810,281140993,281150634,9641,1680,150
281156708,281154674,281163366,8692,1681,150
281169223,281167406,281178335,10929,1682,150
281184279,281182463,281193074,10611,1683,150
281199237,281197203,281206528,9325,1684,150
281212384,281210568,281219576,9008,1685,150
281225433,281223616,281233289,9673,1686,150
281239147,281237329,281247942,10613,1687,150
281253889,281252071,281261713,9642,1688,150
281267570,281265753,281275425,9672,1689,150
281281283,281279465,281290078,10613,1690,150
281296025,281294207,281305137,10930,1691,150
281311301,281309266,281318592,9326,1692,150
281324667,281322632,281333562,10930,1693,150
281339725,281337691,281346699,9008,1694,150
281352773,281350739,281360381,9642,1695,150
281366238,281364421,281374641,10220,1696,150
281380804,281378770,281388095,9325,1697,150
281394170,281392135,281402432,10297,1698,150
281408378,281406561,281416857,10296,1699,150
281423019,281420986,281431280,10294,1700,150
281437443,281435409,281445050,9641,1701,150
281451124,281449090,281459386,10296,1702,150
281465549,281463515,281472523,9008,1703,150
281478381,281476563,281485888,9325,1704,150
281491962,281489928,281498937,9009,1705,150
281505011,281502977,281513590,10613,1706,150
281519752,281517719,281528331,10612,1707,150
281534494,281532460,281541152,8692,1708,150
281547009,281545192,281554230,9038,1709,150
281560087,281558270,281568492,10222,1710,150
281574439,281572621,281581471,8850,1711,150
281587328,281585511,281596068,10557,1712,150
281602014,281600197,281609205,9008,1713,150
281615061,281613244,281623612,10368,1714,150
281629776,281627741,281638038,10297,1715,150
281644201,281642167,281653095,10928,1716,150
281659257,281657223,281668151,10928,1717,150
281674314,281672280,281683209,10929,1718,150
281689371,281687337,281698266,10929,1719,150
281704429,281702395,281713324,10929,1720,150
281719487,281717453,281728381,10928,1721,150
281734326,281732509,281741516,9007,1722,150
281747590,281745556,281756485,10929,1723,150
281762430,281760613,281770571,9958,1724,150
281776644,281774611,281785539,10928,1725,150
281791484,281789667,281799625,9958,1726,150
281805699,281803665,281814593,10928,1727,150
281820756,281818722,281828047,9325,1728,150
281833904,281832086,281842306,10220,1729,150
281848470,281846435,281856078,9643,1730,150
281862151,281860117,281869758,9641,1731,150
281875832,281873797,281882490,8693,1732,150
281888346,281886529,281895221,8692,1733,150
281901295,281899261,281909218,9957,1734,150
281915075,281913258,281922582,9324,1735,150
281928439,281926622,281937497,10875,1736,150
281943659,281941625,281950949,9324,1737,150
281957023,281954989,281964631,9642,1738,150
281970705,281968671,281978966,10295,1739,150
281985128,281983094,281993706,10612,1740,150
281999651,281997834,282007336,9502,1741,150
282013410,282011376,282021671,10295,1742,150
282027833,282025799,282035440,9641,1743,150
282041514,282039480,282049438,9958,1744,150
282055295,282053478,282064120,10642,1745,150
282070066,282068248,282078068,9820,1746,150
282083925,282082108,282091433,9325,1747,150
282097507,282095473,282105768,10295,1748,150
282111930,282109896,282120825,10929,1749,150
282126988,282124954,282134912,9958,1750,150
282140770,282138952,282149279,10327,1751,150
282155440,282153407,282164019,10612,1752,150
282169964,282168147,282176701,8554,1753,150
282182775,282180740,282191036,10296,1754,150
282196982,282195164,282205955,10791,1755,150
282212118,282210084,282220380,10296,1756,150
282226327,282224509,282234467,9958,1757,150
282240325,282238507,282249435,10928,1758,150
282255381,282253564,282263522,9958,1759,150
282269379,282267562,282277857,10295,1760,150
282284019,282281986,282292598,10612,1761,150
282298760,282296726,282307339,10613,1762,150
282313501,282311467,282320792,9325,1763,150
282326649,282324832,282333469,8637,1764,150
282339327,282337509,282348121,10612,1765,150
282354283,282352249,282362545,10296,1766,150
282368707,282366673,282377285,10612,1767,150
282383231,282381414,282390917,9503,1768,150
282396774,282394957,282403649,8692,1769,150
282409723,282407689,282416381,8692,1770,150
282422238,282420421,282430326,9905,1771,150
282436182,282434366,282444977,10611,1772,150
282451138,282449105,282459400,10295,1773,150
282465562,282463528,282474457,10929,1774,150
282480403,282478586,282488089,9503,1775,150
282494162,282492129,282502424,10295,1776,150
282508586,282506552,282517481,10929,1777,150
282523644,282521610,282532221,10611,1778,150
282538384,282536349,282545041,8692,1779,150
282550898,282549081,282558723,9642,1780,150
282564581,282562763,282572405,9642,1781,150
282578479,282576445,282585137,8692,1782,150
282591211,282589177,282599473,10296,1783,150
282605419,282603602,282612788,9186,1784,150
282618862,282616828,282626470,9642,1785,150
282632544,282630510,282639835,9325,1786,150
282645909,282643875,282653833,9958,1787,150
282659907,282657873,282667830,9957,1788,150
282673687,282671870,282682165,10295,1789,150
282688327,282686294,282694985,8691,1790,150
282701059,282699025,282708350,9325,1791,150
282714425,282712390,282722349,9959,1792,150
282728206,282726389,282735976,9587,1793,150
282741833,282740016,282750627,10611,1794,150
282756572,282754755,282765367,10612,1795,150
282771312,282769495,282779453,9958,1796,150
282785528,282783493,282792503,9010,1797,150
282798577,282796543,282806184,9641,1798,150
282812040,282810224,282820515,10291,1799,150
282826460,282824643,282834285,9642,1800,150
282840360,282838325,282847651,9326,1801,150
282853724,282851691,282860382,8691,1802,150
282866239,282864422,282873746,9324,1803,150
282879820,282877786,282888398,10612,1804,150
282894561,282892527,282901851,9324,1805,150
282907709,282905891,282916182,10291,1806,150
282922127,282920310,282930446,10136,1807,150
282936609,282934575,282944215,9640,1808,150
282950287,282948254,282957578,9324,1809,150
282963652,282961618,282972230,10612,1810,150
282978175,282976358,282985366,9008,1811,150
282991440,282989406,282998414,9008,1812,150
283004487,283002454,283012411,9957,1813,150
283018485,283016451,283026746,10295,1814,150
283032909,283030875,283040517,9642,1815,150
283046374,283044557,283053828,9271,1816,150
283059686,283057868,283068796,10928,1817,150
283074959,283072925,283083537,10612,1818,150
283089482,283087665,283096990,9325,1819,150
283103065,283101030,283111326,10296,1820,150
283117489,283115454,283125097,9643,1821,150
283130954,283129137,283140066,10929,1822,150
283146228,283144194,283154490,10296,1823,150
283160652,283158618,283168260,9642,1824,150
283174334,283172300,283181309,9009,1825,150
283187384,283185349,283194358,9009,1826,150
283200216,283198398,283207755,9357,1827,150
283213829,283211795,283221119,9324,1828,150
283227193,283225159,283236088,10929,1829,150
283242252,283240217,283250176,9959,1830,150
283256249,283254215,283263855,9640,1831,150
283269930,283267895,283277221,9326,1832,150
283283295,283281261,283292190,10929,1833,150
283298352,283296318,283307247,10929,1834,150
283313409,283311375,283321987,10612,1835,150
283328149,283326115,283335439,9324,1836,150
283341513,283339479,283348488,9009,1837,150
283354345,283352528,283363140,10612,1838,150
283369303,283367269,283378198,10929,1839,150
283384362,283382327,283393256,10929,1840,150
283399202,283397384,283408313,10929,1841,150
283414475,283412442,283421450,9008,1842,150
283427524,283425490,283434182,8692,1843,150
283440257,283438222,283447548,9326,1844,150
283453405,283451588,283460913,9325,1845,150
283466986,283464952,283475881,10929,1846,150
283482044,283480010,283489334,9324,1847,150
283495191,283493374,283504017,10643,1848,150
283510178,283508145,283518102,9957,1849,150
283524177,283522142,283531468,9326,1850,150
283537325,283535508,283544463,8955,1851,150
283550537,283548503,283559115,10612,1852,150
283565277,283563243,283572885,9642,1853,150
283578960,283576925,283585618,8693,1854,150
283591475,283589658,283600217,10559,1855,150
283606379,283604345,283615274,10929,1856,150
283621221,283619403,283630173,10770,1857,150
283636337,283634302,283644598,10296,1858,150
283650761,283648727,283658685,9958,1859,150
283664542,283662725,283673051,10326,1860,150
283679215,283677180,283688110,10930,1861,150
283694272,283692238,283701245,9007,1862,150
283707318,283705285,283714925,9640,1863,150
283720782,283718965,283728869,9904,1864,150
283734943,283732909,283741917,9008,1865,150
283747991,283745957,283755915,9958,1866,150
283761773,283759955,283768909,8954,1867,150
283774983,283772949,283782591,9642,1868,150
283788448,283786631,283797504,10873,1869,150
283803666,283801632,283811274,9642,1870,150
283817348,283815314,283824006,8692,1871,150
283829863,283828046,283836738,8692,1872,150
283842812,283840778,283850102,9324,1873,150
283856176,283854142,283865071,10929,1874,150
283871232,283869199,283877890,8691,1875,150
283883964,283881930,283890939,9009,1876,150
283896797,283894979,283904622,9643,1877,150
283910479,283908662,283918018,9356,1878,150
283923875,283922058,283932986,10928,1879,150
283939150,283937115,283945808,8693,1880,150
283951665,283949848,283960777,10929,1881,150
283966939,283964905,283973914,9009,1882,150
283979989,283977954,283988567,10613,1883,150
283994730,283992696,284002338,9642,1884,150
284008195,284006378,284016674,10296,1885,150
284022838,284020803,284029495,8692,1886,150
284035352,284033535,284044093,10558,1887,150
284050256,284048222,284057547,9325,1888,150
284063404,284061587,284071228,9641,1889,150
284077302,284075268,284084910,9642,1890,150
284090983,284088950,284099562,10612,1891,150
284105724,284103691,284112699,9008,1892,150
284118556,284116739,284125431,8692,1893,150
284131505,284129471,284138795,9324,1894,150
284144870,284142835,284152793,9958,1895,150
284158650,284156833,284166475,9642,1896,150
284172549,284170515,284180810,10295,1897,150
284186757,284184939,284193949,9010,1898,150
284199807,284197989,284206682,8693,1899,150
284212540,284210722,284219445,8723,1900,150
284225302,284223485,284232206,8721,1901,150
284238064,284236246,284246890,10644,1902,150
284253053,284251019,284260977,9958,1903,150
284267051,284265017,284274975,9958,1904,150
284281049,284279015,284289310,10295,1905,150
284295473,284293439,284303080,9641,1906,150
284308938,284307120,284317079,9959,1907,150
284322936,284321119,284330758,9639,1908,150
284336615,284334798,284344119,9321,1909,150
284350193,284348159,284357800,9641,1910,150
284363874,284361840,284372452,10612,1911,150
284378615,284376581,284386539,9958,1912,150
284392396,284390579,284401191,10612,1913,150
284407137,284405320,284414327,9007,1914,150
284420401,284418367,284428662,10295,1915,150
284434827,284432791,284441485,8694,1916,150
284447342,284445525,284455820,10295,1917,150
284461984,284459949,284468959,9010,1918,150
284474817,284472999,284482642,9643,1919,150
284488715,284486681,284497294,10613,1920,150
284503456,284501422,284510430,9008,1921,150
284516504,284514470,284524112,9642,1922,150
284530185,284528152,284538764,10612,1923,150
284544710,284542893,284551764,8871,1924,150
284557622,284555804,284565077,9273,1925,150
284571151,284569117,284577809,8692,1926,150
284583883,284581849,284590858,9009,1927,150
284596932,284594898,284603907,9009,1928,150
284609981,284607947,284618242,10295,1929,150
284624188,284622371,284632189,9818,1930,150
284638046,284636229,284646842,10613,1931,150
284652788,284650971,284661443,10472,1932,150
284667606,284665572,284676501,10929,1933,150
284682664,284680630,284691243,10613,1934,150
284697406,284695372,284705984,10612,1935,150
284711931,284710113,284718805,8692,1936,150
284724880,284722845,284733458,10613,1937,150
284739621,284737587,284747544,9957,1938,150
284753402,284751584,284762143,10559,1939,150
284768307,284766272,284774965,8693,1940,150
284781039,284779005,284788013,9008,1941,150
284794087,284792053,284801061,9008,1942,150
284806919,284805101,284813824,8723,1943,150
284819680,284817863,284827504,9641,1944,150
284833579,284831544,284840870,9326,1945,150
284846727,284844910,284853918,9008,1946,150
284859992,284857958,284867915,9957,1947,150
284873989,284871955,284882566,10611,1948,150
284888729,284886695,284896020,9325,1949,150
284902094,284900060,284910988,10928,1950,150
284917150,284915116,284926045,10929,1951,150
284932208,284930174,284938866,8692,1952,150
284944724,284942906,284951599,8693,1953,150
284957672,284955639,284964330,8691,1954,150
284970404,284968370,284977062,8692,1955,150
284982919,284981102,284991006,9904,1956,150
284996863,284995046,285005003,9957,1957,150
285011078,285009043,285018685,9642,1958,150
285024759,285022725,285032366,9641,1959,150
285038223,285036406,285046048,9642,1960,150
285051904,285050088,285059412,9324,1961,150
285065486,285063452,285074065,10613,1962,150
285080228,285078194,285086886,8692,1963,150
285092959,285090926,285101854,10928,1964,150
285108016,285105983,285114990,9007,1965,150
285120847,285119030,285129958,10928,1966,150
285135904,285134086,285143412,9326,1967,150
285149270,285147452,285155859,8407,1968,150
285161716,285159899,285169169,9270,1969,150
285175026,285173209,285182850,9641,1970,150
285188924,285186890,285197186,10296,1971,150
285203348,285201314,285212243,10929,1972,150
285218406,285216372,285225697,9325,1973,150
285231554,285229737,285240064,10327,1974,150
285246226,285244193,285254150,9957,1975,150
285260224,285258190,285268803,10613,1976,150
285274749,285272932,285281464,8532,1977,150
285287538,285285504,285295462,9958,1978,150
285301536,285299502,285310114,10612,1979,150
285316060,285314243,285323726,9483,1980,150
285329583,285327766,285338695,10929,1981,150
285344858,285342824,285352466,9642,1982,150
285358540,285356506,285366464,9958,1983,150
285372321,285370504,285380092,9588,1984,150
285385949,285384132,285393086,8954,1985,150
285399159,285397126,285407083,9957,1986,150
285413158,285411123,285422053,10930,1987,150
285427999,285426182,285436794,10612,1988,150
285442956,285440923,285450880,9957,1989,150
285456738,285454920,285465850,10930,1990,150
285472013,285469979,285480908,10929,1991,150
285486855,285485037,285495491,10454,1992,150
285501438,285499620,285510549,10929,1993,150
285516712,285514678,285523370,8692,1994,150
285529228,285527410,285538340,10930,1995,150
285544502,285542468,285551476,9008,1996,150
285557550,285555516,285564523,9007,1997,150
285570597,285568563,285579176,10613,1998,150
285585123,285583305,285594234,10929,1999,150
285600180,285598363,285608160,9797,2000,150
285614018,285612200,285623130,10930,2001,150
285629076,285627259,285637871,10612,2002,150
285644034,285642000,285652929,10929,2003,150
285659091,285657058,285666699,9641,2004,150
285672556,285670739,285679693,8954,2005,150
285685767,285683733,285692425,8692,2006,150
285698283,285696466,285706455,9989,2007,150
285712530,285710495,285720454,9959,2008,150
285726529,285724494,285735424,10930,2009,150
285741588,285739553,285748246,8693,2010,150
285754321,285752286,285762583,10297,2011,150
285768746,285766712,285776037,9325,2012,150
285782111,285780077,285789402,9325,2013,150
285795476,285793442,285802449,9007,2014,150
285808523,285806489,285817101,10612,2015,150
285823047,285821230,285831188,9958,2016,150
285837262,285835228,285843920,8692,2017,150
285849994,285847960,285857602,9642,2018,150
285863460,285861642,285870914,9272,2019,150
285876990,285874955,285885567,10612,2020,150
285891513,285889696,285899338,9642,2021,150
285905195,285903378,285912703,9325,2022,150
285918561,285916743,285927671,10928,2023,150
285933833,285931800,285941757,9957,2024,150
285947832,285945798,285955756,9958,2025,150
285961831,285959797,285968806,9009,2026,150
285974663,285972846,285982488,9642,2027,150
285988562,285986528,285995220,8692,2028,150
286001078,285999260,286009219,9959,2029,150
286015294,286013260,286023556,10296,2030,150
286029720,286027685,286038299,10614,2031,150
286044245,286042428,286052069,9641,2032,150
286057926,286056109,286067038,10929,2033,150
286072984,286071167,286079859,8692,2034,150
286085934,286083900,286093225,9325,2035,150
286099084,286097266,286107219,9953,2036,150
286113077,286111260,286120901,9641,2037,150
286126975,286124941,286135236,10295,2038,150
286141399,286139365,286149324,9959,2039,150
286155181,286153364,286162371,9007,2040,150
286168447,286166412,286176709,10297,2041,150
286182871,286180838,286191449,10611,2042,150
286197612,286195579,286205874,10295,2043,150
286212036,286210003,286219327,9324,2044,150
286225401,286223367,286232059,8692,2045,150
286237917,286236100,286247029,10929,2046,150
286252975,286251158,286260344,9186,2047,150
286266418,286264384,286273709,9325,2048,150
286279782,286277749,286287073,9324,2049,150
286293147,286291113,286301409,10296,2050,150
286307355,286305539,286315496,9957,2051,150
286321571,286319537,286329833,10296,2052,150
286335996,286333962,286343920,9958,2053,150
286349779,286347961,286356368,8407,2054,150
286362226,286360408,286369047,8639,2055,150
286375122,286373088,286381780,8692,2056,150
286387855,286385821,286395779,9958,2057,150
286401854,286399820,286409777,9957,2058,150
286415852,286413818,286422510,8692,2059,150
286428367,286426550,286436507,9957,2060,150
286442364,286440547,286450450,9903,2061,150
286456307,286454490,286465049,10559,2062,150
286471212,286469178,286480107,10929,2063,150
286486270,286484236,286494531,10295,2064,150
286500694,286498660,286509273,10613,2065,150
286515436,286513402,286523360,9958,2066,150
286529218,286527400,286536093,8693,2067,150
286542168,286540134,286550092,9958,2068,150
286556167,286554133,286563458,9325,2069,150
286569316,286567499,286577795,10296,2070,150
286583740,286581924,286590477,8553,2071,150
286596336,286594518,286602925,8407,2072,150
286609000,286606966,286616291,9325,2073,150
286622366,286620332,286629341,9009,2074,150
286635199,286633382,286643940,10558,2075,150
286650104,286648070,286658999,10929,2076,150
286665162,286663128,286672137,9009,2077,150
286677995,286676178,286685851,9673,2078,150
286691710,286689892,286699248,9356,2079,150
286705323,286703289,286714218,10929,2080,150
286720382,286718348,286728960,10612,2081,150
286734906,286733089,286742730,9641,2082,150
286748804,286746770,286756728,9958,2083,150
286762585,286760768,286769775,9007,2084,150
286775632,286773815,286783456,9641,2085,150
286789530,286787496,286797792,10296,2086,150
286803738,286801921,286812850,10929,2087,150
286818797,286816979,286825671,8692,2088,150
286831745,286829711,286840007,10296,2089,150
286846170,286844136,286853461,9325,2090,150
286859535,286857501,286868113,10612,2091,150
286874276,286872242,286881884,9642,2092,150
286887958,286885924,286894616,8692,2093,150
286900473,286898656,286907061,8405,2094,150
286912919,286911101,286920741,9640,2095,150
286926599,286924781,286935078,10297,2096,150
286941024,286939207,286948215,9008,2097,150
286954289,286952255,286960946,8691,2098,150
286967020,286964986,286973995,9009,2099,150
286980070,286978036,286987361,9325,2100,150
286993435,286991401,287000092,8691,2101,150
287006166,287004132,287013774,9642,2102,150
287019849,287017815,287026506,8691,2103,150
287032580,287030546,287040503,9957,2104,150
287046361,287044543,287054871,10328,2105,150
287060817,287059000,287069115,10115,2106,150
287075278,287073244,287083857,10613,2107,150
287089804,287087986,287098102,10116,2108,150
287104049,287102231,287112527,10296,2109,150
287118473,287116656,287126614,9958,2110,150
287132688,287130654,287140296,9642,2111,150
287146154,287144336,287154326,9990,2112,150
287160400,287158366,287168324,9958,2113,150
287174399,287172365,287181057,8692,2114,150
287186914,287185097,287194738,9641,2115,150
287200595,287198778,287208998,10220,2116,150
287215161,287213127,287222452,9325,2117,150
287228310,287226492,287236450,9958,2118,150
287242525,287240491,287249816,9325,2119,150
287255673,287253856,287264468,10612,2120,150
287270631,287268597,287277921,9324,2121,150
287283779,287281962,287291550,9588,2122,150
287297409,287295590,287305813,10223,2123,150
287311759,287309942,287320238,10296,2124,150
287326184,287324367,287334663,10296,2125,150
287340826,287338792,287347800,9008,2126,150
287353658,287351840,287362060,10220,2127,150
287368223,287366189,287376800,10611,2128,150
287382962,287380929,287390570,9641,2129,150
287396644,287394610,287404906,10296,2130,150
287410852,287409035,287417589,8554,2131,150
287423447,287421629,287432188,10559,2132,150
287438134,287436317,287445641,9324,2133,150
287451499,287449682,287458373,8691,2134,150
287464230,287462413,287473056,10643,2135,150
287479002,287477185,287487321,10136,2136,150
287493485,287491451,287502064,10613,2137,150
287508226,287506193,287516805,10612,2138,150
287522967,287520934,287529942,9008,2139,150
287536016,287533982,287544594,10612,2140,150
287550541,287548723,287558543,9820,2141,150
287564617,287562583,287572878,10295,2142,150
287579041,287577007,287587936,10929,2143,150
287593882,287592065,287602023,9958,2144,150
287607881,287606064,287615335,9271,2145,150
287621193,287619375,287628384,9009,2146,150
287634457,287632424,287641748,9324,2147,150
287647605,287645788,287655746,9958,2148,150
287661821,287659787,287670715,10928,2149,150
287676878,287674844,287685457,10613,2150,150
287691619,287689586,287699227,9641,2151,150
287705085,287703268,287712624,9356,2152,150
287718481,287716664,287725302,8638,2153,150
287731376,287729343,287739954,10611,2154,150
287746117,287744083,287754695,10612,2155,150
287760858,287758824,287769436,10612,2156,150
287775600,287773565,287782258,8693,2157,150
287788116,287786299,287796595,10296,2158,150
287802759,287800724,287811654,10930,2159,150
287817600,287815783,287825424,9641,2160,150
287831499,287829465,287838790,9325,2161,150
287844864,287842830,287852787,9957,2162,150
287858862,287856827,287867757,10930,2163,150
287873920,287871886,287882498,10612,2164,150
287888661,287886627,287896923,10296,2165,150
287903086,287901052,287910694,9642,2166,150
287916551,287914734,287925029,10295,2167,150
287931192,287929158,287939770,10612,2168,150
287945716,287943899,287954373,10474,2169,150
287960536,287958502,287969115,10613,2170,150
287975277,287973244,287983854,10610,2171,150
287990017,287987983,287998912,10929,2172,150
288005076,288003042,288013653,10611,2173,150
288019816,288017782,288028077,10295,2174,150
288034240,288032206,288041214,9008,2175,150
288047071,288045254,288056129,10875,2176,150
288062292,288060258,288069899,9641,2177,150
288075973,288073939,288083897,9958,2178,150
288089971,288087937,288098549,10612,2179,150
288104495,288102678,288112319,9641,2180,150
288118393,288116359,288125366,9007,2181,150
288131440,288129406,288138415,9009,2182,150
288144273,288142455,288151811,9356,2183,150
288157668,288155851,288164541,8690,2184,150
288170397,288168581,288178590,10009,2185,150
288184537,288182719,288193647,10928,2186,150
288199810,288197776,288208705,10929,2187,150
288214651,288212834,288221842,9008,2188,150
288227699,288225882,288234891,9009,2189,150
288240749,288238932,288248256,9324,2190,150
288254114,288252297,288261336,9039,2191,150
288267193,288265376,288274330,8954,2192,150
288280404,288278370,288289299,10929,2193,150
288295461,288293428,288302752,9324,2194,150
288308827,288306793,288316434,9641,2195,150
288322509,288320475,288331404,10929,2196,150
288337350,288335533,288344224,8691,2197,150
288350081,288348264,288359192,10928,2198,150
288365354,288363320,288373616,10296,2199,150
288379779,288377745,288387703,9958,2200,150
288393777,288391743,288402038,10295,2201,150
288407983,288406166,288415173,9007,2202,150
288421030,288419213,288428569,9356,2203,150
288434642,288432609,288441299,8690,2204,150
288447373,288445339,288454348,9009,2205,150
288460206,288458388,288468378,9990,2206,150
288474234,288472418,288481139,8721,2207,150
288486996,288485179,288495791,10612,2208,150
288501738,288499920,288510533,10613,2209,150
288516479,288514662,288525452,10790,2210,150
288531615,288529581,288540193,10612,2211,150
288546356,288544322,288553329,9007,2212,150
288559187,288557369,288567697,10328,2213,150
288573643,288571826,288580380,8554,2214,150
288586238,288584420,288594009,9589,2215,150
288600084,288598049,288606741,8692,2216,150
288612815,288610781,288620106,9325,2217,150
288625963,288624146,288634473,10327,2218,150
288640636,288638602,288648243,9641,2219,150
288654317,288652283,288661291,9008,2220,150
288667149,288665331,288674371,9040,2221,150
288680228,288678411,288687416,9005,2222,150
288693490,288691456,288701098,9642,2223,150
288707172,288705138,288715095,9957,2224,150
288720953,288719135,288729378,10243,2225,150
288735541,288733507,288744436,10929,2226,150
288750599,288748565,288758523,9958,2227,150
288764380,288762563,288773122,10559,2228,150
288779284,288777251,288786891,9640,2229,150
288792964,288790931,288801858,10927,2230,150
288808022,288805987,288815946,9959,2231,150
288822020,288819986,288830915,10929,2232,150
288837077,288835044,288845971,10927,2233,150
288852133,288850099,288860711,10612,2234,150
288866657,288864840,288875314,10474,2235,150
288881478,288879443,288888136,8693,2236,150
288893993,288892176,288901180,9004,2237,150
288907254,288905220,288914228,9008,2238,150
288920086,288918268,288929196,10928,2239,150
288935360,288933325,288942018,8693,2240,150
288947874,288946058,288955697,9639,2241,150
288961772,288959737,288969062,9325,2242,150
288974918,288973102,288982688,9586,2243,150
288988545,288986728,288995420,8692,2244,150
289001278,288999460,289010390,10930,2245,150
289016336,289014519,289025310,10791,2246,150
289031472,289029438,289038446,9008,2247,150
289044520,289042486,289053098,10612,2248,150
289059261,289057227,289067522,10295,2249,150
289073686,289071651,289082580,10929,2250,150
289088743,289086709,289097637,10928,2251,150
289103799,289101766,289112376,10610,2252,150
289118539,289116505,289125830,9325,2253,150
289131688,289129870,289139459,9589,2254,150
289145317,289143499,289153455,9956,2255,150
289159312,289157495,289168138,10643,2256,150
289174083,289172267,289183194,10927,2257,150
289189140,289187323,289198114,10791,2258,150
289204277,289202243,289210935,8692,2259,150
289217009,289214975,289224617,9642,2260,150
289230474,289228657,289238645,9988,2261,150
289244719,289242685,289252326,9641,2262,150
289258400,289256366,289266978,10612,2263,150
289272924,289271107,289281719,10612,2264,150
289287882,289285848,289296142,10294,2265,150
289302305,289300271,289308963,8692,2266,150
289315037,289313003,289323615,10612,2267,150
289329778,289327744,289338673,10929,2268,150
289344836,289342802,289353414,10612,2269,150
289359577,289357543,289367838,10295,2270,150
289373784,289371967,289381925,9958,2271,150
289388000,289385966,289395607,9641,2272,150
289401464,289399647,289410259,10612,2273,150
289416422,289414388,289425317,10929,2274,150
289431480,289429446,289439088,9642,2275,150
289445162,289443128,289454056,10928,2276,150
289460219,289458185,289467826,9641,2277,150
289473683,289471866,289482794,10928,2278,150
289488740,289486923,289495476,8553,2279,150
289501333,289499516,289510444,10928,2280,150
289516391,289514573,289523898,9325,2281,150
289529755,289527938,289536945,9007,2282,150
289543019,289540985,289551913,10928,2283,150
289558075,289556042,289566337,10295,2284,150
289572500,289570466,289579791,9325,2285,150
289585649,289583831,289593790,9959,2286,150
289599647,289597830,289608126,10296,2287,150
289614072,289612255,289622390,10135,2288,150
289628553,289626519,289637130,10611,2289,150
289643292,289641259,289652187,10928,2290,150
289658133,289656316,289665957,9641,2291,150
289672031,289669997,289679004,9007,2292,150
289685078,289683044,289693339,10295,2293,150
289699285,289697468,289706792,9324,2294,150
289712650,289710832,289721444,10612,2295,150
289727607,289725573,289735215,9642,2296,150
289741290,289739255,289748265,9010,2297,150
289754123,289752306,289760942,8636,2298,150
289766799,289764982,289775277,10295,2299,150
289781223,289779406,289789702,10296,2300,150
289795865,289793831,289804759,10928,2301,150
289810922,289808888,289819499,10611,2302,150
289825662,289823628,289833922,10294,2303,150
289839868,289838051,289848009,9958,2304,150
289854082,289852049,289862006,9957,2305,150
289868080,289866046,289876342,10296,2306,150
289882288,289880471,289889024,8553,2307,150
289894881,289893064,289901700,8636,2308,150
289907775,289905741,289916354,10613,2309,150
289922300,289920483,289930124,9641,2310,150
289936198,289934164,289944776,10612,2311,150
289950722,289948905,289959378,10473,2312,150
289965540,289963507,289973802,10295,2313,150
289979965,289977931,289987256,9325,2314,150
289993113,289991296,290001254,9958,2315,150
290007328,290005294,290015251,9957,2316,150
290021108,290019291,290028615,9324,2317,150
290034472,290032655,290043267,10612,2318,150
290049430,290047396,290056721,9325,2319,150
290062579,290060761,290071374,10613,2320,150
290077537,290075503,290084827,9324,2321,150
290090685,290088867,290098773,9906,2322,150
290104847,290102813,290113108,10295,2323,150
290119054,290117237,290126878,9641,2324,150
290132736,290130918,290141562,10644,2325,150
290147508,290145691,290156481,10790,2326,150
290162428,290160610,290171402,10792,2327,150
290177565,290175531,290184539,9008,2328,150
290190397,290188580,290199509,10929,2329,150
290205672,290203638,290214567,10929,2330,150
290220514,290218696,290227389,8693,2331,150
290233246,290231429,290241017,9588,2332,150
290247091,290245057,290254699,9642,2333,150
290260773,290258739,290268381,9642,2334,150
290274455,290272421,290281112,8691,2335,150
290287186,290285152,290294477,9325,2336,150
290300552,290298517,290309131,10614,2337,150
290315294,290313260,290324189,10929,2338,150
290330352,290328318,290338930,10612,2339,150
290344877,290343059,290353672,10613,2340,150
290359619,290357801,290367939,10138,2341,150
290373885,290372068,290382026,9958,2342,150
290387884,290386066,290396996,10930,2343,150
290403159,290401125,290411737,10612,2344,150
290417683,290415866,290426478,10612,2345,150
290432641,290430607,290441219,10612,2346,150
290447164,290445348,290454038,8690,2347,150
290460112,290458078,290467403,9325,2348,150
290473476,290471443,290482371,10928,2349,150
290488317,290486500,290496003,9503,2350,150
290501860,290500043,290510654,10611,2351,150
290516817,290514783,290523792,9009,2352,150
290529649,290527832,290538444,10612,2353,150
290544607,290542573,290551898,9325,2354,150
290557756,290555938,290565211,9273,2355,150
290571286,290569252,290579231,9979,2356,150
290585306,290583272,290592596,9324,2357,150
290598455,290596637,290606859,10222,2358,150
290613022,290610989,290621916,10927,2359,150
290627863,290626045,290636658,10613,2360,150
290642603,290640787,290649656,8869,2361,150
290655730,290653696,290663654,9958,2362,150
290669729,290667694,290676387,8693,2363,150
290682462,290680428,290689437,9009,2364,150
290695295,290693477,290703119,9642,2365,150
290709193,290707159,290717771,10612,2366,150
290723935,290721900,290731859,9959,2367,150
290737717,290735900,290746512,10612,2368,150
290752675,290750641,290760283,9642,2369,150
290766142,290764324,290775200,10876,2370,150
290781364,290779329,290788972,9643,2371,150
290794829,290793012,290802020,9008,2372,150
290807878,290806061,290815386,9325,2373,150
290821460,290819427,290829722,10295,2374,150
290835668,290833851,290843354,9503,2375,150
290849212,290847395,290857690,10295,2376,150
290863637,290861819,290870351,8532,2377,150
290876424,290874391,290883082,8691,2378,150
290889157,290887123,290897418,10295,2379,150
290903581,290901547,290912159,10612,2380,150
290918323,290916288,290924981,8693,2381,150
290931056,290929022,290939635,10613,2382,150
290945798,290943764,290954693,10929,2383,150
290960855,290958822,290967513,8691,2384,150
290973588,290971553,290980879,9326,2385,150
290986953,290984919,290993927,9008,2386,150
291000001,290997967,291006658,8691,2387,150
291012514,291010698,291021255,10557,2388,150
291027201,291025384,291034392,9008,2389,150
291040249,291038432,291048020,9588,2390,150
291054095,291052061,291062990,10929,2391,150
291069153,291067119,291077731,10612,2392,150
291083894,291081860,291091817,9957,2393,150
291097893,291095858,291105500,9642,2394,150
291111358,291109540,291120470,10930,2395,150
291126416,291124599,291133606,9007,2396,150
291139680,291137646,291148575,10929,2397,150
291154521,291152704,291161257,8553,2398,150
291167116,291165298,291175911,10613,2399,150
291182073,291180040,291190335,10295,2400,150
291196498,291194464,291205393,10929,2401,150
291211557,291209522,291218531,9009,2402,150
291224388,291222571,291231580,9009,2403,150
291237654,291235620,291244944,9324,2404,150
291250801,291248984,291258308,9324,2405,150
291264165,291262348,291272306,9958,2406,150
291278381,291276346,291286642,10296,2407,150
291292805,291290771,291300096,9325,2408,150
291306170,291304136,291315064,10928,2409,150
291321228,291319193,291328518,9325,2410,150
291334593,291332558,291341251,8693,2411,150
291347108,291345291,291353983,8692,2412,150
291359839,291358023,291368010,9987,2413,150
291374085,291372050,291381375,9325,2414,150
291387232,291385415,291395003,9588,2415,150
291400862,291399044,291409372,10328,2416,150
291415536,291413501,291422193,8692,2417,150
291428050,291426233,291436138,9905,2418,150
291442212,291440178,291449503,9325,2419,150
291455577,291453543,291462235,8692,2420,150
291468309,291466275,291477203,10928,2421,150
291483148,291481332,291491289,9957,2422,150
291497146,291495329,291503966,8637,2423,150
291509823,291508006,291517592,9586,2424,150
291523449,291521633,291530323,8690,2425,150
291536397,291534363,291544004,9641,2426,150
291550078,291548044,291558340,10296,2427,150
291564504,291562469,291573399,10930,2428,150
291579562,291577528,291587486,9958,2429,150
291593344,291591527,291608563,17036,2430,150
291614510,291612693,291623610,10917,2431,150
291629773,291627739,291638668,10929,2432,150
291644830,291642797,291652438,9641,2433,150
291658295,291656478,291666150,9672,2434,150
291672007,291670190,291679830,9640,2435,150
291685687,291683870,291693828,9958,2436,150
291699902,291697868,291708481,10613,2437,150
291714644,291712610,291723539,10929,2438,150
291729485,291727668,291736993,9325,2439,150
291743069,291741034,291750044,9010,2440,150
291756119,291754084,291765014,10930,2441,150
291770960,291769143,291777834,8691,2442,150
291783908,291781874,291792486,10612,2443,150
291798649,291796615,291805622,9007,2444,150
291811478,291809662,291820219,10557,2445,150
291826164,291824348,291833039,8691,2446,150
291838898,291837080,291846406,9326,2447,150
291852263,291850446,291860742,10296,2448,150
291866905,291864871,291875167,10296,2449,150
291881330,291879296,291888620,9324,2450,150
291894694,291892660,291901985,9325,2451,150
291907842,291906025,291916319,10294,2452,150
291922265,291920448,291929001,8553,2453,150
291935076,291933041,291942683,9642,2454,150
291948541,291946723,291956712,9989,2455,150
291962570,291960753,291970394,9641,2456,150
291976470,291974435,291984078,9643,2457,150
291989935,291988118,291997443,9325,2458,150
292003517,292001483,292011124,9641,2459,150
292017198,292015164,292026093,10929,2460,150
292032039,292030222,292038775,8553,2461,150
292044851,292042816,292052775,9959,2462,150
292058850,292056815,292066141,9326,2463,150
292071998,292070181,292078587,8406,2464,150
292084445,292082628,292092924,10296,2465,150
292099087,292097053,292106694,9641,2466,150
292112551,292110734,292119742,9008,2467,150
292125599,292123782,292134710,10928,2468,150
292140873,292138839,292149768,10929,2469,150
292155932,292153897,292162590,8693,2470,150
292168664,292166630,292175321,8691,2471,150
292181395,292179361,292189318,9957,2472,150
292195392,292193358,292204287,10929,2473,150
292210233,292208416,292216969,8553,2474,150
292222826,292221009,292229415,8406,2475,150
292235490,292233456,292243415,9959,2476,150
292249273,292247456,292256147,8691,2477,150
292262222,292260188,292268880,8692,2478,150
292274737,292272920,292282560,9640,2479,150
292288634,292286600,292296558,9958,2480,150
292302632,292300599,292311211,10612,2481,150
292317374,292315340,292325952,10612,2482,150
292332115,292330081,292339089,9008,2483,150
292345164,292343130,292351822,8692,2484,150
292357896,292355863,292365504,9641,2485,150
292371361,292369544,292380156,10612,2486,150
292386102,292384285,292393610,9325,2487,150
292399684,292397650,292408579,10929,2488,150
292414742,292412708,292423637,10929,2489,150
292429584,292427766,292437091,9325,2490,150
292442948,292441131,292450140,9009,2491,150
292455998,292454181,292464139,9958,2492,150
292470213,292468179,292477819,9640,2493,150
292483893,292481859,292491501,9642,2494,150
292497575,292495541,292505181,9640,2495,150
292511038,292509221,292518862,9641,2496,150
292524720,292522902,292533515,10613,2497,150
292539678,292537644,292547940,10296,2498,150
292553886,292552069,292561552,9483,2499,150
292567626,292565592,292575549,9957,2500,150
292581623,292579589,292590201,10612,2501,150
292596363,292594330,292603021,8691,2502,150
292609096,292607062,292617358,10296,2503,150
292623521,292621487,292631445,9958,2504,150
292637303,292635486,292644758,9272,2505,150
292650617,292648799,292658789,9990,2506,150
292664863,292662829,292673124,10295,2507,150
292679287,292677253,292687866,10613,2508,150
292693811,292691995,292701636,9641,2509,150
292707493,292705676,292715634,9958,2510,150
292721492,292719675,292728367,8692,2511,150
292734442,292732408,292741100,8692,2512,150
292746958,292745141,292754148,9007,2513,150
292760005,292758188,292767513,9325,2514,150
292773589,292771554,292780879,9325,2515,150
292786953,292784919,292795532,10613,2516,150
292801696,292799662,292810273,10611,2517,150
292816436,292814402,292823410,9008,2518,150
292829484,292827450,292837745,10295,2519,150
292843691,292841874,292850882,9008,2520,150
292856956,292854922,292863613,8691,2521,150
292869688,292867654,292877294,9640,2522,150
292883369,292881334,292891631,10297,2523,150
292897794,292895760,292906688,10928,2524,150
292912850,292910817,292919825,9008,2525,150
292925899,292923865,292933823,9958,2526,150
292939896,292937863,292947820,9957,2527,150
292953895,292951861,292960553,8692,2528,150
292966411,292964594,292974890,10296,2529,150
292980836,292979019,292987711,8692,2530,150
292993569,292991751,293001077,9326,2531,150
293007151,293005117,293014125,9008,2532,150
293020200,293018165,293029094,10929,2533,150
293035257,293033223,293042865,9642,2534,150
293048723,293046905,293057464,10559,2535,150
293063627,293061593,293071889,10296,2536,150
293078052,293076018,293086630,10612,2537,150
293092576,293090759,293101371,10612,2538,150
293107318,293105501,293115797,10296,2539,150
293121743,293119926,293129567,9641,2540,150
293135642,293133608,293144537,10929,2541,150
293150700,293148666,293157358,8692,2542,150
293163216,293161398,293171356,9958,2543,150
293177214,293175396,293184033,8637,2544,150
293189890,293188073,293197113,9040,2545,150
293202972,293201154,293211376,10222,2546,150
293217322,293215506,293225146,9640,2547,150
293231003,293229186,293238195,9009,2548,150
293244053,293242236,293252795,10559,2549,150
293258958,293256925,293266882,9957,2550,150
293272957,293270923,293281852,10929,2551,150
293288015,293285981,293294988,9007,2552,150
293301062,293299028,293309324,10296,2553,150
293315486,293313453,293323094,9641,2554,150
293328951,293327134,293336459,9325,2555,150
293342316,293340499,293350170,9671,2556,150
293356245,293354211,293362903,8692,2557,150
293368978,293366944,293377557,10613,2558,150
293383503,293381686,293390239,8553,2559,150
293396096,293394279,293404268,9989,2560,150
293410126,293408309,293417001,8692,2561,150
293422860,293421042,293430631,9589,2562,150
293436489,293434672,293445546,10874,2563,150
293451494,293449676,293458685,9009,2564,150
293464543,293462726,293473284,10558,2565,150
293479448,293477414,293486105,8691,2566,150
293492181,293490146,293499788,9642,2567,150
293505863,293503829,293513154,9325,2568,150
293519012,293517195,293527807,10612,2569,150
293533971,293531937,293541579,9642,2570,150
293547438,293545620,293555579,9959,2571,150
293561654,293559620,293568629,9009,2572,150
293574488,293572670,293583599,10929,2573,150
293589545,293587729,293598657,10928,2574,150
293604605,293602787,293611953,9166,2575,150
293618028,293615994,293624685,8691,2576,150
293630759,293628726,293639020,10294,2577,150
293645183,293643150,293652790,9640,2578,150
293658649,293656831,293666187,9356,2579,150
293672262,293670228,293680840,10612,2580,150
293686787,293684970,293693522,8552,2581,150
293699597,293697562,293708492,10930,2582,150
293714655,293712622,293722579,9957,2583,150
293728654,293726620,293736578,9958,2584,150
293742436,293740619,293749574,8955,2585,150
293755649,293753615,293764228,10613,2586,150
293770392,293768358,293778316,9958,2587,150
293784391,293782357,293791682,9325,2588,150
293797540,293795723,293804994,9271,2589,150
293811069,293809035,293817727,8692,2590,150
293823585,293821768,293830405,8637,2591,150
293836480,293834446,293844088,9642,2592,150
293850163,293848129,293858425,10296,2593,150
293864588,293862554,293872194,9640,2594,150
293878053,293876235,293886190,9955,2595,150
293892049,293890231,293900190,9959,2596,150
293906048,293904231,293919833,15602,2597,150
293925997,293923963,293932972,9009,2598,150
293938830,293937013,293946369,9356,2599,150
293952227,293950410,293960737,10327,2600,150
293966684,293964867,293975479,10612,2601,150
293981642,293979609,293988932,9323,2602,150
293994790,293992973,294002615,9642,2603,150
294008690,294006656,294015981,9325,2604,150
294022056,294020022,294029664,9642,2605,150
294035522,294033705,294042397,8692,2606,150
294048254,294046438,294055391,8953,2607,150
294061466,294059432,294069390,9958,2608,150
294075248,294073431,294082123,8692,2609,150
294087981,294086164,294096385,10221,2610,150
294102332,294100515,294109839,9324,2611,150
294115913,294113880,294122887,9007,2612,150
294128745,294126928,294136200,9272,2613,150
294142274,294140241,294150851,10610,2614,150
294156798,294154981,294164780,9799,2615,150
294170854,294168821,294179115,10294,2616,150
294185278,294183244,294192253,9009,2617,150
294198327,294196294,294204985,8691,2618,150
294210844,294209026,294217719,8693,2619,150
294223578,294221760,294232057,10297,2620,150
294238221,294236187,294246798,10611,2621,150
294252962,294250928,294260570,9642,2622,150
294266645,294264611,294273935,9324,2623,150
294280011,294277976,294288906,10930,2624,150
294295070,294293036,294302678,9642,2625,150
294308753,294306719,294317648,10929,2626,150
294323595,294321778,294332073,10295,2627,150
294338020,294336203,294346159,9956,2628,150
294352018,294350200,294359525,9325,2629,150
294365384,294363566,294372923,9357,2630,150
294378998,294376964,294386288,9324,2631,150
294392363,294390329,294399971,9642,2632,150
294405830,294404013,294413653,9640,2633,150
294419729,294417694,294426387,8693,2634,150
294432245,294430428,294440719,10291,2635,150
294446882,294444848,294455777,10929,2636,150
294461941,294459907,294470836,10929,2637,150
294477000,294474966,294484924,9958,2638,150
294490783,294488965,294498554,9589,2639,150
294504412,294502595,294511920,9325,2640,150
294517778,294515961,294526573,10612,2641,150
294532520,294530703,294540502,9799,2642,150
294546361,294544543,294555473,10930,2643,150
294561636,294559603,294569898,10295,2644,150
294575845,294574028,294583509,9481,2645,150
294589368,294587550,294596559,9009,2646,150
294602634,294600600,294611213,10613,2647,150
294617160,294615343,294623875,8532,2648,150
294629732,294627916,294638527,10611,2649,150
294644692,294642657,294651350,8693,2650,150
294657426,294655391,294666004,10613,2651,150
294672168,294670134,294680092,9958,2652,150
294686168,294684133,294694429,10296,2653,150
294700592,294698558,294707883,9325,2654,150
294713957,294711924,294722851,10927,2655,150
294728798,294726981,294735989,9008,2656,150
294742064,294740030,294750959,10929,2657,150
294757122,294755088,294765046,9958,2658,150
294771121,294769087,294779383,10296,2659,150
294785545,294783512,294792203,8691,2660,150
294798062,294796244,294805254,9010,2661,150
294811328,294809295,294818302,9007,2662,150
294824377,294822343,294832955,10612,2663,150
294838902,294837085,294846092,9007,2664,150
294851950,294850133,294859774,9641,2665,150
294865632,294863815,294873085,9270,2666,150
294878944,294877127,294887738,10611,2667,150
294893685,294891868,294901510,9642,2668,150
294907585,294905551,294916164,10613,2669,150
294922328,294920294,294930906,10612,2670,150
294936852,294935035,294945508,10473,2671,150
294951455,294949637,294959119,9482,2672,150
294965192,294963159,294973454,10295,2673,150
294979401,294977583,294987066,9483,2674,150
294993141,294991107,294999798,8691,2675,150
295005657,295003839,295012476,8637,2676,150
295018335,295016517,295025156,8639,2677,150
295031014,295029197,295039522,10325,2678,150
295045469,295043652,295052977,9325,2679,150
295058834,295057017,295066921,9904,2680,150
295072778,295070961,295081835,10874,2681,150
295087781,295085964,295096753,10789,2682,150
295102917,295100883,295110841,9958,2683,150
295116699,295114882,295125493,10611,2684,150
295131656,295129622,295139580,9958,2685,150
295145438,295143621,295154549,10928,2686,150
295160712,295158678,295168003,9325,2687,150
295174077,295172043,295182338,10295,2688,150
295188285,295186468,295195476,9008,2689,150
295201334,295199517,295209475,9958,2690,150
295215550,295213516,295222525,9009,2691,150
295228383,295226565,295236524,9959,2692,150
295242383,295240565,295249922,9357,2693,150
295255996,295253962,295262970,9008,2694,150
295268829,295267011,295276336,9325,2695,150
295282195,295280377,295289333,8956,2696,150
295295408,295293374,295302066,8692,2697,150
295307924,295306107,295316397,10290,2698,150
295322561,295320527,295330485,9958,2699,150
295336560,295334526,295343218,8692,2700,150
295349077,295347259,295357871,10612,2701,150
295363818,295362001,295370692,8691,2702,150
295376551,295374733,295383741,9008,2703,150
295389816,295387782,295398711,10929,2704,150
295404659,295402841,295412641,9800,2705,150
295418716,295416682,295427610,10928,2706,150
295433557,295431740,295441855,10115,2707,150
295447803,295445985,295455311,9326,2708,150
295461386,295459352,295469646,10294,2709,150
295475811,295473776,295482785,9009,2710,150
295488859,295486826,295496150,9324,2711,150
295502009,295500191,295511121,10930,2712,150
295517284,295515250,295524574,9324,2713,150
295530649,295528615,295537939,9324,2714,150
295543798,295541980,295551019,9039,2715,150
295557094,295555060,295565355,10295,2716,150
295571520,295569485,295578493,9008,2717,150
295584568,295582534,295593463,10929,2718,150
295599626,295597592,295607550,9958,2719,150
295613409,295611591,295621549,9958,2720,150
295627407,295625590,295635811,10221,2721,150
295641975,295639941,295648633,8692,2722,150
295654708,295652674,295662315,9641,2723,150
295668173,295666356,295676029,9673,2724,150
295681888,295680070,295690397,10327,2725,150
295696560,295694526,295703851,9325,2726,150
295709709,295707892,295717533,9641,2727,150
295723608,295721574,295731870,10296,2728,150
295738032,295735999,295745640,9641,2729,150
295751498,295749681,295760293,10612,2730,150
295766240,295764423,295773906,9483,2731,150
295779764,295777947,295787272,9325,2732,150
295793131,295791313,295800638,9325,2733,150
295806712,295804679,295814003,9324,2734,150
295820079,295818044,295828658,10614,2735,150
295834821,295832787,295842429,9642,2736,150
295848287,295846470,295855794,9324,2737,150
295861870,295859835,295869477,9642,2738,150
295875552,295873518,295883813,10295,2739,150
295889760,295887943,295898394,10451,2740,150
295904342,295902524,295913137,10613,2741,150
295919084,295917267,295928195,10928,2742,150
295934359,295932325,295941016,8691,2743,150
295946873,295945057,295955013,9956,2744,150
295961089,295959054,295968064,9010,2745,150
295973922,295972105,295981746,9641,2746,150
295987821,295985787,295995429,9642,2747,150
296001504,295999470,296010081,10611,2748,150
296016026,296014210,296023850,9640,2749,150
296029708,296027891,296038185,10294,2750,150
296044131,296042315,296051182,8867,2751,150
296057256,296055223,296064863,9640,2752,150
296070938,296068904,296077595,8691,2753,150
296083669,296081636,296091931,10295,2754,150
296098095,296096061,296105385,9324,2755,150
296111243,296109426,296119753,10327,2756,150
296125916,296123883,296134494,10611,2757,150
296140442,296138624,296147791,9167,2758,150
296153649,296151832,296161187,9355,2759,150
296167262,296165228,296174870,9642,2760,150
296180945,296178911,296188552,9641,2761,150
296194410,296192593,296203205,10612,2762,150
296209152,296207334,296216185,8851,2763,150
296222043,296220226,296229497,9271,2764,150
296235355,296233538,296244150,10612,2765,150
296250096,296248279,296257149,8870,2766,150
296263224,296261190,296271148,9958,2767,150
296277223,296275189,296285484,10295,2768,150
296291647,296289613,296299571,9958,2769,150
296305430,296303612,296314225,10613,2770,150
296320389,296318355,296327047,8692,2771,150
296332905,296331088,296341077,9989,2772,150
296347152,296345118,296356046,10928,2773,150
296361994,296360176,296368868,8692,2774,150
296374726,296372909,296382549,9640,2775,150
296388406,296386590,296396884,10294,2776,150
296402830,296401013,296409704,8691,2777,150
296415562,296413745,296423648,9903,2778,150
296429506,296427689,296437330,9641,2779,150
296443187,296441371,296450378,9007,2780,150
296456236,296454419,296464640,10221,2781,150
296470587,296468770,296479381,10611,2782,150
296485327,296483510,296493983,10473,2783,150
296499931,296498113,296508072,9959,2784,150
296513930,296512113,296521152,9039,2785,150
296527010,296525193,296535097,9904,2786,150
296541172,296539138,296550066,10928,2787,150
296556013,296554196,296564807,10611,2788,150
296570753,296568936,296579865,10929,2789,150
296586029,296583995,296593320,9325,2790,150
296599395,296597361,296606369,9008,2791,150
296612444,296610410,296620705,10295,2792,150
296626869,296624835,296633844,9009,2793,150
296639702,296637885,296646893,9008,2794,150
296652752,296650934,296661547,10613,2795,150
296667712,296665677,296675002,9325,2796,150
296681077,296679043,296687735,8692,2797,150
296693810,296691776,296701734,9958,2798,150
296707809,296705775,296715416,9641,2799,150
296721275,296719457,296728411,8954,2800,150
296734486,296732452,296742410,9958,2801,150
296748485,296746451,296755142,8691,2802,150
296761217,296759183,296769478,10295,2803,150
296775642,296773608,296783250,9642,2804,150
296789325,296787291,296797249,9958,2805,150
296803106,296801290,296811847,10557,2806,150
296818010,296815976,296826588,10612,2807,150
296832753,296830718,296841330,10612,2808,150
296847494,296845460,296856071,10611,2809,150
296862235,296860201,296870497,10296,2810,150
296876444,296874627,296883476,8849,2811,150
296889552,296887517,296897476,9959,2812,150
296903551,296901517,296911812,10295,2813,150
296917977,296915942,296924635,8693,2814,150
296930494,296928676,296937083,8407,2815,150
296943158,296941124,296950133,9009,2816,150
296955991,296954174,296964470,10296,2817,150
296970634,296968600,296977291,8691,2818,150
296983147,296981331,296990337,9006,2819,150
296996411,296994377,297004019,9642,2820,150
297010093,297008059,297016751,8692,2821,150
297022826,297020792,297030434,9642,2822,150
297036509,297034475,297045086,10611,2823,150
297051249,297049215,297058540,9325,2824,150
297064397,297062581,297073507,10926,2825,150
297079454,297077637,297086644,9007,2826,150
297092719,297090685,297100642,9957,2827,150
297106717,297104682,297114008,9326,2828,150
297120083,297118049,297128978,10929,2829,150
297134925,297133108,297141800,8692,2830,150
297147658,297145841,297154532,8691,2831,150
297160607,297158573,297169185,10612,2832,150
297175348,297173314,297183271,9957,2833,150
297189346,297187312,297196003,8691,2834,150
297202078,297200044,297210340,10296,2835,150
297216287,297214470,297223162,8692,2836,150
297229020,297227203,297237161,9958,2837,150
297243019,297241201,297250526,9325,2838,150
297256385,297254567,297265180,10613,2839,150
297271344,297269310,297278002,8692,2840,150
297284076,297282043,297291051,9008,2841,150
297296910,297295092,297304733,9641,2842,150
297310592,297308774,297318416,9642,2843,150
297324491,297322457,297333069,10612,2844,150
297339016,297337199,297346839,9640,2845,150
297352914,297350880,297361175,10295,2846,150
297367121,297365304,297374469,9165,2847,150
297380328,297378510,297389439,10929,2848,150
297395385,297393568,297403209,9641,2849,150
297409067,297407250,297416575,9325,2850,150
297422433,297420616,297430520,9904,2851,150
297436379,297434561,297444857,10296,2852,150
297451019,297448986,297458943,9957,2853,150
297464801,297462984,297472973,9989,2854,150
297478832,297477014,297486655,9641,2855,150
297492514,297490696,297500991,10295,2856,150
297507155,297505121,297516050,10929,2857,150
297521996,297520180,297530474,10294,2858,150
297536638,297534604,297543612,9008,2859,150
297549686,297547653,297558581,10928,2860,150
297564745,297562710,297573324,10614,2861,150
297579270,297577454,297586777,9323,2862,150
297592852,297590818,297601746,10928,2863,150
297607910,297605876,297616171,10295,2864,150
297622117,297620300,297629941,9641,2865,150
297635800,297633982,297643972,9990,2866,150
297649830,297648013,297657971,9958,2867,150
297664045,297662011,297670703,8692,2868,150
297676778,297674744,297685673,10929,2869,150
297691619,297689803,297699601,9798,2870,150
297705460,297703642,297712335,8693,2871,150
297718411,297716376,297726018,9642,2872,150
297732093,297730059,297740671,10612,2873,150
297746618,297744801,297755254,10453,2874,150
297761418,297759384,297768709,9325,2875,150
297774568,297772750,297783679,10929,2876,150
297789843,297787809,297796501,8692,2877,150
297802576,297800542,297810837,10295,2878,150
297816785,297814967,297824926,9959,2879,150
297831001,297828967,297838292,9325,2880,150
297844150,297842333,297851372,9039,2881,150
297857229,297855413,297864998,9585,2882,150
297870857,297869039,297878682,9643,2883,150
297884757,297882723,297891415,8692,2884,150
297897273,297895456,297904464,9008,2885,150
297910539,297908505,297918801,10296,2886,150
297924965,297922931,297931940,9009,2887,150
297937799,297935981,297944620,8639,2888,150
297950695,297948661,297957352,8691,2889,150
297963427,297961393,297971351,9958,2890,150
297977209,297975392,297985613,10221,2891,150
297991777,297989743,297999068,9325,2892,150
298005143,298003109,298013405,10296,2893,150
298019569,298017535,298027831,10296,2894,150
298033994,298031961,298041918,9957,2895,150
298047777,298045959,298056572,10613,2896,150
298062735,298060701,298070025,9324,2897,150
298075883,298074066,298084287,10221,2898,150
298090451,298088417,298098059,9642,2899,150
298103917,298102100,298112321,10221,2900,150
298118484,298116451,298126408,9957,2901,150
298132266,298130449,298140352,9903,2902,150
298146210,298144393,298154719,10326,2903,150
298160883,298158849,298169144,10295,2904,150
298175308,298173274,298182915,9641,2905,150
298188774,298186956,298196629,9673,2906,150
298202487,298200670,298209677,9007,2907,150
298215752,298213718,298222409,8691,2908,150
298228484,298226450,298236745,10295,2909,150
298242908,298240875,298249565,8690,2910,150
298255423,298253606,298264249,10643,2911,150
298270413,298268379,298278337,9958,2912,150
298284412,298282378,298291386,9008,2913,150
298297461,298295427,298304435,9008,2914,150
298310294,298308476,298318435,9959,2915,150
298324510,298322476,298332117,9641,2916,150
298338192,298336158,298345800,9642,2917,150
298351658,298349841,298358849,9008,2918,150
298364924,298362890,298371899,9009,2919,150
298377757,298375940,298386235,10295,2920,150
298392399,298390365,298399373,9008,2921,150
298405448,298403414,298412104,8690,2922,150
298417963,298416145,298425184,9039,2923,150
298431042,298429225,298438864,9639,2924,150
298444723,298442905,298452861,9956,2925,150
298458719,298456902,298467227,10325,2926,150
298473174,298471357,298480681,9324,2927,150
298486756,298484722,298495334,10612,2928,150
298501497,298499464,298508471,9007,2929,150
298514547,298512512,298522809,10297,2930,150
298528973,298526939,298535947,9008,2931,150
298542021,298539988,298550282,10294,2932,150
298556229,298554412,298563420,9008,2933,150
298569495,298567461,298578074,10613,2934,150
298584020,298582203,298592994,10791,2935,150
298599158,298597124,298608053,10929,2936,150
298614219,298612183,298621826,9643,2937,150
298627684,298625867,298636162,10295,2938,150
298642326,298640292,298649932,9640,2939,150
298656007,298653973,298662982,9009,2940,150
298669057,298667023,298676032,9009,2941,150
298681890,298680073,298690293,10220,2942,150
298696457,298694423,298704381,9958,2943,150
298710239,298708422,298719351,10929,2944,150
298725299,298723481,298732964,9483,2945,150
298739039,298737005,298746647,9642,2946,150
298752722,298750688,298761301,10613,2947,150
298767248,298765431,298775229,9798,2948,150
298781088,298779270,298788913,9643,2949,150
298794772,298792954,298802280,9326,2950,150
298808355,298806321,298816617,10296,2951,150
298822780,298820747,298830071,9324,2952,150
298835930,298834112,298842519,8407,2953,150
298848594,298846560,298857489,10929,2954,150
298863436,298861619,298870785,9166,2955,150
298876643,298874826,298884151,9325,2956,150
298890226,298888192,298897199,9007,2957,150
298903057,298901240,298910194,8954,2958,150
298916269,298914235,298925164,10929,2959,150
298931111,298929294,298938480,9186,2960,150
298944338,298942521,298951559,9038,2961,150
298957417,298955600,298965237,9637,2962,150
298971095,298969278,298978603,9325,2963,150
298984678,298982644,298993573,10929,2964,150
298999737,298997703,299007661,9958,2965,150
299013520,299011702,299020974,9272,2966,150
299027049,299025015,299034974,9959,2967,150
299040831,299039015,299049943,10928,2968,150
299056107,299054073,299064031,9958,2969,150
299070107,299068072,299077715,9643,2970,150
299083573,299081756,299092685,10929,2971,150
299098631,299096814,299107425,10611,2972,150
299113589,299111555,299121851,10296,2973,150
299128013,299125980,299135936,9956,2974,150
299141795,299139977,299150852,10875,2975,150
299157017,299154982,299165912,10930,2976,150
299172076,299170042,299180654,10612,2977,150
299186818,299184784,299193476,8692,2978,150
299199334,299197517,299206208,8691,2979,150
299212066,299210249,299220153,9904,2980,150
299226229,299224194,299233204,9010,2981,150
299239063,299237245,299248121,10876,2982,150
299254286,299252250,299260944,8694,2983,150
299267019,299264985,299275281,10296,2984,150
299281227,299279410,299288101,8691,2985,150
299293960,299292142,299301468,9326,2986,150
299307544,299305509,299316122,10613,2987,150
299322069,299320251,299330210,9959,2988,150
299336285,299334251,299344209,9958,2989,150
299350284,299348250,299358545,10295,2990,150
299364710,299362675,299372634,9959,2991,150
299378492,299376675,299387287,10612,2992,150
299393451,299391417,299402345,10928,2993,150
299408292,299406475,299416116,9641,2994,150
299421975,299420157,299429166,9009,2995,150
299435024,299433207,299444136,10929,2996,150
299450300,299448266,299458562,10296,2997,150
299464509,299462692,299473620,10928,2998,150
299479784,299477750,299488679,10929,2999,150
299494625,299492809,299503282,10473,3000,150
299509446,299507412,299517054,9642,3001,150
299522913,299521095,299529502,8407,3002,150
299535577,299533543,299544155,10612,3003,150
299550317,299548284,299558241,9957,3004,150
299564100,299562282,299572895,10613,3005,150
299579060,299577025,299587954,10929,3006,150
299594118,299592083,299603013,10930,3007,150
299608960,299607142,299617932,10790,3008,150
299623878,299622061,299632673,10612,3009,150
299638838,299636803,299647100,10297,3010,150
299653265,299651230,299659923,8693,3011,150
299665998,299663964,299674577,10613,3012,150
299680741,299678707,299689319,10612,3013,150
299695266,299693449,299704061,10612,3014,150
299710226,299708191,299717834,9643,3015,150
299723692,299721875,299731833,9958,3016,150
299737691,299735874,299746094,10220,3017,150
299752041,299750224,299758915,8691,3018,150
299764990,299762956,299772597,9641,3019,150
299778455,299776638,299786934,10296,3020,150
299793098,299791064,299800704,9640,3021,150
299806779,299804745,299815041,10296,3022,150
299821205,299819171,299830100,10929,3023,150
299836263,299834230,299844207,9977,3024,150
299850282,299848248,299859176,10928,3025,150
299865124,299863306,299873105,9799,3026,150
299879181,299877146,299886154,9008,3027,150
299892229,299890195,299900152,9957,3028,150
299906227,299904193,299914488,10295,3029,150
299920651,299918617,299928574,9957,3030,150
299934649,299932615,299942257,9642,3031,150
299948331,299946298,299956255,9957,3032,150
299962331,299960296,299969938,9642,3033,150
299975797,299973979,299982386,8407,3034,150
299988461,299986427,299997040,10613,3035,150
300003204,300001170,300009861,8691,3036,150
300015936,300013902,300022910,9008,3037,150
300028985,300026951,300037246,10295,3038,150
300043193,300041375,300051491,10116,3039,150
300057438,300055621,300065261,9640,3040,150
300071119,300069302,300079861,10559,3041,150
300086026,300083991,300094288,10297,3042,150
300100235,300098418,300107583,9165,3043,150
300113658,300111624,300120632,9008,3044,150
300126490,300124673,300135548,10875,3045,150
300141713,300139678,300148687,9009,3046,150
300154761,300152728,300162369,9641,3047,150
300168444,300166410,300175102,8692,3048,150
300180960,300179143,300188815,9672,3049,150
300194891,300192856,300202182,9326,3050,150
300208041,300206223,300216233,10010,3051,150
300222397,300220363,300230321,9958,3052,150
300236396,300234362,300244320,9958,3053,150
300250179,300248361,300257370,9009,3054,150
300263445,300261411,300270736,9325,3055,150
300276812,300274777,300285074,10297,3056,150
300291238,300289204,300299500,10296,3057,150
300305663,300303630,300314558,10928,3058,150
300320722,300318688,300328646,9958,3059,150
300334504,300332687,300342644,9957,3060,150
300348719,300346685,300357298,10613,3061,150
300363245,300361428,300370436,9008,3062,150
300376511,300374477,300383485,9008,3063,150
300389343,300387526,300397198,9672,3064,150
300403273,300401239,300410881,9642,3065,150
300416956,300414922,300423614,8692,3066,150
300429688,300427655,300436345,8690,3067,150
300442203,300440386,300449024,8638,3068,150
300455099,300453065,300462390,9325,3069,150
300468250,300466432,300475789,9357,3070,150
300481865,300479830,300490443,10613,3071,150
300496607,300494573,300503264,8691,3072,150
300509122,300507305,300516891,9586,3073,150
300522965,300520932,300530889,9957,3074,150
300536747,300534930,300545542,10612,3075,150
300551705,300549672,300558363,8691,3076,150
300564439,300562404,300571729,9325,3077,150
300577587,300575770,300585095,9325,3078,150
300591170,300589136,300599094,9958,3079,150
300604952,300603135,300612459,9324,3080,150
300618317,300616500,300626141,9641,3081,150
300632216,300630182,300640140,9958,3082,150
300646217,300644182,300654142,9960,3083,150
300660000,300658183,300668794,10611,3084,150
300674958,300672924,300681616,8692,3085,150
300687691,300685657,300694666,9009,3086,150
300700742,300698707,300708033,9326,3087,150
300714109,300712074,300720767,8693,3088,150
300726843,300724808,300734133,9325,3089,150
300739992,300738174,300748163,9989,3090,150
300754238,300752204,300761846,9642,3091,150
300767920,300765887,300775211,9324,3092,150
300781069,300779252,300789210,9958,3093,150
300795285,300793251,300802576,9325,3094,150
300808435,300806617,300817546,10929,3095,150
300823709,300821675,300832603,10928,3096,150
300838767,300836733,300846058,9325,3097,150
300851917,300850099,300859772,9673,3098,150
300865630,300863813,300873454,9641,3099,150
300879529,300877495,300886504,9009,3100,150
300892579,300890545,300901474,10929,3101,150
300907637,300905604,300914928,9324,3102,150
300921003,300918969,300929581,10612,3103,150
300935745,300933711,300942720,9009,3104,150
300948578,300946761,300962681,15920,3105,150
300968702,300966884,300975992,9108,3106,150
300981850,300980033,300990327,10294,3107,150
300996274,300994457,301004255,9798,3108,150
301010113,301008296,301016987,8691,3109,150
301023063,301021028,301030670,9642,3110,150
301036745,301034711,301044037,9326,3111,150
301049895,301048078,301059007,10929,3112,150
301064954,301063137,301073433,10296,3113,150
301079597,301077563,301086888,9325,3114,150
301092963,301090929,301100886,9957,3115,150
301106961,301104927,301113936,9009,3116,150
301119794,301117977,301126985,9008,3117,150
301132844,301131026,301141639,10613,3118,150
301147803,301145769,301154461,8692,3119,150
301160319,301158502,301168144,9642,3120,150
301174218,301172185,301182142,9957,3121,150
301188000,301186183,301196479,10296,3122,150
301202426,301200609,301209617,9008,3123,150
301215475,301213658,301223244,9586,3124,150
301229319,301227285,301237581,10296,3125,150
301243528,301241711,301252162,10451,3126,150
301258109,301256292,301266089,9797,3127,150
301272164,301270130,301279138,9008,3128,150
301285213,301283179,301293137,9958,3129,150
301298995,301297178,301307082,9904,3130,150
301312940,301311123,301321733,10610,3131,150
301327680,301325863,301335028,9165,3132,150
301341103,301339069,301349365,10296,3133,150
301355312,301353495,301362504,9009,3134,150
301368580,301366545,301375553,9008,3135,150
301381411,301379594,301388548,8954,3136,150
301394623,301392589,301402231,9642,3137,150
301408090,301406272,301416885,10613,3138,150
301423048,301421015,301429706,8691,3139,150
301435566,301433747,301444045,10298,3140,150
301450210,301448175,301458472,10297,3141,150
301464420,301462602,301472899,10297,3142,150
301478846,301477029,301485720,8691,3143,150
301491578,301489761,301498769,9008,3144,150
301504627,301502810,301513739,10929,3145,150
301519902,301517869,301528797,10928,3146,150
301534744,301532927,301543718,10791,3147,150
301549882,301547848,301556856,9008,3148,150
301562931,301560897,301569906,9009,3149,150
301575765,301573947,301584591,10644,3150,150
301590537,301588720,301605524,16804,3151,150
301611688,301609654,301619296,9642,3152,150
301625371,301623337,301632661,9324,3153,150
301638736,301636702,301646998,10296,3154,150
301652946,301651128,301661423,10295,3155,150
301667587,301665553,301675195,9642,3156,150
301681053,301679236,301689457,10221,3157,150
301695621,301693587,301703229,9642,3158,150
301709087,301707270,301716912,9642,3159,150
301722769,301720953,301731247,10294,3160,150
301737411,301735377,301745673,10296,3161,150
301751621,301749803,301758812,9009,3162,150
301764670,301762853,301773779,10926,3163,150
301779725,301777908,301787232,9324,3164,150
301793307,301791273,301799965,8692,3165,150
301806041,301804006,301814935,10929,3166,150
301820881,301819065,301829993,10928,3167,150
301836157,301834123,301843765,9642,3168,150
301849622,301847806,301856493,8687,3169,150
301862568,301860534,301870492,9958,3170,150
301876349,301874533,301884752,10219,3171,150
301890699,301888882,301897573,8691,3172,150
301903431,301901614,301910970,9356,3173,150
301916827,301915011,301923964,8953,3174,150
301930039,301928005,301937963,9958,3175,150
301944037,301942004,301951012,9008,3176,150
301957087,301955053,301964694,9641,3177,150
301970552,301968735,301978375,9640,3178,150
301984233,301982416,301992374,9958,3179,150
301998449,301996415,302007344,10929,3180,150
302013508,302011474,302020166,8692,3181,150
302026241,302024207,302034819,10612,3182,150
302040983,302038949,302048589,9640,3183,150
302054665,302052630,302062927,10297,3184,150
302069092,302067057,302076700,9643,3185,150
302082560,302080742,302090098,9356,3186,150
302095957,302094139,302103179,9040,3187,150
302109037,302107220,302117831,10611,3188,150
302123995,302121961,302132573,10612,3189,150
302138736,302136702,302146660,9958,3190,150
302152519,302150701,302160343,9642,3191,150
302166202,302164384,302173075,8691,3192,150
302178934,302177116,302187675,10559,3193,150
302193622,302191805,302200812,9007,3194,150
302206670,302204853,302213861,9008,3195,150
302219936,302217902,302226594,8692,3196,150
302232669,302230635,302239643,9008,3197,150
302245502,302243684,302254297,10613,3198,150
302260462,302258427,302269357,10930,3199,150
302275304,302273487,302284255,10768,3200,150
302290419,302288385,302299313,10928,3201,150
302305477,302303443,302314371,10928,3202,150
302320318,302318501,302329113,10612,3203,150
302335277,302333243,302342252,9009,3204,150
302348326,302346293,302355300,9007,3205,150
302361158,302359341,302369299,9958,3206,150
302375157,302373340,302382348,9008,3207,150
302388207,302386389,302395715,9326,3208,150
302401790,302399756,302409398,9642,3209,150
302415257,302413439,302423397,9958,3210,150
302429254,302427438,302436445,9007,3211,150
302442520,302440486,302450782,10296,3212,150
302456946,302454912,302464553,9641,3213,150
302470411,302468594,302478548,9954,3214,150
302484624,302482589,302491281,8692,3215,150
302497356,302495322,302504646,9324,3216,150
302510721,302508687,302518012,9325,3217,150
302523871,302522053,302531959,9906,3218,150
302538034,302536000,302545325,9325,3219,150
302551183,302549366,302559662,10296,3220,150
302565609,302563792,302573117,9325,3221,150
302578976,302577158,302588086,10928,3222,150
302594250,302592216,302602511,10295,3223,150
302608458,302606641,302616283,9642,3224,150
302622142,302620324,302629649,9325,3225,150
302635724,302633690,302644619,10929,3226,150
302650566,302648749,302659678,10929,3227,150
302665626,302663808,302673766,9958,3228,150
302679625,302677807,302688101,10294,3229,150
302694266,302692231,302700923,8692,3230,150
302706782,302704964,302714005,9041,3231,150
302720080,302718046,302726738,8692,3232,150
302732597,302730779,302740738,9959,3233,150
302746596,302744779,302754104,9325,3234,150
302759962,302758145,302767470,9325,3235,150
302773545,302771511,302781153,9642,3236,150
302787011,302785194,302794519,9325,3237,150
302800377,302798560,302807196,8636,3238,150
302813053,302811237,302821194,9957,3239,150
302827052,302825235,302834243,9008,3240,150
302840319,302838284,302848243,9959,3241,150
302854318,302852284,302861292,9008,3242,150
302867150,302865333,302874603,9270,3243,150
302880461,302878644,302887599,8955,3244,150
302893676,302891641,302901284,9643,3245,150
302907142,302905325,302914681,9356,3246,150
302920539,302918722,302929017,10295,3247,150
302934964,302933147,302944076,10929,3248,150
302950024,302948206,302956899,8693,3249,150
302962757,302960940,302970295,9355,3250,150
302976153,302974336,302983661,9325,3251,150
302989737,302987702,302997344,9642,3252,150
303003420,303001386,303011027,9641,3253,150
303017101,303015068,303023759,8691,3254,150
303029617,303027800,303036492,8692,3255,150
303042567,303040533,303050828,10295,3256,150
303056991,303054958,303065886,10928,3257,150
303071833,303070016,303078548,8532,3258,150
303084407,303082589,303093148,10559,3259,150
303099312,303097278,303106602,9324,3260,150
303112460,303110643,303119597,8954,3261,150
303125672,303123638,303133595,9957,3262,150
303139671,303137636,303146646,9010,3263,150
303152505,303150687,303160275,9588,3264,150
303166134,303164316,303174275,9959,3265,150
303180350,303178316,303187641,9325,3266,150
303193500,303191682,303200954,9272,3267,150
303206813,303204995,303214637,9642,3268,150
303220712,303218678,303228320,9642,3269,150
303234179,303232361,303242921,10560,3270,150
303249084,303247050,303257007,9957,3271,150
303263082,303261048,303270373,9325,3272,150
303276448,303274414,303283423,9009,3273,150
303289281,303287464,303297369,9905,3274,150
303303444,303301410,303311706,10296,3275,150
303317870,303315836,303325161,9325,3276,150
303331236,303329202,303337894,8692,3277,150
303343969,303341935,303351577,9642,3278,150
303357651,303355618,303365912,10294,3279,150
303372075,303370042,303378733,8691,3280,150
303384591,303382774,303391411,8637,3281,150
303397485,303395452,303404460,9008,3282,150
303410319,303408501,303418406,9905,3283,150
303424481,303422447,303432743,10296,3284,150
303438907,303436873,303447486,10613,3285,150
303453434,303451616,303462546,10930,3286,150
303468709,303466676,303475683,9007,3287,150
303481542,303479724,303490599,10875,3288,150
303496762,303494729,303504686,9957,3289,150
303510544,303508727,303517419,8692,3290,150
303523494,303521460,303530469,9009,3291,150
303536544,303534510,303545123,10613,3292,150
303551287,303549253,303558577,9324,3293,150
303564652,303562618,303573547,10929,3294,150
303579711,303577677,303586368,8691,3295,150
303592443,303590409,303599418,9009,3296,150
303605493,303603459,303613101,9642,3297,150
303619175,303617142,303627436,10294,3298,150
303633600,303631566,303640890,9324,3299,150
303646749,303644931,303655860,10929,3300,150
303661809,303659990,303670921,10931,3301,150
303677085,303675051,303685347,10296,3302,150
303691294,303689477,303698959,9482,3303,150
303705034,303703000,303713296,10296,3304,150
303719460,303717426,303726117,8691,3305,150
303731976,303730158,303739113,8955,3306,150
303744972,303743154,303753713,10559,3307,150
303759660,303757843,303768772,10929,3308,150
303774936,303772902,303783830,10928,3309,150
303789777,303787960,303797918,9958,3310,150
303803776,303801959,303810651,8692,3311,150
303816509,303814692,303823646,8954,3312,150
303829504,303827687,303837983,10296,3313,150
303844147,303842113,303850805,8692,3314,150
303856880,303854846,303863854,9008,3315,150
303869712,303867895,303876300,8405,3316,150
303882158,303880341,303891270,10929,3317,150
303897434,303895400,303905359,9959,3318,150
303911434,303909400,303918725,9325,3319,150
303924799,303922766,303932406,9640,3320,150
303938481,303936447,303945772,9325,3321,150
303951630,303949813,303958505,8692,3322,150
303964581,303962546,303971555,9009,3323,150
303977629,303975596,303985891,10295,3324,150
303991839,303990021,303999031,9010,3325,150
304005106,304003072,304012397,9325,3326,150
304018255,304016438,304027365,10927,3327,150
304033529,304031495,304041791,10296,3328,150
304047739,304045921,304054930,9009,3329,150
304061005,304058971,304069266,10295,3330,150
304075214,304073396,304083851,10455,3331,150
304089798,304087981,304096514,8533,3332,150
304102372,304100555,304111483,10928,3333,150
304117647,304115613,304125909,10296,3334,150
304131856,304130039,304139362,9323,3335,150
304145220,304143403,304154046,10643,3336,150
304160210,304158175,304166867,8692,3337,150
304172943,304170908,304181522,10614,3338,150
304187469,304185651,304196581,10930,3339,150
304202745,304200710,304209719,9009,3340,150
304215794,304213760,304224371,10611,3341,150
304230534,304228500,304238795,10295,3342,150
304244959,304242925,304253537,10612,3343,150
304259701,304257667,304267625,9958,3344,150
304273701,304271666,304281625,9959,3345,150
304287700,304285666,304294674,9008,3346,150
304300533,304298715,304307987,9272,3347,150
304314062,304312028,304321985,9957,3348,150
304327843,304326026,304334717,8691,3349,150
304340792,304338758,304348400,9642,3350,150
304354258,304352441,304362399,9958,3351,150
304368475,304366440,304377053,10613,3352,150
304383217,304381183,304391479,10296,3353,150
304397644,304395609,304405906,10297,3354,150
304411854,304410036,304418728,8692,3355,150
304424803,304422769,304431461,8692,3356,150
304437320,304435502,304445145,9643,3357,150
304451220,304449186,304459798,10612,3358,150
304465745,304463928,304473432,9504,3359,150
304479291,304477473,304487060,9587,3360,150
304492918,304491101,304499792,8691,3361,150
304505867,304503833,304512525,8692,3362,150
304518384,304516566,304525258,8692,3363,150
304531116,304529299,304539910,10611,3364,150
304546074,304544040,304554969,10929,3365,150
304560915,304559099,304569393,10294,3366,150
304575556,304573523,304583164,9641,3367,150
304589240,304587205,304595897,8692,3368,150
304601755,304599938,304610550,10612,3369,150
304616498,304614680,304623213,8533,3370,150
304629289,304627254,304635947,8693,3371,150
304642022,304639988,304650283,10295,3372,150
304656230,304654413,304664054,9641,3373,150
304669913,304668095,304677738,9643,3374,150
304683813,304681779,304690471,8692,3375,150
304696546,304694512,304704152,9640,3376,150
304710010,304708193,304718751,10558,3377,150
304724699,304722881,304733650,10769,3378,150
304739597,304737780,304747421,9641,3379,150
304753496,304751462,304762389,10927,3380,150
304768335,304766518,304776159,9641,3381,150
304782018,304780200,304790159,9959,3382,150
304796233,304794200,304804157,9957,3383,150
304810231,304808198,304818155,9957,3384,150
304824230,304822196,304832492,10296,3385,150
304838655,304836621,304847550,10929,3386,150
304853713,304851680,304861637,9957,3387,150
304867711,304865678,304876606,10928,3388,150
304882552,304880735,304891030,10295,3389,150
304896977,304895159,304904958,9799,3390,150
304911033,304908999,304918641,9642,3391,150
304924499,304922682,304931690,9008,3392,150
304937766,304935731,304946027,10296,3393,150
304951973,304950156,304960946,10790,3394,150
304967110,304965076,304975688,10612,3395,150
304981636,304979818,304988667,8849,3396,150
304994742,304992708,305003320,10612,3397,150
305009267,305007450,305016459,9009,3398,150
305022317,305020500,305031059,10559,3399,150
305037223,305035189,305045147,9958,3400,150
305051222,305049188,305058513,9325,3401,150
305064589,305062554,305072513,9959,3402,150
305078589,305076554,305085247,8693,3403,150
305091105,305089288,305099582,10294,3404,150
305105746,305103712,305113353,9641,3405,150
305119428,305117394,305127689,10295,3406,150
305133636,305131819,305141302,9483,3407,150
305147377,305145343,305154668,9325,3408,150
305160743,305158709,305169322,10613,3409,150
305175486,305173452,305183411,9959,3410,150
305189269,305187452,305198064,10612,3411,150
305204228,305202194,305212489,10295,3412,150
305218436,305216619,305226915,10296,3413,150
305233079,305231045,305240053,9008,3414,150
305245912,305244094,305252787,8693,3415,150
305258645,305256828,305267386,10558,3416,150
305273549,305271515,305280839,9324,3417,150
305286697,305284880,305295492,10612,3418,150
305301656,305299622,305308946,9324,3419,150
305315021,305312987,305322312,9325,3420,150
305328171,305326353,305336650,10297,3421,150
305342598,305340780,305351393,10613,3422,150
305357340,305355523,305366292,10769,3423,150
305372457,305370422,305381352,10930,3424,150
305387514,305385481,305396408,10927,3425,150
305402572,305400538,305411467,10929,3426,150
305417630,305415596,305425892,10296,3427,150
305432055,305430022,305440632,10610,3428,150
305446795,305444762,305455372,10610,3429,150
305461536,305459502,305468194,8692,3430,150
305474052,305472235,305480926,8691,3431,150
305487001,305484967,305495895,10928,3432,150
305502059,305500025,305509350,9325,3433,150
305515208,305513391,305522399,9008,3434,150
305528258,305526441,305536768,10327,3435,150
305542933,305540898,305550541,9643,3436,150
305556615,305554582,305563590,9008,3437,150
305569448,305567631,305577219,9588,3438,150
305583294,305581260,305590901,9641,3439,150
305596759,305594942,305605818,10876,3440,150
305611982,305609948,305620877,10929,3441,150
305627039,305625006,305635934,10928,3442,150
305642098,305640064,305649389,9325,3443,150
305655248,305653430,305664042,10612,3444,150
305669988,305668171,305678466,10295,3445,150
305684413,305682595,305692238,9643,3446,150
305698097,305696279,305705605,9326,3447,150
305711464,305709646,305718971,9325,3448,150
305725046,305723012,305733940,10928,3449,150
305740104,305738070,305747712,9642,3450,150
305753570,305751753,305760444,8691,3451,150
305766519,305764485,305773493,9008,3452,150
305779351,305777534,305787754,10220,3453,150
305793917,305791884,305801841,9957,3454,150
305807917,305805883,305814891,9008,3455,150
305820749,305818932,305829807,10875,3456,150
305835970,305833937,305844864,10927,3457,150
305850811,305848994,305858952,9958,3458,150
305865027,305862993,305872634,9641,3459,150
305878492,305876675,305887604,10929,3460,150
305893768,305891734,305901692,9958,3461,150
305907551,305905733,305916609,10876,3462,150
305922772,305920739,305931667,10928,3463,150
305937614,305935796,305945438,9642,3464,150
305951297,305949479,305959152,9673,3465,150
305965227,305963193,305971885,8692,3466,150
305977743,305975926,305986147,10221,3467,150
305992311,305990277,306000235,9958,3468,150
306006310,306004276,306015204,10928,3469,150
306021368,306019334,306030263,10929,3470,150
306036427,306034393,306044035,9642,3471,150
306049894,306048076,306058035,9959,3472,150
306064110,306062076,306072371,10295,3473,150
306078319,306076501,306087431,10930,3474,150
306093596,306091561,306101520,9959,3475,150
306107595,306105561,306115202,9641,3476,150
306121277,306119243,306128567,9324,3477,150
306134426,306132608,306142196,9588,3478,150
306148054,306146237,306155825,9588,3479,150
306161685,306159867,306170158,10291,3480,150
306176322,306174288,306183296,9008,3481,150
306189155,306187337,306196662,9325,3482,150
306202737,306200703,306210661,9958,3483,150
306216519,306214702,306223709,9007,3484,150
306229784,306227750,306238679,10929,3485,150
306244626,306242809,306251500,8691,3486,150
306257575,306255541,306264233,8692,3487,150
306270092,306268274,306278918,10644,3488,150
306285083,306283048,306291740,8692,3489,150
306297815,306295781,306305106,9325,3490,150
306310964,306309147,306319443,10296,3491,150
306325389,306323573,306332422,8849,3492,150
306338280,306336463,306345735,9272,3493,150
306351595,306349777,306359419,9642,3494,150
306365278,306363461,306372153,8692,3495,150
306378229,306376194,306387124,10930,3496,150
306393289,306391254,306400580,9326,3497,150
306406656,306404621,306414917,10296,3498,150
306420864,306419047,306427739,8692,3499,150
306433598,306431780,306441106,9326,3500,150
306447180,306445147,306454154,9007,3501,150
306460229,306458195,306468153,9958,3502,150
306474228,306472194,306481519,9325,3503,150
306487594,306485560,306496489,10929,3504,150
306502436,306500619,306509785,9166,3505,150
306515643,306513826,306523783,9957,3506,150
306529643,306527825,306536462,8637,3507,150
306542537,306540503,306551432,10929,3508,150
306557379,306555562,306565203,9641,3509,150
306571062,306569244,306580119,10875,3510,150
306586283,306584249,306592941,8692,3511,150
306599017,306596982,306607595,10613,3512,150
306613542,306611725,306621683,9958,3513,150
306627758,306625724,306634732,9008,3514,150
306640592,306638774,306648733,9959,3515,150
306654808,306652774,306661465,8691,3516,150
306667540,306665506,306676435,10929,3517,150
306682599,306680565,306690207,9642,3518,150
306696282,306694248,306704861,10613,3519,150
306711025,306708991,306719604,10613,3520,150
306725551,306723733,306734187,10454,3521,150
306740351,306738317,306749246,10929,3522,150
306755410,306753376,306763333,9957,3523,150
306769408,306767374,306776382,9008,3524,150
306782240,306780423,306791352,10929,3525,150
306797299,306795482,306805281,9799,3526,150
306811140,306809322,306817729,8407,3527,150
306823587,306821770,306832381,10611,3528,150
306838545,306836511,306847124,10613,3529,150
306853289,306851254,306860264,9010,3530,150
306866339,306864305,306875233,10928,3531,150
306881181,306879363,306889816,10453,3532,150
306895980,306893946,306904875,10929,3533,150
306910822,306909005,306917875,8870,3534,150
306923950,306921916,306930923,9007,3535,150
306936998,306934964,306945892,10928,3536,150
306952056,306950022,306960950,10928,3537,150
306967115,306965080,306975039,9959,3538,150
306981115,306979081,306988407,9326,3539,150
306994481,306992448,307003376,10928,3540,150
307009540,307007506,307016515,9009,3541,150
307022591,307020557,307030199,9642,3542,150
307036275,307034241,307043566,9325,3543,150
307049641,307047607,307056931,9324,3544,150
307063006,307060972,307071585,10613,3545,150
307077750,307075716,307086012,10296,3546,150
307092176,307090142,307099784,9642,3547,150
307105859,307103825,307114121,10296,3548,150
307120069,307118252,307129180,10928,3549,150
307135344,307133310,307143605,10295,3550,150
307149552,307147735,307158664,10929,3551,150
307164611,307162794,307171803,9009,3552,150
307177662,307175845,307186067,10222,3553,150
307192230,307190197,307199204,9007,3554,150
307205063,307203245,307213203,9958,3555,150
307219061,307217243,307227855,10612,3556,150
307233801,307231984,307242596,10612,3557,150
307248759,307246725,307256050,9325,3558,150
307262125,307260091,307269416,9325,3559,150
307275491,307273457,307282149,8692,3560,150
307288224,307286190,307296148,9958,3561,150
307302223,307300189,307310147,9958,3562,150
307316221,307314187,307324145,9958,3563,150
307330002,307328186,307338174,9988,3564,150
307344247,307342214,307351855,9641,3565,150
307357930,307355896,307365538,9642,3566,150
307371613,307369579,307379221,9642,3567,150
307385078,307383261,307392268,9007,3568,150
307398342,307396308,307405950,9642,3569,150
307411808,307409991,307418683,8692,3570,150
307424758,307422724,307432048,9324,3571,150
307438123,307436089,307446047,9958,3572,150
307451905,307450088,307460383,10295,3573,150
307466548,307464512,307473205,8693,3574,150
307479063,307477246,307485937,8691,3575,150
307492011,307489978,307500588,10610,3576,150
307506752,307504718,307515331,10613,3577,150
307521496,307519461,307530390,10929,3578,150
307536555,307534520,307543846,9326,3579,150
307549922,307547887,307557212,9325,3580,150
307563070,307561253,307569945,8692,3581,150
307575804,307573986,307583312,9326,3582,150
307589387,307587353,307596045,8692,3583,150
307602120,307600086,307608778,8692,3584,150
307614853,307612819,307623748,10929,3585,150
307629695,307627878,307637836,9958,3586,150
307643910,307641877,307652805,10928,3587,150
307658970,307656935,307667232,10297,3588,150
307673395,307671361,307681003,9642,3589,150
307687078,307685044,307695657,10613,3590,150
307701604,307699786,307709427,9641,3591,150
307715284,307713468,307722475,9007,3592,150
307728332,307726516,307737126,10610,3593,150
307743073,307741256,307750581,9325,3594,150
307756657,307754622,307764919,10297,3595,150
307771082,307769049,307779661,10612,3596,150
307785825,307783791,307794404,10613,3597,150
307800350,307798533,307809462,10929,3598,150
307815626,307813592,307822601,9009,3599,150
307828459,307826642,307836600,9958,3600,150
307842675,307840641,307851570,10929,3601,150
307857517,307855700,307865341,9641,3602,150
307871200,307869382,307879604,10222,3603,150
307885768,307883734,307892426,8692,3604,150
307898284,307896467,307907396,10929,3605,150
307913559,307911526,307921167,9641,3606,150
307927025,307925208,307935504,10296,3607,150
307941668,307939634,307949930,10296,3608,150
307955878,307954060,307962752,8692,3609,150
307968611,307966793,307975801,9008,3610,150
307981660,307979842,307988882,9040,3611,150
307994740,307992923,308001614,8691,3612,150
308007472,308005655,308016266,10611,3613,150
308022212,308020396,308029265,8869,3614,150
308035123,308033306,308042893,9587,3615,150
308048752,308046934,308057155,10221,3616,150
308063102,308061285,308071243,9958,3617,150
308077319,308075284,308086213,10929,3618,150
308092377,308090343,308101271,10928,3619,150
308107435,308105401,308115359,9958,3620,150
308121434,308119400,308130329,10929,3621,150
308136277,308134459,308143785,9326,3622,150
308149860,308147826,308157784,9958,3623,150
308163859,308161825,308172120,10295,3624,150
308178068,308176250,308185891,9641,3625,150
308191750,308189932,308199289,9357,3626,150
308205146,308203330,308213550,10220,3627,150
308219497,308217680,308226688,9008,3628,150
308232763,308230729,308241024,10295,3629,150
308247188,308245153,308255111,9958,3630,150
308260969,308259152,308268106,8954,3631,150
308273964,308272147,308281734,9587,3632,150
308287592,308285775,308296070,10295,3633,150
308302234,308300200,308309208,9008,3634,150
308315067,308313249,308322891,9642,3635,150
308328749,308326932,308337807,10875,3636,150
308343971,308341937,308352233,10296,3637,150
308358397,308356362,308365687,9325,3638,150
308371761,308369728,308379052,9324,3639,150
308385127,308383093,308392734,9641,3640,150
308398809,308396775,308406416,9641,3641,150
308412275,308410457,308421101,10644,3642,150
308427265,308425231,308435189,9958,3643,150
308441263,308439230,308449187,9957,3644,150
308455262,308453228,308462237,9009,3645,150
308468312,308466278,308475602,9324,3646,150
308481677,308479643,308489284,9641,3647,150
308495360,308493325,308503938,10613,3648,150
308510101,308508067,308518680,10613,3649,150
308524843,308522809,308533737,10928,3650,150
308539901,308537867,308547509,9642,3651,150
308553367,308551550,308559955,8405,3652,150
308566029,308563996,308573952,9956,3653,150
308579810,308577993,308586948,8955,3654,150
308592806,308590989,308600314,9325,3655,150
308606173,308604355,308614598,10243,3656,150
308620762,308618728,308629024,10296,3657,150
308634971,308633154,308643944,10790,3658,150
308650110,308648074,308659005,10931,3659,150
308665170,308663135,308671828,8693,3660,150
308677686,308675869,308686110,10241,3661,150
308692273,308690240,308700850,10610,3662,150
308706797,308704980,308715770,10790,3663,150
308721934,308719900,308730829,10929,3664,150
308736993,308734959,308743967,9008,3665,150
308750042,308748008,308758937,10929,3666,150
308765101,308763067,308771758,8691,3667,150
308777834,308775799,308786413,10614,3668,150
308792577,308790543,308801156,10613,3669,150
308807103,308805286,308813839,8553,3670,150
308819915,308817880,308828492,10612,3671,150
308834439,308832622,308842917,10295,3672,150
308849081,308847047,308856689,9642,3673,150
308862764,308860730,308871658,10928,3674,150
308877605,308875788,308886084,10296,3675,150
308892248,308890214,308898906,8692,3676,150
308904981,308902947,308913242,10295,3677,150
308919189,308917372,308926242,8870,3678,150
308932100,308930283,308938689,8406,3679,150
308944764,308942730,308953659,10929,3680,150
308959822,308957788,308967430,9642,3681,150
308973504,308971471,308980162,8691,3682,150
308986237,308984203,308995132,10929,3683,150
309001296,308999262,309007954,8692,3684,150
309013812,309011995,309022553,10558,3685,150
309028717,309026683,309036325,9642,3686,150
309042183,309040366,309049953,9587,3687,150
309056028,309053994,309064606,10612,3688,150
309070769,309068736,309079663,10927,3689,150
309085827,309083793,309094404,10611,3690,150
309100568,309098534,309107542,9008,3691,150
309113400,309111583,309121487,9904,3692,150
309127346,309125528,309135201,9673,3693,150
309141276,309139242,309149537,10295,3694,150
309155702,309153667,309163310,9643,3695,150
309169168,309167351,309176074,8723,3696,150
309182149,309180115,309190095,9980,3697,150
309195953,309194136,309203777,9641,3698,150
309209635,309207818,309217174,9356,3699,150
309223033,309221215,309231120,9905,3700,150
309237195,309235161,309245774,10613,3701,150
309251722,309249904,309260694,10790,3702,150
309266857,309264824,309275119,10295,3703,150
309281283,309279249,309288256,9007,3704,150
309294332,309292297,309303227,10930,3705,150
309309391,309307357,309317336,9979,3706,150
309323410,309321377,309331017,9640,3707,150
309336875,309335058,309343696,8638,3708,150
309349555,309347737,309357009,9272,3709,150
309362867,309361050,309371979,10929,3710,150
309378142,309376108,309386404,10296,3711,150
309392567,309390533,309399858,9325,3712,150
309405716,309403899,309414511,10612,3713,150
309420458,309418641,309428282,9641,3714,150
309434140,309432323,309441648,9325,3715,150
309447506,309445689,309454728,9039,3716,150
309460587,309458769,309468411,9642,3717,150
309474486,309472452,309482748,10296,3718,150
309488912,309486878,309495887,9009,3719,150
309501962,309499928,309508937,9009,3720,150
309515012,309512978,309522303,9325,3721,150
309528161,309526344,309536639,10295,3722,150
309542586,309540769,309549777,9008,3723,150
309555853,309553818,309563144,9326,3724,150
309569003,309567185,309577164,9979,3725,150
309583239,309581205,309591817,10612,3726,150
309597764,309595947,309605272,9325,3727,150
309611130,309609313,309618035,8722,3728,150
309624110,309622076,309630768,8692,3729,150
309636843,309634809,309645104,10295,3730,150
309651052,309649234,309658738,9504,3731,150
309664814,309662779,309671472,8693,3732,150
309677331,309675513,309686126,10613,3733,150
309692290,309690256,309700235,9979,3734,150
309706093,309704276,309714255,9979,3735,150
309720114,309718296,309728855,10559,3736,150
309734802,309732985,309741539,8554,3737,150
309747614,309745580,309754272,8692,3738,150
309760130,309758313,309767352,9039,3739,150
309773426,309771393,309781688,10295,3740,150
309787634,309785817,309796429,10612,3741,150
309802591,309800558,309809249,8691,3742,150
309815107,309813290,309822561,9271,3743,150
309828420,309826602,309835009,8407,3744,150
309841084,309839050,309848059,9009,3745,150
309854134,309852100,309862079,9979,3746,150
309867937,309866120,309876731,10611,3747,150
309882678,309880861,309891789,10928,3748,150
309897952,309895919,309904609,8690,3749,150
309910685,309908650,309917342,8692,3750,150
309923200,309921383,309931995,10612,3751,150
309937941,309936124,309944993,8869,3752,150
309950852,309949034,309958043,9009,3753,150
309963902,309962084,309971409,9325,3754,150
309977267,309975450,309985036,9586,3755,150
309990894,309989077,309999373,10296,3756,150
310005537,310003503,310013144,9641,3757,150
310019218,310017185,310027163,9978,3758,150
310033021,310031204,310040159,8955,3759,150
310046019,310044201,310053240,9039,3760,150
310059315,310057281,310066606,9325,3761,150
310072681,310070647,310079971,9324,3762,150
310086046,310084012,310094941,10929,3763,150
310101104,310099071,310107762,8691,3764,150
310113836,310111803,310122097,10294,3765,150
310128044,310126227,310135414,9187,3766,150
310141489,310139455,310149434,9979,3767,150
310155509,310153475,310162800,9325,3768,150
310168658,310166841,310176798,9957,3769,150
310182656,310180839,310190481,9642,3770,150
310196557,310194522,310204502,9980,3771,150
310210578,310208543,310217869,9326,3772,150
310223728,310221911,310230920,9009,3773,150
310236778,310234961,310245257,10296,3774,150
310251421,310249387,310260316,10929,3775,150
310266480,310264446,310274088,9642,3776,150
310280163,310278129,310287454,9325,3777,150
310293529,310291495,310301790,10295,3778,150
310307954,310305920,310316849,10929,3779,150
310323012,310320979,310329670,8691,3780,150
310335529,310333711,310344008,10297,3781,150
310349955,310348138,310358433,10295,3782,150
310364597,310362563,310372205,9642,3783,150
310378280,310376247,310385571,9324,3784,150
310391646,310389612,310398304,8692,3785,150
310404379,310402346,310411670,9324,3786,150
310417529,310415711,310424350,8639,3787,150
310430425,310428391,310439320,10929,3788,150
310445268,310443450,310452775,9325,3789,150
310458633,310456816,310466805,9989,3790,150
310472880,310470846,310481774,10928,3791,150
310487938,310485904,310496832,10928,3792,150
310502996,310500962,310509654,8692,3793,150
310515729,310513695,310523653,9958,3794,150
310529511,310527694,310536385,8691,3795,150
310542461,310540426,310550385,9959,3796,150
310556243,310554426,310570587,16161,3797,150
310576535,310574718,310583250,8532,3798,150
310589108,310587291,310596299,9008,3799,150
310602374,310600340,310610297,9957,3800,150
310616155,310614338,310624327,9989,3801,150
310630185,310628368,310637323,8955,3802,150
310643182,310641365,310651270,9905,3803,150
310657127,310655311,310665606,10295,3804,150
310671770,310669736,310678428,8692,3805,150
310684286,310682469,310693027,10558,3806,150
310698974,310697157,310708086,10929,3807,150
310714250,310712216,310722829,10613,3808,150
310728992,310726959,310736600,9641,3809,150
310742459,310740641,310754344,13703,3810,150
310760508,310758474,310767799,9325,3811,150
310773656,310771840,310782134,10294,3812,150
310788298,310786264,310797192,10928,3813,150
310803356,310801322,310810964,9642,3814,150
310817039,310815005,310824963,9958,3815,150
310830821,310829004,310838012,9008,3816,150
310844087,310842053,310852349,10296,3817,150
310858513,310856479,310866437,9958,3818,150
310872295,310870478,310879485,9007,3819,150
310885561,310883527,310892853,9326,3820,150
310898711,310896894,310907506,10612,3821,150
310913670,310911636,310921277,9641,3822,150
310927351,310925318,310934009,8691,3823,150
310939867,310938050,310948608,10558,3824,150
310954555,310952738,310963034,10296,3825,150
310969198,310967164,310977459,10295,3826,150
310983406,310981589,310992201,10612,3827,150
310998365,310996331,311005023,8692,3828,150
311011097,311009064,311019359,10295,3829,150
311025307,311023489,311032498,9009,3830,150
311038356,311036539,311046497,9958,3831,150
311052355,311050538,311061180,10642,3832,150
311067344,311065310,311076239,10929,3833,150
311082403,311080369,311091297,10928,3834,150
311097462,311095427,311104120,8693,3835,150
311110195,311108161,311118457,10296,3836,150
311124621,311122587,311132229,9642,3837,150
311138087,311136270,311144908,8638,3838,150
311150766,311148949,311159245,10296,3839,150
311165409,311163375,311173670,10295,3840,150
311179835,311177800,311188414,10614,3841,150
311194361,311192544,311202680,10136,3842,150
311208628,311206810,311215819,9009,3843,150
311221677,311219860,311228868,9008,3844,150
311234726,311232909,311243236,10327,3845,150
311249401,311247366,311263509,16143,3846,150
311269674,311267640,311277936,10296,3847,150
311283883,311282066,311291548,9482,3848,150
311297623,311295590,311304912,9322,3849,150
311310987,311308953,311318910,9957,3850,150
311324768,311322951,311332593,9642,3851,150
311338451,311336634,311345642,9008,3852,150
311351499,311349683,311360610,10927,3853,150
311366773,311364739,311373747,9008,3854,150
311379606,311377788,311386797,9009,3855,150
311392872,311390838,311401450,10612,3856,150
311407614,311405580,311416192,10612,3857,150
311422140,311420322,311430281,9959,3858,150
311436139,311434322,311443330,9008,3859,150
311449189,311447371,311457984,10613,3860,150
311464148,311462114,311471121,9007,3861,150
311477196,311475162,311485457,10295,3862,150
311491405,311489587,311499704,10117,3863,150
311505652,311503834,311514446,10612,3864,150
311520610,311518576,311527585,9009,3865,150
311533443,311531626,311540896,9270,3866,150
311546755,311544937,311555867,10930,3867,150
311562031,311559997,311569955,9958,3868,150
311575814,311573996,311584217,10221,3869,150
311590382,311588347,311598307,9960,3870,150
311604165,311602348,311611619,9271,3871,150
311617695,311615661,311624985,9324,3872,150
311631059,311629026,311639637,10611,3873,150
311645801,311643766,311653092,9326,3874,150
311658951,311657133,311667777,10644,3875,150
311673725,311671907,311681233,9326,3876,150
311687308,311685274,311695232,9958,3877,150
311701091,311699273,311707966,8693,3878,150
311714041,311712007,311721332,9325,3879,150
311727190,311725373,311734328,8955,3880,150
311740187,311738369,311749245,10876,3881,150
311755410,311753375,311763333,9958,3882,150
311769408,311767374,311777015,9641,3883,150
311783090,311781056,311791014,9958,3884,150
311797089,311795055,311805668,10613,3885,150
311811832,311809798,311819756,9958,3886,150
311825614,311823797,311834409,10612,3887,150
311840571,311838538,311847546,9008,3888,150
311853621,311851587,311861544,9957,3889,150
311867619,311865585,311875881,10296,3890,150
311881828,311880011,311889336,9325,3891,150
311895193,311893377,311903671,10294,3892,150
311909835,311907801,311917126,9325,3893,150
311922984,311921167,311930491,9324,3894,150
311936566,311934532,311944173,9641,3895,150
311950031,311948214,311957221,9007,3896,150
311963079,311961262,311969900,8638,3897,150
311975975,311973941,311984553,10612,3898,150
311990717,311988683,311998641,9958,3899,150
312004716,312002682,312012978,10296,3900,150
312019141,312017108,312027720,10612,3901,150
312033668,312031850,312040383,8533,3902,150
312046241,312044424,312054751,10327,3903,150
312060915,312058881,312069810,10929,3904,150
312075757,312073940,312082631,8691,3905,150
312088706,312086672,312095680,9008,3906,150
312101537,312099721,312109941,10220,3907,150
312115889,312114071,312123713,9642,3908,150
312129789,312127754,312136764,9010,3909,150
312142839,312140805,312151733,10928,3910,150
312157681,312155863,312164554,8691,3911,150
312170629,312168595,312178891,10296,3912,150
312185055,312183021,312192029,9008,3913,150
312198104,312196070,312206028,9958,3914,150
312211887,312210069,312220291,10222,3915,150
312226455,312224421,312234063,9642,3916,150
312239921,312238104,312247374,9270,3917,150
312253448,312251415,312262343,10928,3918,150
312268507,312266473,312276769,10296,3919,150
312282932,312280899,312291511,10612,3920,150
312297458,312295641,312306253,10612,3921,150
312312417,312310383,312320340,9957,3922,150
312326416,312324381,312333390,9009,3923,150
312339248,312337431,312348042,10611,3924,150
312354205,312352172,312361179,9007,3925,150
312367253,312365220,312375832,10612,3926,150
312381997,312379962,312388971,9009,3927,150
312395046,312393012,312403308,10296,3928,150
312409471,312407438,312418049,10611,3929,150
312424214,312422179,312432138,9959,3930,150
312437996,312436179,312446081,9902,3931,150
312451941,312450122,312460736,10614,3932,150
312466682,312464866,312474189,9323,3933,150
312480265,312478230,312488189,9959,3934,150
312494265,312492230,312502189,9959,3935,150
312508265,312506230,312516844,10614,3936,150
312523008,312520974,312531269,10295,3937,150
312537434,312535399,312544725,9326,3938,150
312550799,312548766,312558090,9324,3939,150
312564165,312562131,312571456,9325,3940,150
312577531,312575497,312586426,10929,3941,150
312592373,312590556,312600036,9480,3942,150
312606112,312604077,312613402,9325,3943,150
312619260,312617443,312628055,10612,3944,150
312634219,312632185,312642143,9958,3945,150
312648001,312646184,312654876,8692,3946,150
312660734,312658917,312669529,10612,3947,150
312675693,312673659,312683617,9958,3948,150
312689692,312687658,312696983,9325,3949,150
312703058,312701024,312711953,10929,3950,150
312718117,312716083,312724774,8691,3951,150
312730850,312728815,312739745,10930,3952,150
312745909,312743875,312754488,10613,3953,150
312760653,312758618,312768576,9958,3954,150
312774435,312772617,312782575,9958,3955,150
312788649,312786616,312795307,8691,3956,150
312801382,312799348,312808355,9007,3957,150
312814213,312812396,312821088,8692,3958,150
312826946,312825129,312835350,10221,3959,150
312841298,312839480,312848489,9009,3960,150
312854347,312852530,312863403,10873,3961,150
312869567,312867533,312876858,9325,3962,150
312882933,312880899,312890224,9325,3963,150
312896299,312894265,312903906,9641,3964,150
312909981,312907947,312916955,9008,3965,150
312922814,312920997,312929688,8691,3966,150
312935763,312933729,312943370,9641,3967,150
312949227,312947411,312958022,10611,3968,150
312964186,312962152,312972448,10296,3969,150
312978611,312976577,312985901,9324,3970,150
312991760,312989942,313000162,10220,3971,150
313006326,313004292,313014904,10612,3972,150
313020851,313019034,313027726,8692,3973,150
313033800,313031767,313040458,8691,3974,150
313046316,313044499,313055375,10876,3975,150
313061539,313059505,313069146,9641,3976,150
313075004,313073187,313083145,9958,3977,150
313089004,313087186,313096512,9326,3978,150
313102371,313100554,313110194,9640,3979,150
313116052,313114235,313123822,9587,3980,150
313129680,313127863,313136501,8638,3981,150
313142359,313140542,313151185,10643,3982,150
313157348,313155315,313165926,10611,3983,150
313171874,313170056,313179699,9643,3984,150
313185557,313183740,313194665,10925,3985,150
313200829,313198795,313208753,9958,3986,150
313214828,313212794,313223089,10295,3987,150
313229036,313227219,313237831,10612,3988,150
313243995,313241961,313250970,9009,3989,150
313257045,313255011,313264019,9008,3990,150
313270094,313268060,313278018,9958,3991,150
313283876,313282059,313290781,8722,3992,150
313296639,313294822,313305751,10929,3993,150
313311915,313309881,313318890,9009,3994,150
313324748,313322931,313332889,9958,3995,150
313338748,313336930,313346920,9990,3996,150
313352996,313350961,313359653,8692,3997,150
313365728,313363694,313373336,9642,3998,150
313379194,313377377,313387019,9642,3999,150
313392877,313391060,313399752,8692,4000,150
313405609,313403793,313413750,9957,4001,150
313419607,313417791,313427693,9902,4002,150
313433551,313431734,313441376,9642,4003,150
313447235,313445417,313454373,8956,4004,150
313460447,313458414,313467421,9007,4005,150
313473279,313471462,313480417,8955,4006,150
313486492,313484458,313493782,9324,4007,150
313499640,313497823,313507465,9642,4008,150
313513323,313511506,313520514,9008,4009,150
313526372,313524555,313534512,9957,4010,150
313540588,313538553,313548196,9643,4011,150
313554271,313552237,313561245,9008,4012,150
313567103,313565286,313575845,10559,4013,150
313582008,313579975,313590585,10610,4014,150
313596749,313594715,313605644,10929,4015,150
313611807,313609774,313620068,10294,4016,150
313626231,313624197,313632889,8692,4017,150
313638964,313636930,313646888,9958,4018,150
313652746,313650929,313660516,9587,4019,150
313666374,313664557,313673881,9324,4020,150
313679739,313677922,313686876,8954,4021,150
313692952,313690917,313701531,10614,4022,150
313707478,313705661,313715776,10115,4023,150
313721941,313719906,313728916,9010,4024,150
313734991,313732957,313743569,10612,4025,150
313749733,313747699,313756391,8692,4026,150
313762466,313760432,313770074,9642,4027,150
313775932,313774115,313784073,9958,4028,150
313790148,313788114,313798727,10613,4029,150
313804892,313802857,313813470,10613,4030,150
313819418,313817600,313827559,9959,4031,150
313833634,313831600,313840607,9007,4032,150
313846465,313844648,313855524,10876,4033,150
313861688,313859654,313868663,9009,4034,150
313874737,313872704,313881395,8691,4035,150
313887471,313885436,313894446,9010,4036,150
313900305,313898487,313908129,9642,4037,150
313914204,313912170,313920862,8692,4038,150
313926937,313924903,313933595,8692,4039,150
313939670,313937636,313946961,9325,4040,150
313952819,313951002,313960273,9271,4041,150
313966131,313964314,313974271,9957,4042,150
313980129,313978312,313988216,9904,4043,150
313994073,313992257,314000947,8690,4044,150
314006805,314004988,314015546,10558,4045,150
314021710,314019676,314029318,9642,4046,150
314035175,314033359,314042683,9324,4047,150
314048758,314046724,314055731,9007,4048,150
314061805,314059772,314069096,9324,4049,150
314074955,314073137,314082146,9009,4050,150
314088220,314086187,314096144,9957,4051,150
314102003,314100185,314109828,9643,4052,150
314115904,314113869,314122562,8693,4053,150
314128636,314126603,314135927,9324,4054,150
314142002,314139968,314148977,9009,4055,150
314154835,314153018,314163313,10295,4056,150
314169478,314167443,314177402,9959,4057,150
314183477,314181443,314190768,9325,4058,150
314196843,314194809,314203501,8692,4059,150
314209576,314207542,314217838,10296,4060,150
314223786,314221968,314231294,9326,4061,150
314237370,314235336,314244661,9325,4062,150
314250736,314248702,314259313,10611,4063,150
314265477,314263443,314272135,8692,4064,150
314278210,314276176,314285501,9325,4065,150
314291576,314289542,314300471,10929,4066,150
314306418,314304601,314314897,10296,4067,150
314321061,314319027,314327718,8691,4068,150
314333576,314331759,314340767,9008,4069,150
314346627,314344809,314353533,8724,4070,150
314359608,314357574,314366898,9324,4071,150
314372758,314370940,314381553,10613,4072,150
314387717,314385683,314396612,10929,4073,150
314402776,314400742,314411355,10613,4074,150
314417519,314415485,314424494,9009,4075,150
314430569,314428535,314437227,8692,4076,150
314443085,314441269,314451257,9988,4077,150
314457115,314455298,314466227,10929,4078,150
314472391,314470357,314480315,9958,4079,150
314486174,314484356,314494653,10297,4080,150
314500817,314498783,314508741,9958,4081,150
314514599,314512783,314522423,9640,4082,150
314528281,314526464,314537389,10925,4083,150
314543553,314541519,314550528,9009,4084,150
314556388,314554570,314565183,10613,4085,150
314571130,314569313,314579765,10452,4086,150
314585930,314583895,314594507,10612,4087,150
314600669,314598636,314609247,10611,4088,150
314615411,314613377,314622702,9325,4089,150
314628561,314626743,314636646,9903,4090,150
314642720,314640687,314651298,10611,4091,150
314657461,314655427,314664435,9008,4092,150
314670509,314668476,314677484,9008,4093,150
314683558,314681525,314691482,9957,4094,150
314697339,314695522,314705818,10296,4095,150
314711981,314709948,314720242,10294,4096,150
314726406,314724372,314735300,10928,4097,150
314741247,314739430,314748120,8690,4098,150
314754195,314752161,314762773,10612,4099,150
314768719,314766902,314777514,10612,4100,150
314783678,314781644,314790336,8692,4101,150
314796194,314794377,314804672,10295,4102,150
314810835,314808802,314818126,9324,4103,150
314824200,314822167,314832124,9957,4104,150
314838199,314836165,314845807,9642,4105,150
314851666,314849848,314859806,9958,4106,150
314865664,314863847,314874068,10221,4107,150
314880232,314878198,314888156,9958,4108,150
314894014,314892197,314902101,9904,4109,150
314907959,314906142,314917071,10929,4110,150
314923234,314921200,314930207,9007,4111,150
314936282,314934248,314943257,9009,4112,150
314949333,314947298,314958227,10929,4113,150
314964391,314962356,314972315,9959,4114,150
314978174,314976356,314986345,9989,4115,150
314992202,314990386,314999972,9586,4116,150
315005831,315004013,315012706,8693,4117,150
315018565,315016747,315026102,9355,4118,150
315032177,315030143,315040439,10296,4119,150
315046603,315044569,315053261,8692,4120,150
315059336,315057302,315066626,9324,4121,150
315072484,315070667,315081226,10559,4122,150
315087390,315085356,315095651,10295,4123,150
315101816,315099781,315108791,9010,4124,150
315114866,315112832,315121841,9009,4125,150
315127915,315125882,315135838,9956,4126,150
315141913,315139879,315149837,9958,4127,150
315155911,315153878,315163835,9957,4128,150
315169910,315167876,315178805,10929,4129,150
315184969,315182935,315191627,8692,4130,150
315197703,315195668,315205311,9643,4131,150
315211169,315209352,315219647,10295,4132,150
315225593,315223776,315232646,8870,4133,150
315238504,315236687,315246645,9958,4134,150
315252504,315250686,315260908,10222,4135,150
315266856,315265038,315274047,9009,4136,150
315280122,315278088,315287729,9641,4137,150
315293588,315291770,315300462,8692,4138,150
315306320,315304503,315313774,9271,4139,150
315319850,315317815,315327140,9325,4140,150
315333000,315331181,315341792,10611,4141,150
315347956,315345922,315355247,9325,4142,150
315361105,315359288,315369931,10643,4143,150
315376095,315374061,315383386,9325,4144,150
315389461,315387427,315398355,10928,4145,150
315404519,315402485,315412443,9958,4146,150
315418302,315416484,315425493,9009,4147,150
315431567,315429534,315440145,10611,4148,150
315446309,315444275,315453284,9009,4149,150
315459359,315457325,315468253,10928,4150,150
315474417,315472382,315481392,9010,4151,150
315487467,315485433,315495075,9642,4152,150
315501150,315499116,315509728,10612,4153,150
315515675,315513858,315523023,9165,4154,150
315528881,315527064,315536333,9269,4155,150
315542192,315540374,315549699,9325,4156,150
315555773,315553740,315563697,9957,4157,150
315569772,315567738,315576429,8691,4158,150
315582504,315580470,315589795,9325,4159,150
315595654,315593836,315604396,10560,4160,150
315610343,315608525,315617375,8850,4161,150
315623233,315621416,315630687,9271,4162,150
315636761,315634728,315644685,9957,4163,150
315650543,315648726,315657765,9039,4164,150
315663839,315661805,315671763,9958,4165,150
315677622,315675804,315685161,9357,4166,150
315691020,315689202,315699161,9959,4167,150
315705236,315703202,315712210,9008,4168,150
315718284,315716251,315726545,10294,4169,150
315732709,315730675,315741287,10612,4170,150
315747451,315745417,315754109,8692,4171,150
315759968,315758150,315768447,10297,4172,150
315774612,315772577,315781586,9009,4173,150
315787660,315785627,315796554,10927,4174,150
315802718,315800684,315809376,8692,4175,150
315815451,315813417,315822108,8691,4176,150
315828183,315826149,315835790,9641,4177,150
315841648,315839831,315848839,9008,4178,150
315854697,315852880,315861572,8692,4179,150
315867647,315865613,315874938,9325,4180,150
315880796,315878979,315889199,10220,4181,150
315895147,315893329,315902655,9326,4182,150
315908512,315906696,315916335,9639,4183,150
315922192,315920376,315930280,9904,4184,150
315936354,315934321,315943645,9324,4185,150
315949504,315947686,315957012,9326,4186,150
315963087,315961053,315971011,9958,4187,150
315976870,315975052,315984693,9641,4188,150
315990551,315988734,315999029,10295,4189,150
316005193,316003159,316013117,9958,4190,150
316019191,316017158,316027114,9956,4191,150
316033189,316031155,316042084,10929,4192,150
316048248,316046214,316056826,10612,4193,150
316062990,316060956,316069965,9009,4194,150
316076040,316074006,316084935,10929,4195,150
316090881,316089064,316097755,8691,4196,150
316103614,316101796,316110434,8638,4197,150
316116509,316114475,316123800,9325,4198,150
316129658,316127841,316137799,9958,4199,150
316143656,316141840,316151796,9956,4200,150
316157871,316155837,316165162,9325,4201,150
316171236,316169203,316180131,10928,4202,150
316186078,316184261,316193269,9008,4203,150
316199344,316197310,316208239,10929,4204,150
316214402,316212369,316222664,10295,4205,150
316228828,316226794,316237406,10612,4206,150
316243570,316241536,316250861,9325,4207,150
316256937,316254902,316264228,9326,4208,150
316270303,316268269,316276961,8692,4209,150
316282821,316281002,316291615,10613,4210,150
316297562,316295744,316306198,10454,4211,150
316312362,316310328,316321257,10929,4212,150
316327421,316325387,316334396,9009,4213,150
316340254,316338437,316347129,8692,4214,150
316352987,316351170,316361465,10295,4215,150
316367412,316365595,316376068,10473,4216,150
316382232,316380198,316390493,10295,4217,150
316396440,316394623,316403315,8692,4218,150
316409174,316407356,316417970,10614,4219,150
316423917,316422100,316432553,10453,4220,150
316438716,316436682,316445373,8691,4221,150
316451231,316449414,316459710,10296,4222,150
316465874,316463840,316474769,10929,4223,150
316480933,316478899,316489510,10611,4224,150
316495674,316493640,316503282,9642,4225,150
316509140,316507323,316515728,8405,4226,150
316521586,316519769,316528407,8638,4227,150
316534265,316532448,316542406,9958,4228,150
316548264,316546447,316556087,9640,4229,150
316562162,316560128,316571056,10928,4230,150
316577220,316575185,316586115,10930,4231,150
316592280,316590245,316601175,10930,4232,150
316607338,316605305,316613996,8691,4233,150
316619855,316618037,316628967,10930,4234,150
316635131,316633097,316642105,9008,4235,150
316647963,316646146,316654838,8692,4236,150
316660913,316658879,316669175,10296,4237,150
316675339,316673305,316683600,10295,4238,150
316689764,316687730,316698659,10929,4239,150
316704606,316702789,316713401,10612,4240,150
316719564,316717531,316728141,10610,4241,150
316734305,316732271,316740963,8692,4242,150
316746821,316745004,316755647,10643,4243,150
316761811,316759777,316769101,9324,4244,150
316775177,316773142,316783756,10614,4245,150
316789703,316787886,316797528,9642,4246,150
316803603,316801569,316811527,9958,4247,150
316817385,316815568,316825526,9958,4248,150
316831601,316829567,316840179,10612,4249,150
316846343,316844309,316853001,8692,4250,150
316858859,316857042,316866050,9008,4251,150
316872125,316870091,316879100,9009,4252,150
316884958,316883141,316893046,9905,4253,150
316898904,316897087,316906039,8952,4254,150
316912114,316910080,316919404,9324,4255,150
316925262,316923445,316933666,10221,4256,150
316939829,316937796,316946803,9007,4257,150
316952661,316950844,316961401,10557,4258,150
316967565,316965531,316975827,10296,4259,150
316981992,316979957,316990887,10930,4260,150
316996834,316995017,317003866,8849,4261,150
317009941,317007907,317018520,10613,4262,150
317024466,317022650,317033419,10769,4263,150
317039366,317037549,317047190,9641,4264,150
317053048,317051231,317061135,9904,4265,150
317066993,317065176,317076105,10929,4266,150
317082268,317080235,317089242,9007,4267,150
317095318,317093283,317103580,10297,4268,150
317109745,317107710,317116718,9008,4269,150
317122575,317120759,317131053,10294,4270,150
317137000,317135183,317145795,10612,4271,150
317151960,317149925,317158618,8693,4272,150
317164693,317162659,317171983,9324,4273,150
317177842,317176024,317185983,9959,4274,150
317192058,317190024,317200637,10613,4275,150
317206801,317204767,317213458,8691,4276,150
317219316,317217499,317226770,9271,4277,150
317232845,317230811,317239503,8692,4278,150
317245362,317243544,317253187,9643,4279,150
317259045,317257228,317266584,9356,4280,150
317272442,317270625,317281501,10876,4281,150
317287665,317285631,317295273,9642,4282,150
317301131,317299314,317310241,10927,4283,150
317316188,317314371,317323854,9483,4284,150
317329712,317327895,317337537,9642,4285,150
317343612,317341578,317350902,9324,4286,150
317356761,317354943,317364268,9325,4287,150
317370343,317368309,317377633,9324,4288,150
317383491,317381674,317390681,9007,4289,150
317396756,317394722,317405335,10613,4290,150
317411283,317409465,317418158,8693,4291,150
317424016,317422199,317433128,10929,4292,150
317439292,317437258,317447217,9959,4293,150
317453292,317451258,317460582,9324,4294,150
317466657,317464623,317473948,9325,4295,150
317479806,317477989,317488863,10874,4296,150
317494809,317492993,317503921,10928,4297,150
317509868,317508051,317518166,10115,4298,150
317524330,317522296,317532253,9957,4299,150
317538328,317536294,317546590,10296,4300,150
317552754,317550720,317559411,8691,4301,150
317565486,317563452,317573748,10296,4302,150
317579695,317577878,317587519,9641,4303,150
317593594,317591560,317602172,10612,4304,150
317608336,317606302,317615944,9642,4305,150
317621802,317619985,317629341,9356,4306,150
317635199,317633382,317644311,10929,4307,150
317650474,317648441,317659052,10611,4308,150
317665215,317663181,317673794,10613,4309,150
317679741,317677924,317686932,9008,4310,150
317692790,317690973,317699981,9008,4311,150
317705839,317704022,317714949,10927,4312,150
317721113,317719079,317729036,9957,4313,150
317735111,317733077,317742402,9325,4314,150
317748477,317746443,317757055,10612,4315,150
317763002,317761185,317770056,8871,4316,150
317775914,317774097,317783684,9587,4317,150
317789542,317787725,317798654,10929,4318,150
317804601,317802784,317812267,9483,4319,150
317818343,317816309,317825001,8692,4320,150
317830858,317829042,317839336,10294,4321,150
317845500,317843466,317852158,8692,4322,150
317858233,317856199,317867127,10928,4323,150
317873291,317871257,317881214,9957,4324,150
317887289,317885255,317895213,9958,4325,150
317901288,317899254,317908895,9641,4326,150
317914753,317912936,317922892,9956,4327,150
317928967,317926933,317937861,10928,4328,150
317944025,317941991,317952604,10613,4329,150
317958767,317956733,317965741,9008,4330,150
317971815,317969782,317980394,10612,4331,150
317986558,317984524,317994820,10296,4332,150
318000768,317998950,318009720,10770,4333,150
318015884,318013850,318024463,10613,4334,150
318030410,318028593,318038889,10296,4335,150
318045053,318043019,318051710,8691,4336,150
318057785,318055751,318064442,8691,4337,150
318070301,318068483,318078779,10296,4338,150
318084943,318082909,318093838,10929,4339,150
318100003,318097968,318106661,8693,4340,150
318112736,318110702,318120343,9641,4341,150
318126419,318124384,318134026,9642,4342,150
318140102,318138067,318148364,10297,4343,150
318154311,318152494,318162136,9642,4344,150
318167994,318166177,318175764,9587,4345,150
318181623,318179805,318189795,9990,4346,150
318195653,318193836,318202522,8686,4347,150
318208380,318206563,318215199,8636,4348,150
318221273,318219240,318228880,9640,4349,150
318234955,318232921,318243216,10295,4350,150
318249164,318247346,318256671,9325,4351,150
318262746,318260712,318269721,9009,4352,150
318275580,318273762,318283404,9642,4353,150
318289479,318287445,318296454,9009,4354,150
318302529,318300495,318309504,9009,4355,150
318315362,318313545,318322870,9325,4356,150
318328944,318326911,318336868,9957,4357,150
318342943,318340909,318351838,10929,4358,150
318358003,318355968,318365927,9959,4359,150
318371785,318369968,318379007,9039,4360,150
318385082,318383048,318393006,9958,4361,150
318399081,318397047,318407976,10929,4362,150
318414140,318412106,318421431,9325,4363,150
318427289,318425472,318435799,10327,4364,150
318441747,318439929,318448461,8532,4365,150
318454320,318452502,318463062,10560,4366,150
318469225,318467192,318476199,9007,4367,150
318482274,318480240,318489247,9007,4368,150
318495106,318493288,318502012,8724,4369,150
318507870,318506053,318515092,9039,4370,150
318521167,318519133,318530062,10929,4371,150
318536226,318534192,318542884,8692,4372,150
318548959,318546925,318557221,10296,4373,150
318563386,318561351,318570044,8693,4374,150
318575902,318574085,318584697,10612,4375,150
318590860,318588827,318597835,9008,4376,150
318603693,318601876,318610568,8692,4377,150
318616643,318614609,318623301,8692,4378,150
318629159,318627342,318636614,9272,4379,150
318642471,318640655,318651582,10927,4380,150
318657747,318655712,318666008,10296,4381,150
318672172,318670138,318680750,10612,4382,150
318686696,318684880,318693887,9007,4383,150
318699745,318697928,318708857,10929,4384,150
318714804,318712987,318723441,10454,4385,150
318729605,318727571,318737866,10295,4386,150
318744030,318741996,318750688,8692,4387,150
318756546,318754729,318765335,10606,4388,150
318771282,318769465,318778157,8692,4389,150
318784232,318782198,318791840,9642,4390,150
318797915,318795881,318805839,9958,4391,150
318811697,318809880,318819838,9958,4392,150
318825697,318823879,318832834,8955,4393,150
318838692,318836875,318846864,9989,4394,150
318852939,318850905,318861200,10295,4395,150
318867364,318865330,318874021,8691,4396,150
318879880,318878062,318887334,9272,4397,150
318893409,318891375,318901670,10295,4398,150
318907617,318905800,318914987,9187,4399,150
318920845,318919028,318927720,8692,4400,150
318933578,318931761,318940399,8638,4401,150
318946474,318944440,318953765,9325,4402,150
318959623,318957806,318966811,9005,4403,150
318972887,318970853,318979862,9009,4404,150
318985937,318983903,318994832,10929,4405,150
319000996,318998962,319007971,9009,4406,150
319014046,319012012,319020704,8692,4407,150
319026563,319024745,319035304,10559,4408,150
319041467,319039434,319050045,10611,4409,150
319056209,319054175,319063500,9325,4410,150
319069358,319067541,319077213,9672,4411,150
319083288,319081255,319090896,9641,4412,150
319096971,319094937,319105550,10613,4413,150
319111715,319109680,319118373,8693,4414,150
319124231,319122414,319132086,9672,4415,150
319138161,319136127,319147056,10929,4416,150
319153003,319151186,319162115,10929,4417,150
319168279,319166245,319176858,10613,4418,150
319183023,319180988,319190947,9959,4419,150
319197022,319194988,319204313,9325,4420,150
319210171,319208354,319217363,9009,4421,150
319223221,319221404,319230125,8721,4422,150
319235984,319234166,319245096,10930,4423,150
319251261,319249226,319258235,9009,4424,150
319264093,319262276,319270911,8635,4425,150
319276770,319274952,319285173,10221,4426,150
319291337,319289303,319298628,9325,4427,150
319304486,319302669,319311677,9008,4428,150
319317752,319315718,319325359,9641,4429,150
319331217,319329400,319339695,10295,4430,150
319345859,319343825,319354121,10296,4431,150
319360285,319358251,319367576,9325,4432,150
319373435,319371618,319381206,9588,4433,150
319387282,319385248,319396177,10929,4434,150
319402341,319400307,319409316,9009,4435,150
319415391,319413357,319422682,9325,4436,150
319428758,319426724,319437653,10929,4437,150
319443816,319441783,319451107,9324,4438,150
319457182,319455149,319465107,9958,4439,150
319471182,319469148,319478156,9008,4440,150
319484015,319482197,319492103,9906,4441,150
319498178,319496144,319505469,9325,4442,150
319511328,319509510,319518201,8691,4443,150
319524059,319522242,319531567,9325,4444,150
319537641,319535608,319544616,9008,4445,150
319550691,319548657,319558952,10295,4446,150
319564899,319563082,319573555,10473,4447,150
319579719,319577685,319587980,10295,4448,150
319594144,319592110,319601119,9009,4449,150
319607194,319605160,319614168,9008,4450,150
319620244,319618209,319628505,10296,4451,150
319634453,319632635,319641486,8851,4452,150
319647560,319645527,319655168,9641,4453,150
319661027,319659209,319668797,9588,4454,150
319674873,319672839,319681848,9009,4455,150
319687707,319685889,319696819,10930,4456,150
319702766,319700949,319711719,10770,4457,150
319717883,319715849,319725491,9642,4458,150
319731566,319729532,319738857,9325,4459,150
319744932,319742898,319752223,9325,4460,150
319758082,319756264,319767194,10930,4461,150
319773358,319771324,319781937,10613,4462,150
319788101,319786067,319796996,10929,4463,150
319803159,319801126,319810767,9641,4464,150
319816625,319814808,319823814,9006,4465,150
319829671,319827855,319838076,10221,4466,150
319844023,319842206,319852003,9797,4467,150
319858078,319856044,319864736,8692,4468,150
319870594,319868777,319877468,8691,4469,150
319883327,319881509,319890835,9326,4470,150
319896909,319894876,319904517,9641,4471,150
319910592,319908558,319919170,10612,4472,150
319925117,319923300,319931992,8692,4473,150
319937850,319936033,319944671,8638,4474,150
319950529,319948712,319957404,8692,4475,150
319963480,319961446,319971741,10295,4476,150
319977689,319975871,319986642,10771,4477,150
319992807,319990772,320000730,9958,4478,150
320006588,320004771,320013492,8721,4479,150
320019566,320017532,320028143,10611,4480,150
320034306,320032272,320042568,10296,4481,150
320048514,320046697,320056200,9503,4482,150
320062058,320060241,320069280,9039,4483,150
320075355,320073321,320082012,8691,4484,150
320087871,320086053,320096350,10297,4485,150
320102513,320100479,320109171,8692,4486,150
320115029,320113212,320122884,9672,4487,150
320128742,320126925,320136196,9271,4488,150
320142271,320140237,320149879,9642,4489,150
320155954,320153920,320162927,9007,4490,150
320168785,320166967,320177264,10297,4491,150
320183427,320181393,320191351,9958,4492,150
320197426,320195392,320204401,9009,4493,150
320210476,320208442,320217133,8691,4494,150
320222991,320221174,320232103,10929,4495,150
320238049,320236232,320247022,10790,4496,150
320253186,320251152,320260793,9641,4497,150
320266869,320264834,320273844,9010,4498,150
320279920,320277885,320287210,9325,4499,150
320293286,320291251,320301547,10296,4500,150
320307710,320305676,320315318,9642,4501,150
320321175,320319359,320329970,10611,4502,150
320336133,320334099,320344057,9958,4503,150
320349915,320348098,320357738,9640,4504,150
320363596,320361779,320371104,9325,4505,150
320376962,320375144,320383783,8639,4506,150
320389858,320387824,320397466,9642,4507,150
320403541,320401507,320411465,9958,4508,150
320417323,320415506,320424197,8691,4509,150
320430272,320428238,320436930,8692,4510,150
320442788,320440971,320450875,9904,4511,150
320456950,320454916,320465212,10296,4512,150
320471375,320469341,320478983,9642,4513,150
320484842,320483024,320493637,10613,4514,150
320499799,320497766,320507723,9957,4515,150
320513798,320511764,320521404,9640,4516,150
320527478,320525445,320535401,9956,4517,150
320541476,320539442,320549737,10295,4518,150
320555900,320553866,320563823,9957,4519,150
320569899,320567864,320577823,9959,4520,150
320583681,320581864,320591822,9958,4521,150
320597898,320595863,320606160,10297,4522,150
320612107,320610290,320619614,9324,4523,150
320625472,320623655,320632060,8405,4524,150
320637919,320636101,320645427,9326,4525,150
320651285,320649468,320660080,10612,4526,150
320666026,320664209,320673216,9007,4527,150
320679075,320677257,320688187,10930,4528,150
320694350,320692316,320701957,9641,4529,150
320707816,320705998,320715586,9588,4530,150
320721444,320719627,320729298,9671,4531,150
320735372,320733338,320742347,9009,4532,150
320748206,320746388,320756997,10609,4533,150
320763160,320761126,320769817,8691,4534,150
320775676,320773858,320782581,8723,4535,150
320788657,320786622,320795948,9326,4536,150
320802023,320799989,320810918,10929,4537,150
320817081,320815048,320825005,9957,4538,150
320831079,320829045,320838687,9642,4539,150
320844762,320842728,320852686,9958,4540,150
320858543,320856727,320866684,9957,4541,150
320872543,320870725,320881337,10612,4542,150
320887284,320885467,320895582,10115,4543,150
320901530,320899712,320910008,10296,4544,150
320915954,320914137,320925065,10928,4545,150
320931229,320929195,320938837,9642,4546,150
320944912,320942878,320953807,10929,4547,150
320959971,320957937,320966946,9009,4548,150
320973021,320970987,320979996,9009,4549,150
320985855,320984037,320993996,9959,4550,150
320999854,320998037,321008912,10875,4551,150
321015075,321013041,321023337,10296,4552,150
321029285,321027467,321036160,8693,4553,150
321042235,321040201,321049208,9007,4554,150
321055284,321053249,321062574,9325,4555,150
321068649,321066615,321075306,8691,4556,150
321081165,321079347,321087985,8638,4557,150
321094060,321092026,321102955,10929,4558,150
321109119,321107085,321115776,8691,4559,150
321121851,321119817,321130429,10612,4560,150
321136592,321134558,321145486,10928,4561,150
321151431,321149615,321159572,9957,4562,150
321165647,321163613,321172938,9325,4563,150
321178795,321176979,321186565,9586,4564,150
321192423,321190606,321199613,9007,4565,150
321205471,321203654,321212925,9271,4566,150
321219000,321216966,321227895,10929,4567,150
321233841,321232024,321242160,10136,4568,150
321248324,321246290,321257219,10929,4569,150
321263381,321261348,321271642,10294,4570,150
321277805,321275771,321284463,8692,4571,150
321290537,321288504,321298461,9957,4572,150
321304536,321302502,321312460,9958,4573,150
321318534,321316500,321325824,9324,4574,150
321331682,321329865,321339190,9325,4575,150
321345265,321343231,321353843,10612,4576,150
321360006,321357972,321367614,9642,4577,150
321373472,321371655,321382528,10873,4578,150
321388691,321386658,321396615,9957,4579,150
321402690,321400656,321410614,9958,4580,150
321416689,321414655,321425267,10612,4581,150
321431431,321429396,321439355,9959,4582,150
321445213,321443396,321453617,10221,4583,150
321459781,321457747,321466755,9008,4584,150
321472830,321470796,321479488,8692,4585,150
321485563,321483529,321493824,10295,4586,150
321499770,321497953,321507911,9958,4587,150
321513769,321511952,321520991,9039,4588,150
321527066,321525032,321534990,9958,4589,150
321540848,321539031,321547669,8638,4590,150
321553743,321551709,321560718,9009,4591,150
321566793,321564759,321575687,10928,4592,150
321581634,321579817,321595959,16142,4593,150
321602124,321600090,321609731,9641,4594,150
321615804,321613771,321622778,9007,4595,150
321628853,321626819,321635827,9008,4596,150
321641684,321639868,321649825,9957,4597,150
321655684,321653866,321662559,8693,4598,150
321668634,321666600,321676894,10294,4599,150
321683057,321681023,321689715,8692,4600,150
321695574,321693756,321704084,10328,4601,150
321710248,321708213,321717856,9643,4602,150
321723932,321721897,321731222,9325,4603,150
321737298,321735263,321744906,9643,4604,150
321750764,321748947,321759559,10612,4605,150
321765723,321763689,321773647,9958,4606,150
321779505,321777688,321787329,9641,4607,150
321793187,321791370,321801008,9638,4608,150
321807082,321805049,321815344,10295,4609,150
321821507,321819473,321829430,9957,4610,150
321835288,321833471,321842163,8692,4611,150
321848022,321846204,321855210,9006,4612,150
321861068,321859251,321869155,9904,4613,150
321875013,321873196,321883808,10612,4614,150
321889756,321887938,321898867,10929,4615,150
321904814,321902997,321913293,10296,4616,150
321919457,321917423,321926430,9007,4617,150
321932505,321930471,321939795,9324,4618,150
321945870,321943836,321954448,10612,4619,150
321960612,321958578,321968220,9642,4620,150
321974077,321972261,321982218,9957,4621,150
321988076,321986259,321997133,10874,4622,150
322003297,322001263,322012192,10929,4623,150
322018138,322016321,322025646,9325,4624,150
322031504,322029687,322038726,9039,4625,150
322044801,322042767,322051459,8692,4626,150
322057534,322055500,322065795,10295,4627,150
322071742,322069925,322080040,10115,4628,150
322086203,322084169,322093178,9009,4629,150
322099252,322097219,322108147,10928,4630,150
322114311,322112277,322122890,10613,4631,150
322129055,322127020,322136978,9958,4632,150
322142836,322141019,322151948,10929,4633,150
322158112,322156078,322164769,8691,4634,150
322170627,322168810,322178397,9587,4635,150
322184254,322182438,322192733,10295,4636,150
322198679,322196863,322206819,9956,4637,150
322212678,322210860,322221419,10559,4638,150
322227366,322225549,322235663,10114,4639,150
322241609,322239793,322250087,10294,4640,150
322256251,322254217,322264828,10611,4641,150
322270991,322268957,322277649,8692,4642,150
322283506,322281690,322291983,10293,4643,150
322297930,322296113,322305438,9325,4644,150
322311513,322309479,322318171,8692,4645,150
322324246,322322212,322332170,9958,4646,150
322338029,322336211,322344902,8691,4647,150
322350759,322348943,322357948,9005,4648,150
322363807,322361989,322371346,9357,4649,150
322377422,322375387,322386316,10929,4650,150
322392480,322390446,322400404,9958,4651,150
322406262,322404445,322413137,8692,4652,150
322419212,322417178,322426820,9642,4653,150
322432895,322430861,322439869,9008,4654,150
322445944,322443910,322454205,10295,4655,150
322460369,322458335,322468631,10296,4656,150
322474795,322472761,322482719,9958,4657,150
322488794,322486760,322495767,9007,4658,150
322501625,322499808,322510104,10296,4659,150
322516268,322514234,322524529,10295,4660,150
322530692,322528659,322538616,9957,4661,150
322544474,322542657,322551295,8638,4662,150
322557370,322555336,322564978,9642,4663,150
322570836,322569019,322579631,10612,4664,150
322585793,322583760,322593401,9641,4665,150
322599475,322597441,322608053,10612,4666,150
322614216,322612182,322621191,9009,4667,150
322627049,322625232,322636107,10875,4668,150
322642270,322640237,322649878,9641,4669,150
322655737,322653919,322664794,10875,4670,150
322670741,322668924,322679536,10612,4671,150
322685700,322683666,322694595,10929,4672,150
322700541,322698724,322707890,9166,4673,150
322713966,322711931,322721574,9643,4674,150
322727648,322725615,322736542,10927,4675,150
322742705,322740672,322749679,9007,4676,150
322755754,322753720,322762729,9009,4677,150
322768587,322766770,322777382,10612,4678,150
322783329,322781512,322791153,9641,4679,150
322797011,322795194,322804834,9640,4680,150
322810692,322808875,322818517,9642,4681,150
322824376,322822558,322831884,9326,4682,150
322837742,322835925,322844562,8637,4683,150
322850420,322848603,322857009,8406,4684,150
322863084,322861050,322870375,9325,4685,150
322876450,322874416,322883424,9008,4686,150
322889283,322887465,322898395,10930,4687,150
322904341,322902524,322911849,9325,4688,150
322917923,322915890,322926502,10612,4689,150
322932665,322930631,322939323,8692,4690,150
322945182,322943364,322952636,9272,4691,150
322958494,322956677,322966264,9587,4692,150
322972339,322970305,322980263,9958,4693,150
322986338,322984304,322993313,9009,4694,150
322999171,322997354,323006679,9325,4695,150
323012755,323010720,323021334,10614,4696,150
323027281,323025464,323035578,10114,4697,150
323041742,323039708,323048400,8692,4698,150
323054258,323052441,323061133,8692,4699,150
323067208,323065174,323074182,9008,4700,150
323080040,323078223,323088550,10327,4701,150
323094714,323092680,323101688,9008,4702,150
323107763,323105729,323114420,8691,4703,150
323120280,323118461,323132756,14295,4704,150
323138921,323136886,323145895,9009,4705,150
323151753,323149936,323160865,10929,4706,150
323167029,323164995,323174320,9325,4707,150
323180395,323178361,323187053,8692,4708,150
323192911,323191094,323201315,10221,4709,150
323207478,323205444,323215740,10296,4710,150
323221687,323219870,323228562,8692,4711,150
323234421,323232603,323242276,9673,4712,150
323248135,323246317,323257247,10930,4713,150
323263411,323261377,323271019,9642,4714,150
323277094,323275060,323285356,10296,4715,150
323291520,323289486,323300415,10929,4716,150
323306578,323304545,323313869,9324,4717,150
323319945,323317910,323327235,9325,4718,150
323333094,323331276,323341573,10297,4719,150
323347520,323345703,323356473,10770,4720,150
323362420,323360603,323370244,9641,4721,150
323376102,323374285,323383926,9641,4722,150
323389784,323387967,323396975,9008,4723,150
323403050,323401016,323411312,10296,4724,150
323417259,323415442,323424134,8692,4725,150
323429992,323428175,323438133,9958,4726,150
323443991,323442174,323451814,9640,4727,150
323457672,323455855,323465179,9324,4728,150
323471253,323469220,323479178,9958,4729,150
323485252,323483219,323494147,10928,4730,150
323500311,323498277,323507285,9008,4731,150
323513360,323511326,323521938,10612,4732,150
323528102,323526068,323536026,9958,4733,150
323542101,323540067,323550679,10612,4734,150
323556843,323554809,323565738,10929,4735,150
323571902,323569868,323580481,10613,4736,150
323586428,323584611,323595539,10928,4737,150
323601702,323599668,323608360,8692,4738,150
323614434,323612401,323622696,10295,4739,150
323628642,323626825,323637437,10612,4740,150
323643601,323641567,323650258,8691,4741,150
323656332,323654299,323663623,9324,4742,150
323669698,323667664,323676356,8692,4743,150
323682430,323680397,323691325,10928,4744,150
323697271,323695454,323704779,9325,4745,150
323710854,323708820,323719115,10295,4746,150
323725278,323723245,323733201,9956,4747,150
323739276,323737242,323746884,9642,4748,150
323752741,323750925,323760280,9355,4749,150
323766139,323764321,323773964,9643,4750,150
323780039,323778005,323788617,10612,4751,150
323794781,323792747,323803675,10928,4752,150
323809622,323807805,323816970,9165,4753,150
323822828,323821011,323829703,8692,4754,150
323835778,323833744,323844040,10296,4755,150
323849987,323848170,323858961,10791,4756,150
323864908,323863091,323872416,9325,4757,150
323878274,323876457,323886411,9954,4758,150
323892487,323890452,323901382,10930,4759,150
323907546,323905512,323915154,9642,4760,150
323921229,323919195,323929152,9957,4761,150
323935227,323933193,323943171,9978,4762,150
323949030,323947212,323957509,10297,4763,150
323963455,323961639,323971279,9640,4764,150
323977138,323975320,323985278,9958,4765,150
323991354,323989319,323998962,9643,4766,150
324004821,324003003,324012012,9009,4767,150
324017870,324016053,324026981,10928,4768,150
324033144,324031111,324041405,10294,4769,150
324047352,324045535,324055177,9642,4770,150
324061252,324059218,324067910,8692,4771,150
324073769,324071951,324081223,9272,4772,150
324087299,324085264,324096194,10930,4773,150
324102358,324100324,324111253,10929,4774,150
324117417,324115383,324125678,10295,4775,150
324131626,324129808,324140578,10770,4776,150
324146525,324144708,324155497,10789,4777,150
324161661,324159627,324169923,10296,4778,150
324176087,324174053,324183061,9008,4779,150
324188920,324187102,324197715,10613,4780,150
324203663,324201845,324212299,10454,4781,150
324218246,324216429,324225753,9324,4782,150
324231612,324229794,324238803,9009,4783,150
324244878,324242844,324251536,8692,4784,150
324257611,324255577,324266189,10612,4785,150
324272353,324270319,324279644,9325,4786,150
324285503,324283686,324292409,8723,4787,150
324298484,324296450,324305459,9009,4788,150
324311317,324309500,324320059,10559,4789,150
324326007,324324189,324333515,9326,4790,150
324339590,324337556,324347515,9959,4791,150
324353373,324351556,324360248,8692,4792,150
324366106,324364289,324372695,8406,4793,150
324378554,324376736,324385776,9040,4794,150
324391635,324389818,324400741,10923,4795,150
324406689,324404871,324414037,9166,4796,150
324420113,324418078,324427721,9643,4797,150
324433579,324431762,324441116,9354,4798,150
324447191,324445157,324454799,9642,4799,150
324460657,324458840,324469768,10928,4800,150
324475715,324473898,324482906,9008,4801,150
324488764,324486947,324496904,9957,4802,150
324502762,324500945,324511557,10612,4803,150
324517721,324515687,324526615,10928,4804,150
324532778,324530744,324540069,9325,4805,150
324546143,324544110,324553118,9008,4806,150
324559193,324557159,324566484,9325,4807,150
324572342,324570525,324579795,9270,4808,150
324585871,324583836,324594449,10613,4809,150
324600613,324598579,324608874,10295,4810,150
324614821,324613004,324622486,9482,4811,150
324628561,324626527,324635219,8692,4812,150
324641077,324639260,324649481,10221,4813,150
324655645,324653611,324663906,10295,4814,150
324669852,324668035,324677676,9641,4815,150
324683534,324681717,324691389,9672,4816,150
324697464,324695430,324705726,10296,4817,150
324711891,324709856,324720470,10614,4818,150
324726634,324724600,324734558,9958,4819,150
324740633,324738599,324747290,8691,4820,150
324753365,324751331,324760022,8691,4821,150
324766097,324764063,324774358,10295,4822,150
324780522,324778488,324787497,9009,4823,150
324793572,324791538,324801497,9959,4824,150
324807573,324805538,324816468,10930,4825,150
324822630,324820597,324829605,9008,4826,150
324835463,324833646,324842970,9324,4827,150
324848827,324847011,324857653,10642,4828,150
324863817,324861783,324872079,10296,4829,150
324878243,324876209,324887137,10928,4830,150
324893301,324891267,324901563,10296,4831,150
324907727,324905693,324915335,9642,4832,150
324921194,324919376,324927783,8407,4833,150
324933641,324931824,324942753,10929,4834,150
324948701,324946883,324956998,10115,4835,150
324963161,324961128,324971085,9957,4836,150
324977159,324975126,324985421,10295,4837,150
324991585,324989551,324998559,9008,4838,150
325004417,325002600,325011006,8406,4839,150
325016865,325015047,325024721,9674,4840,150
325030579,325028762,325038087,9325,4841,150
325044162,325042128,325051453,9325,4842,150
325057528,325055494,325066423,10929,4843,150
325072587,325070553,325080848,10295,4844,150
325086795,325084978,325094776,9798,4845,150
325100634,325098817,325107508,8691,4846,150
325113583,325111549,325122162,10613,4847,150
325128108,325126291,325137219,10928,4848,150
325143384,325141349,325150674,9325,4849,150
325156533,325154715,325164071,9356,4850,150
325169930,325168112,325177754,9642,4851,150
325183612,325181795,325192091,10296,4852,150
325198254,325196220,325205544,9324,4853,150
325211402,325209585,325219880,10295,4854,150
325226043,325224010,325232701,8691,4855,150
325238775,325236741,325245749,9008,4856,150
325251606,325249790,325260084,10294,4857,150
325266030,325264213,325273399,9186,4858,150
325279257,325277440,325288369,10929,4859,150
325294533,325292499,325301507,9008,4860,150
325307364,325305548,325315536,9988,4861,150
325321394,325319577,325329219,9642,4862,150
325335294,325333260,325344189,10929,4863,150
325350353,325348319,325357011,8692,4864,150
325362869,325361052,325371273,10221,4865,150
325377438,325375403,325385700,10297,4866,150
325391647,325389830,325400126,10296,4867,150
325406290,325404256,325413264,9008,4868,150
325419123,325417305,325426631,9326,4869,150
325432705,325430672,325440965,10293,4870,150
325446912,325445095,325455053,9958,4871,150
325460911,325459094,325469652,10558,4872,150
325475816,325473782,325482791,9009,4873,150
325488866,325486832,325497444,10612,4874,150
325503608,325501574,325511215,9641,4875,150
325517074,325515256,325525869,10613,4876,150
325531817,325529999,325540115,10116,4877,150
325546279,325544245,325554540,10295,4878,150
325560704,325558670,325568311,9641,4879,150
325574386,325572352,325582647,10295,4880,150
325588811,325586777,325597389,10612,4881,150
325603553,325601519,325610844,9325,4882,150
325616920,325614885,325624210,9325,4883,150
325630285,325628251,325638864,10613,4884,150
325645027,325642994,325651684,8690,4885,150
325657759,325655725,325666337,10612,4886,150
325672500,325670466,325679158,8692,4887,150
325685016,325683199,325692207,9008,4888,150
325698065,325696248,325706153,9905,4889,150
325712227,325710194,325720806,10612,4890,150
325726969,325724936,325734260,9324,4891,150
325740119,325738301,325747309,9008,4892,150
325753167,325751350,325762279,10929,4893,150
325768226,325766409,325776544,10135,4894,150
325782489,325780673,325789364,8691,4895,150
325795439,325793405,325802097,8692,4896,150
325808172,325806138,325814830,8692,4897,150
325820905,325818871,325828196,9325,4898,150
325834272,325832237,325842851,10614,4899,150
325848797,325846980,325856305,9325,4900,150
325862163,325860346,325870566,10220,4901,150
325876513,325874696,325883388,8692,4902,150
325889463,325887429,325896438,9009,4903,150
325902513,325900479,325909804,9325,4904,150
325915879,325913845,325923170,9325,4905,150
325929028,325927211,325937189,9978,4906,150
325943047,325941230,325950238,9008,4907,150
325956313,325954279,325963920,9641,4908,150
325969778,325967961,325977970,10009,4909,150
325983917,325982100,325992256,10156,4910,150
325998420,325996386,326006344,9958,4911,150
326012202,326010385,326019022,8637,4912,150
326024880,326023063,326033052,9989,4913,150
326039127,326037093,326047706,10613,4914,150
326053870,326051836,326062449,10613,4915,150
326068613,326066579,326077190,10611,4916,150
326083354,326081320,326090328,9008,4917,150
326096186,326094369,326105298,10929,4918,150
326111462,326109428,326119724,10296,4919,150
326125888,326123854,326134149,10295,4920,150
326140314,326138279,326149209,10930,4921,150
326155373,326153339,326162348,9009,4922,150
326168205,326166389,326175392,9003,4923,150
326181467,326179433,326188125,8692,4924,150
326194199,326192166,326201806,9640,4925,150
326207881,326205847,326215488,9641,4926,150
326221347,326219529,326228854,9325,4927,150
326234929,326232895,326243506,10611,4928,150
326249670,326247636,326258564,10928,4929,150
326264511,326262694,326272674,9980,4930,150
326278532,326276715,326287327,10612,4931,150
326293491,326291457,326301415,9958,4932,150
326307273,326305456,326315098,9642,4933,150
326321173,326319139,326327831,8692,4934,150
326333906,326331872,326341512,9640,4935,150
326347370,326345553,326355849,10296,4936,150
326362013,326359979,326370908,10929,4937,150
326376855,326375038,326385966,10928,4938,150
326392130,326390096,326401025,10929,4939,150
326406971,326405154,326415450,10296,4940,150
326421396,326419579,326429221,9642,4941,150
326435296,326433262,326442587,9325,4942,150
326448662,326446628,326457241,10613,4943,150
326463404,326461371,326472298,10927,4944,150
326478462,326476428,326485436,9008,4945,150
326491511,326489477,326498486,9009,4946,150
326504561,326502527,326512823,10296,4947,150
326518986,326516952,326526594,9642,4948,150
326532452,326530635,326539960,9325,4949,150
326546036,326544001,326553011,9010,4950,150
326558869,326557052,326567010,9958,4951,150
326572869,326571051,326580640,9589,4952,150
326586498,326584681,326594323,9642,4953,150
326600181,326598364,326607002,8638,4954,150
326613076,326611043,326621001,9958,4955,150
326626860,326625042,326634052,9010,4956,150
326640127,326638093,326647101,9008,4957,150
326652959,326651142,326660414,9272,4958,150
326666271,326664455,326673177,8722,4959,150
326679252,326677218,326688147,10929,4960,150
326694311,326692277,326702572,10295,4961,150
326708736,326706702,326716027,9325,4962,150
326722102,326720068,326729393,9325,4963,150
326735468,326733434,326742126,8692,4964,150
326747985,326746167,326755492,9325,4965,150
326761566,326759533,326770145,10612,4966,150
326776309,326774275,326783916,9641,4967,150
326789774,326787957,326798569,10612,4968,150
326804733,326802699,326813628,10929,4969,150
326819576,326817758,326826292,8534,4970,150
326832367,326830333,326839974,9641,4971,150
326845833,326844016,326854627,10611,4972,150
326860791,326858757,326869370,10613,4973,150
326875317,326873500,326883796,10296,4974,150
326889960,326887926,326898855,10929,4975,150
326905018,326902984,326912626,9642,4976,150
326918701,326916667,326926962,10295,4977,150
326933125,326931092,326940415,9323,4978,150
326946490,326944456,326954414,9958,4979,150
326960488,326958455,326967146,8691,4980,150
326973004,326971187,326981830,10643,4981,150
326987994,326985960,326996573,10613,4982,150
327002520,327000703,327009236,8533,4983,150
327015311,327013277,327022602,9325,4984,150
327028678,327026643,327035969,9326,4985,150
327041827,327040010,327049999,9989,4986,150
327055856,327054040,327063996,9956,4987,150
327070071,327068037,327077679,9642,4988,150
327083537,327081720,327092649,10929,4989,150
327098813,327096779,327105788,9009,4990,150
327111863,327109829,327119471,9642,4991,150
327125329,327123512,327134441,10929,4992,150
327140388,327138571,327147896,9325,4993,150
327153754,327151937,327160890,8953,4994,150
327166748,327164931,327173622,8691,4995,150
327179480,327177663,327186701,9038,4996,150
327192776,327190742,327200067,9325,4997,150
327206142,327204108,327213750,9642,4998,150
327219609,327217791,327226484,8693,4999,150
327232343,327230526,327239796,9270,5000,150
327246028,327243837,327260042,16205,1,175
327265985,327264012,327279702,15690,2,175
327285755,327283563,327298820,15257,3,175
327304872,327302681,327318906,16225,4,175
327324857,327322883,327339209,16326,5,175
327345261,327343070,327360879,17809,6,175
327366931,327364741,327379362,14621,7,175
327385414,327383223,327398479,15256,8,175
327404531,327402340,327418883,16543,9,175
327424936,327422745,327437368,14623,10,175
327443340,327441365,327457988,16623,11,175
327464112,327462138,327479414,17276,12,175
327485556,327483365,327497988,14623,13,175
327504104,327502129,327518772,16643,14,175
327524770,327522796,327539101,16305,15,175
327545243,327543052,327560883,17831,16,175
327566920,327564946,327582200,17254,17,175
327588251,327586276,327602583,16307,18,175
327608725,327606534,327621790,15256,19,175
327627766,327625792,327641148,15356,20,175
327647290,327645099,327661938,16839,21,175
327667929,327665955,327682596,16641,22,175
327688738,327686547,327702118,15571,23,175
327708258,327706067,327721638,15571,24,175
327727767,327725793,327741779,15986,25,175
327747920,327745728,327759718,13990,26,175
327765836,327763862,327781791,17929,27,175
327787842,327785867,327800273,14406,28,175
327806414,327804223,327819795,15572,29,175
327825820,327823846,327838251,14405,30,175
327844257,327842282,327858608,16326,31,175
327864749,327862558,327878446,15888,32,175
327884560,327882586,327899860,17274,33,175
327905967,327903993,327920298,16305,34,175
327926311,327924337,327940324,15987,35,175
327946465,327944274,327960501,16227,36,175
327966506,327964532,327981490,16958,37,175
327987414,327985440,328002299,16859,38,175
328008441,328006249,328023741,17492,39,175
328029724,328027750,328045025,17275,40,175
328051009,328049035,328065677,16642,41,175
328071819,328069627,328083934,14307,42,175
328089978,328088004,328103042,15038,43,175
328109182,328106992,328122246,15254,44,175
328128246,328126272,328140675,14403,45,175
328146651,328144676,328161002,16326,46,175
328167039,328165064,328179786,14722,47,175
328185709,328183735,328199379,15644,48,175
328205521,328203329,328219851,16522,49,175
328225991,328223801,328240004,16203,50,175
328246004,328244030,328260651,16621,51,175
328266576,328264601,328282168,17567,52,175
328288290,328286315,328300722,14407,53,175
328306698,328304724,328321999,17275,54,175
328327924,328325949,328342544,16595,55,175
328348671,328346696,328361734,15038,56,175
328367712,328365738,328379826,14088,57,175
328385874,328383900,328400205,16305,58,175
328406181,328404207,328419561,15354,59,175
328425546,328423571,328439243,15672,60,175
328445384,328443193,328459398,16205,61,175
328465539,328463348,328479573,16225,62,175
328485693,328483718,328500045,16327,63,175
328506027,328504053,328519724,15671,64,175
328525647,328523673,328540582,16909,65,175
328546626,328544652,328560956,16304,66,175
328566935,328564960,328580315,15355,67,175
328586457,328584265,328600492,16227,68,175
328606476,328604502,328619857,15355,69,175
328625998,328623807,328640329,16522,70,175
328646377,328644403,328659126,14723,71,175
328665099,328663124,328680083,16959,72,175
328686073,328684099,328702028,17929,73,175
328708141,328706166,328723441,17275,74,175
328729413,328727439,328743765,16326,75,175
328749906,328747715,328762020,14305,76,175
328768028,328766054,328781746,15692,77,175
328787874,328785900,328801572,15672,78,175
328807610,328805636,328822573,16937,79,175
328828715,328826524,328842097,15573,80,175
328848022,328846047,328861303,15256,81,175
328867357,328865383,328881055,15672,82,175
328886979,328885005,328900650,15645,83,175
328906621,328904647,328919053,14406,84,175
328924978,328923003,328937698,14695,85,175
328943818,328941843,328955616,13773,86,175
328961758,328959566,328975455,15889,87,175
328981506,328979532,328993937,14405,88,175
328999860,328997886,329014500,16614,89,175
329020551,329018576,329035218,16642,90,175
329041359,329039168,329055710,16542,91,175
329061724,329059749,329074156,14407,92,175
329080272,329078298,329093991,15693,93,175
329100037,329098062,329115676,17614,94,175
329121817,329119626,329136169,16543,95,175
329142189,329140215,329155253,15038,96,175
329161394,329159203,329175746,16543,97,175
329181729,329179755,329197030,17275,98,175
329203076,329201102,329215824,14722,99,175
329221840,329219867,329236191,16324,100,175
329242315,329240340,329256351,16011,101,175
329262428,329260453,329275808,15355,102,175
329282038,329279847,329295755,15908,103,175
329301855,329299880,329314919,15039,104,175
329321024,329319050,329335058,16008,105,175
329341184,329339210,329354565,15355,106,175
329360670,329358695,329374050,15355,107,175
329380281,329378089,329393979,15890,108,175
329400087,329398113,329413784,15671,109,175
329419916,329417941,329433296,15355,110,175
329439405,329437430,329454707,17277,111,175
329460831,329458857,329475162,16305,112,175
329481300,329479325,329496265,16940,113,175
329502495,329500304,329516193,15889,114,175
329522330,329520356,329535711,15355,115,175
329541842,329539868,329557144,17276,116,175
329563268,329561293,329575700,14407,117,175
329581929,329579738,329595311,15573,118,175
329601446,329599471,329616747,17276,119,175
329622761,329620786,329636727,15941,120,175
329642831,329640857,329656211,15354,121,175
329662301,329660327,329675683,15356,122,175
329681696,329679722,329695609,15887,123,175
329701685,329699710,329715382,15672,124,175
329721611,329719421,329735624,16203,125,175
329741854,329739663,329754601,14938,126,175
329760744,329758769,329776045,17276,127,175
329782058,329780084,329796288,16204,128,175
329802415,329800439,329817717,17278,129,175
329823857,329821883,329837237,15354,130,175
329843466,329841275,329858451,17176,131,175
329864552,329862577,329878882,16305,132,175
329885002,329883028,329899352,16324,133,175
329905412,329903438,329920080,16642,134,175
329926201,329924226,329941502,17276,135,175
329947605,329945630,329962251,16621,136,175
329968265,329966290,329983751,17461,137,175
329989895,329987920,330004563,16643,138,175
330010691,330008717,330025359,16642,139,175
330031421,330029447,330045435,15988,140,175
330051448,330049474,330066967,17493,141,175
330073199,330071007,330086264,15257,142,175
330092405,330090430,330107052,16622,143,175
330113142,330111167,330128759,17592,144,175
330134819,330132845,330150119,17274,145,175
330156133,330154158,330169414,15256,146,175
330175545,330173571,330190213,16642,147,175
330196443,330194252,330209846,15594,148,175
330216075,330213885,330228821,14936,149,175
330234884,330232910,330247631,14721,150,175
330253861,330251670,330267558,15888,151,175
330273697,330271722,330286761,15039,152,175
330292820,330290846,330306856,16010,153,175
330313086,330310895,330327121,16226,154,175
330333242,330331268,330348860,17592,155,175
330354993,330353018,330368690,15672,156,175
330374798,330372824,330389129,16305,157,175
330395359,330393168,330410027,16859,158,175
330416128,330414154,330429508,15354,159,175
330435737,330433546,330449435,15889,160,175
330455665,330453474,330468730,15256,161,175
330474960,330472769,330488023,15254,162,175
330494131,330492157,330510065,17908,163,175
330516296,330514105,330529358,15253,164,175
330535487,330533512,330547286,13774,165,175
330553411,330551437,330567426,15989,166,175
330573562,330571589,330589834,18245,167,175
330595977,330594003,330609357,15354,168,175
330615587,330613396,330631521,18125,169,175
330637753,330635561,330653709,18148,170,175
330659827,330657853,330673207,15354,171,175
330679220,330677246,330693440,16194,172,175
330699568,330697594,330714235,16641,173,175
330720465,330718275,330733867,15592,174,175
330740098,330737907,330754429,16522,175,175
330760560,330758586,330774596,16010,176,175
330780684,330778710,330792482,13772,177,175
330798590,330796615,330811970,15355,178,175
330818073,330816098,330834029,17931,179,175
330840042,330838068,330856496,18428,180,175
330862598,330860623,330874713,14090,181,175
330880942,330878752,330894956,16204,182,175
330901029,330899054,330915696,16642,183,175
330921927,330919736,330935645,15909,184,175
330941875,330939684,330956860,17176,185,175
330963091,330960900,330976810,15910,186,175
330982938,330980963,330997606,16643,187,175
331003665,331001692,331019283,17591,188,175
331025514,331023323,331039865,16542,189,175
331046096,331043905,331061079,17174,190,175
331067146,331065172,331081793,16621,191,175
331088024,331085833,331101722,15889,192,175
331107830,331105856,331122183,16327,193,175
331128301,331126327,331148182,21855,194,175
331154273,331152299,331169574,17275,195,175
331175691,331173717,331190993,17276,196,175
331197120,331195145,331212106,16961,197,175
331218338,331216146,331233957,17811,198,175
331240080,331238106,331254728,16622,199,175
331260959,331258768,331273074,14306,200,175
331279305,331277114,331291101,13987,201,175
331297219,331295245,331311549,16304,202,175
331317565,331315589,331333682,18093,203,175
331339779,331337805,331352526,14721,204,175
331358646,331356671,331372660,15989,205,175
331378735,331376760,331393720,16960,206,175
331399951,331397760,331412066,14306,207,175
331418080,331416106,331432340,16234,208,175
331438437,331436462,331452471,16009,209,175
331458702,331456511,331472084,15573,210,175
331478226,331476251,331491289,15038,211,175
331497386,331495412,331510765,15353,212,175
331516909,331514935,331532190,17255,213,175
331538262,331536288,331553881,17593,214,175
331560112,331557921,331575413,17492,215,175
331581428,331579453,331594710,15257,216,175
331600940,331598750,331616242,17492,217,175
331622376,331620402,331637994,17592,218,175
331644123,331642149,331658452,16303,219,175
331664683,331662493,331678718,16225,220,175
331684949,331682758,331697064,14306,221,175
331703295,331701104,331715093,13989,222,175
331721154,331719180,331734852,15672,223,175
331740866,331738892,331754781,15889,224,175
331760892,331758917,331773323,14406,225,175
331779554,331777363,331792302,14939,226,175
331798413,331796439,331811160,14721,227,175
331817282,331815306,331830980,15674,228,175
331837211,331835020,331853167,18147,229,175
331859226,331857252,331871973,14721,230,175
331878072,331876097,331892424,16327,231,175
331898438,331896464,331914262,17798,232,175
331920396,331918421,331935063,16642,233,175
331941143,331939169,331955158,15989,234,175
331961390,331959198,331974454,15256,235,175
331980518,331978542,331993583,15041,236,175
331999720,331997746,332013734,15988,237,175
332019802,332017827,332034449,16622,238,175
332040681,332038489,332053746,15257,239,175
332059977,332057786,332075595,17809,240,175
332081741,332079766,332096725,16959,241,175
332102785,332100811,332116800,15989,242,175
332123031,332120840,332135780,14940,243,175
332141917,332139942,332156246,16304,244,175
332162262,332160286,332177092,16806,245,175
332183323,332181132,332197337,16205,246,175
332203472,332201498,332219427,17929,247,175
332225657,332223467,332239353,15886,248,175
332245420,332243446,332257219,13773,249,175
332263341,332261367,332278324,16957,250,175
332284463,332282489,332299447,16958,251,175
332305461,332303487,332319059,15572,252,175
332325073,332323099,332340262,17163,253,175
332346493,332344303,332359874,15571,254,175
332365978,332364003,332378410,14407,255,175
332384641,332382450,332399289,16839,256,175
332405521,332403329,332418269,14940,257,175
332424500,332422309,332436932,14623,258,175
332443037,332441063,332457685,16622,259,175
332463816,332461841,332477513,15672,260,175
332483745,332481553,332498413,16860,261,175
332504533,332502559,332519497,16938,262,175
332525637,332523663,332539335,15672,263,175
332545567,332543375,332558631,15256,264,175
332564775,332562801,332581048,18247,265,175
332587130,332585155,332601165,16010,266,175
332607276,332605301,332619075,13774,267,175
332625089,332623115,332640976,17861,268,175
332647206,332645016,332662824,17808,269,175
332669055,332666864,332684356,17492,270,175
332690448,332688475,332702562,14087,271,175
332708646,332706672,332723314,16642,272,175
332729404,332727430,332744073,16643,273,175
332750305,332748114,332764635,16521,274,175
332770711,332768736,332785991,17255,275,175
332792130,332790155,332808065,17910,276,175
332814188,332812214,332829489,17275,277,175
332835549,332833575,332850534,16959,278,175
332856765,332854574,332869829,15255,279,175
332876059,332873868,332890411,16543,280,175
332896478,332894504,332909542,15038,281,175
332915640,332913666,332931258,17592,282,175
332937333,332935358,332951685,16327,283,175
332957699,332955725,332971580,15855,284,175
332977810,332975619,332993428,17809,285,175
332999543,332997568,333014507,16939,286,175
333020571,333018597,333035556,16959,287,175
333041787,333039596,333053900,14304,288,175
333059998,333058023,333075300,17277,289,175
333081417,333079442,333095432,15990,290,175
333101540,333099566,333113655,14089,291,175
333119794,333117820,333133176,15356,292,175
333139406,333137215,333153440,16225,293,175
333159671,333157480,333174340,16860,294,175
333180409,333178435,333194107,15672,295,175
333200222,333198247,333214869,16622,296,175
333220995,333219021,333235959,16938,297,175
333242029,333240056,333258279,18223,298,175
333264421,333262447,333280375,17928,299,175
333286389,333284415,333301886,17471,300,175
333308117,333305927,333323419,17492,301,175
333329563,333327588,333341677,14089,302,175
333347907,333345716,333360338,14622,303,175
333366352,333364378,333379632,15254,304,175
333385754,333383780,333399789,16009,305,175
333406021,333403830,333420667,16837,306,175
333426751,333424776,333441082,16306,307,175
333447313,333445122,333463269,18147,308,175
333469371,333467397,333482434,15037,309,175
333488666,333486474,333502681,16207,310,175
333508815,333506841,333525066,18225,311,175
333531175,333529201,333545505,16304,312,175
333551629,333549655,333565959,16304,313,175
333572095,333570120,333587059,16939,314,175
333593290,333591099,333606988,15889,315,175
333613072,333611098,333627403,16305,316,175
333633541,333631567,333647553,15986,317,175
333653696,333651722,333669315,17593,318,175
333675452,333673479,333689149,15670,319,175
333695225,333693251,333709557,16306,320,175
333715681,333713707,333730012,16305,321,175
333736150,333734176,333749848,15672,322,175
333756079,333753888,333770115,16227,323,175
333776219,333774245,333790888,16643,324,175
333797008,333795033,333810706,15673,325,175
333816767,333814792,333829831,15039,326,175
333836062,333833871,333850392,16521,327,175
333856624,333854432,333871926,17494,328,175
333878158,333875966,333892488,16522,329,175
333898573,333896599,333912587,15988,330,175
333918694,333916720,333933680,16960,331,175
333939756,333937782,333952504,14722,332,175
333958736,333956544,333972750,16206,333,175
333978888,333976914,333993536,16622,334,175
333999632,333997658,334013963,16305,335,175
334020195,334018004,334033576,15572,336,175
334039591,334037616,334053472,15856,337,175
334059617,334057643,334072998,15355,338,175
334079229,334077038,334094847,17809,339,175
334100979,334099005,334114676,15671,340,175
334120783,334118809,334134481,15672,341,175
334140544,334138570,334154874,16304,342,175
334160965,334158991,334175295,16304,343,175
334181439,334179465,334196108,16643,344,175
334202339,334200148,334216037,15889,345,175
334222120,334220145,334236788,16643,346,175
334242893,334240918,334255641,14723,347,175
334261772,334259798,334277073,17275,348,175
334283173,334281199,334296576,15377,349,175
334302682,334300707,334318955,18248,350,175
334325187,334322996,334340151,17155,351,175
334346286,334344312,334360300,15988,352,175
334366439,334364465,334380475,16010,353,175
334386587,334384613,334400285,15672,354,175
334406515,334404325,334418629,14304,355,175
334424858,334422668,334437923,15255,356,175
334444062,334442087,334458076,15989,357,175
334464154,334462181,334477534,15353,358,175
334483765,334481574,334499384,17810,359,175
334505615,334503424,334519629,16205,360,175
334525644,334523670,334541425,17755,361,175
334547560,334545586,334561913,16327,362,175
334567996,334566022,334583951,17929,363,175
334590076,334588101,334602507,14406,364,175
334608595,334606621,334622291,15670,365,175
334628307,334626331,334643488,17157,366,175
334649719,334647528,334663100,15572,367,175
334669227,334667253,334682925,15672,368,175
334689037,334687063,334704655,17592,369,175
334710887,334708695,334725555,16860,370,175
334731788,334729596,334745484,15888,371,175
334751599,334749624,334765317,15693,372,175
334771331,334769357,334784295,14938,373,175
334790525,334788334,334804223,15889,374,175
334810454,334808263,334824172,15909,375,175
334830276,334828302,334844627,16325,376,175
334850697,334848723,334863762,15039,377,175
334869840,334867866,334881954,14088,378,175
334888185,334885994,334902833,16839,379,175
334909063,334906873,334923711,16838,380,175
334929725,334927751,334943659,15908,381,175
334949890,334947699,334964221,16522,382,175
334970453,334968262,334982567,14305,383,175
334988647,334986672,335002978,16306,384,175
335009210,335007019,335023858,16839,385,175
335030001,335028027,335044331,16304,386,175
335050463,335048489,335065765,17276,387,175
335071997,335069806,335085378,15572,388,175
335091522,335089548,335104903,15355,389,175
335111026,335109051,335125060,16009,390,175
335131190,335129215,335145204,15989,391,175
335151435,335149244,335165152,15908,392,175
335171383,335169192,335185398,16206,393,175
335191487,335189512,335205522,16010,394,175
335211640,335209666,335225020,15354,395,175
335231146,335229172,335245180,16008,396,175
335251315,335249340,335265668,16328,397,175
335271781,335269807,335284213,14406,398,175
335290315,335288340,335303064,14724,399,175
335309295,335307104,335322993,15889,400,175
335329224,335327033,335344525,17492,401,175
335350585,335348610,335364282,15672,402,175
335370345,335368370,335385645,17275,403,175
335391718,335389743,335405100,15357,404,175
335411331,335409140,335424079,14939,405,175
335430309,335428119,335442740,14621,406,175
335448863,335446889,335462898,16009,407,175
335469130,335466938,335483143,16205,408,175
335489279,335487305,335503631,16326,409,175
335509721,335507746,335525993,18247,410,175
335532008,335530034,335544973,14939,411,175
335551099,335549125,335564795,15670,412,175
335570896,335568923,335585544,16621,413,175
335591649,335589674,335607266,17592,414,175
335613338,335611364,335628639,17275,415,175
335634752,335632777,335648766,15989,416,175
335654828,335652853,335668864,16011,417,175
335674961,335672986,335688363,15377,418,175
335694435,335692460,335708448,15988,419,175
335714564,335712589,335730520,17931,420,175
335736750,335734560,335750130,15570,421,175
335756359,335754169,335770055,15886,422,175
335776286,335774095,335791588,17493,423,175
335797819,335795628,335811200,15572,424,175
335817308,335815334,335830690,15356,425,175
335836751,335834777,335850132,15355,426,175
335856362,335854172,335870058,15886,427,175
335876201,335874227,335890553,16326,428,175
335896695,335894721,335909442,14721,429,175
335915672,335913481,335928420,14939,430,175
335934487,335932513,335949133,16620,431,175
335955147,335953173,335967509,14336,432,175
335973631,335971657,335988932,17275,433,175
335995017,335993043,336009031,15988,434,175
336015110,336013135,336029145,16010,435,175
336035376,336033185,336049074,15889,436,175
336055185,336053211,336069537,16326,437,175
336075596,336073622,336088977,15355,438,175
336095207,336093016,336107322,14306,439,175
336113456,336111481,336125571,14090,440,175
336131802,336129611,336144865,15254,441,175
336150936,336148961,336164969,16008,442,175
336171200,336169009,336186501,17492,443,175
336192606,336190631,336205986,15355,444,175
336212216,336210025,336225280,15255,445,175
336231375,336229400,336246022,16622,446,175
336252109,336250135,336264540,14405,447,175
336270770,336268579,336284805,16226,448,175
336290939,336288964,336304974,16010,449,175
336311205,336309014,336327161,18147,450,175
336333392,336331201,336347723,16522,451,175
336353954,336351763,336367968,16205,452,175
336374097,336372123,336387161,15038,453,175
336393226,336391252,336406607,15355,454,175
336412674,336410700,336426689,15989,455,175
336432790,336430816,336446824,16008,456,175
336452838,336450864,336468671,17807,457,175
336474802,336472828,336489787,16959,458,175
336495864,336493890,336509245,15355,459,175
336515308,336513334,336530293,16959,460,175
336536523,336534333,336549904,15571,461,175
336556134,336553943,336570147,16204,462,175
336576278,336574304,336591263,16959,463,175
336597404,336595429,336610152,14723,464,175
336616220,336614246,336629285,15039,465,175
336635422,336633447,336650724,17277,466,175
336656862,336654887,336670558,15671,467,175
336676788,336674598,336691751,17153,468,175
336697984,336695791,336711049,15258,469,175
336717180,336715205,336729294,14089,470,175
336735400,336733426,336749731,16305,471,175
336755962,336753771,336769996,16225,472,175
336776132,336774158,336792087,17929,473,175
336798220,336796246,336810334,14088,474,175
336816463,336814488,336829210,14722,475,175
336835331,336833357,336848079,14722,476,175
336854092,336852119,336868956,16837,477,175
336875021,336873046,336889669,16623,478,175
336895805,336893830,336910789,16959,479,175
336916900,336914926,336931884,16958,480,175
336937985,336936011,336952020,16009,481,175
336958252,336956060,336972265,16205,482,175
336978350,336976376,336992048,15672,483,175
336998134,336996160,337013436,17276,484,175
337019498,337017524,337034166,16642,485,175
337040179,337038206,337055686,17480,486,175
337061809,337059835,337075526,15691,487,175
337081756,337079565,337095137,15572,488,175
337101368,337099177,337116014,16837,489,175
337122088,337120114,337136101,15987,490,175
337142332,337140141,337156051,15910,491,175
337162113,337160138,337174226,14088,492,175
337180456,337178265,337193838,15573,493,175
337199972,337197997,337213670,15673,494,175
337219783,337217809,337233481,15672,495,175
337239590,337237616,337252991,15375,496,175
337259222,337257031,337273868,16837,497,175
337280099,337277908,337293795,15887,498,175
337300025,337297834,337313089,15255,499,175
337319320,337317129,337338884,21755,500,175
337345115,337342924,337360416,17492,501,175
337366483,337364508,337378914,14406,502,175
337385146,337382954,337399794,16840,503,175
337405919,337403945,337419933,15988,504,175
337426006,337424032,337440674,16642,505,175
337446689,337444714,337459971,15257,506,175
337466080,337464107,337479776,15669,507,175
337485908,337483934,337500871,16937,508,175
337506886,337504911,337520154,15243,509,175
337526279,337524305,337541897,17592,510,175
337547912,337545937,337562490,16553,511,175
337568721,337566530,337583072,16542,512,175
337589305,337587113,337604606,17493,513,175
337610838,337608647,337626773,18126,514,175
337632834,337630860,337645899,15039,515,175
337652130,337649938,337664878,14940,516,175
337670965,337668991,337685315,16324,517,175
337691328,337689355,337705262,15907,518,175
337711373,337709398,337725070,15672,519,175
337731176,337729202,337744557,15355,520,175
337750663,337748689,337763725,15036,521,175
337769955,337767764,337786226,18462,522,175
337792457,337790266,337807442,17176,523,175
337813457,337811482,337827718,16236,524,175
337833779,337831804,337847476,15672,525,175
337853707,337851516,337868059,16543,526,175
337874187,337872213,337888222,16009,527,175
337894453,337892262,337908784,16522,528,175
337914848,337912874,337927596,14722,529,175
337933698,337931724,337948683,16959,530,175
337954745,337952771,337969730,16959,531,175
337975867,337973892,337990196,16304,532,175
337996320,337994346,338008751,14405,533,175
338014892,338012918,338028590,15672,534,175
338034820,338032629,338046935,14306,535,175
338052998,338051023,338068932,17909,536,175
338075028,338073054,338088430,15376,537,175
338094539,338092565,338108552,15987,538,175
338114566,338112592,338131055,18463,539,175
338137118,338135143,338151131,15988,540,175
338157228,338155253,338171579,16326,541,175
338177669,338175694,338192336,16642,542,175
338198477,338196503,338211859,15356,543,175
338217956,338215981,338230702,14721,544,175
338236837,338234862,338249901,15039,545,175
338256032,338254058,338269411,15353,546,175
338275511,338273537,338288575,15038,547,175
338294588,338292614,338308818,16204,548,175
338314884,338312909,338328284,15375,549,175
338334423,338332449,338347803,15354,550,175
338353934,338351960,338368581,16621,551,175
338374715,338372741,338388730,15989,552,175
338394854,338392880,338408867,15987,553,175
338414990,338413016,338428054,15038,554,175
338434285,338432094,338448320,16226,555,175
338454462,338452489,338470080,17591,556,175
338476164,338474189,338490832,16643,557,175
338496974,338495000,338511009,16009,558,175
338517240,338515049,338531273,16224,559,175
338537505,338535313,338550569,15256,560,175
338556799,338554608,338572733,18125,561,175
338578871,338576897,338593539,16642,562,175
338599613,338597639,338613627,15988,563,175
338619858,338617666,338634504,16838,564,175
338640736,338638545,338652851,14306,565,175
338658960,338656986,338672023,15037,566,175
338678084,338676110,338691148,15038,567,175
338697273,338695298,338709388,14090,568,175
338715520,338713547,338730504,16957,569,175
338736520,338734545,338750402,15857,570,175
338756462,338754487,338771764,17277,571,175
338777841,338775867,338791539,15672,572,175
338797552,338795578,338811836,16258,573,175
338817963,338815988,338833581,17593,574,175
338839699,338837724,338852129,14405,575,175
338858227,338856252,338870659,14407,576,175
338876891,338874699,338892193,17494,577,175
338898334,338896360,338912031,15671,578,175
338918103,338916129,338932117,15988,579,175
338938237,338936261,338954193,17932,580,175
338960208,338958233,338974406,16173,581,175
338980475,338978500,338993856,15356,582,175
338999870,338997896,339013456,15560,583,175
339019549,339017575,339033247,15672,584,175
339039367,339037393,339053381,15988,585,175
339059460,339057486,339073473,15987,586,175
339079587,339077612,339092968,15356,587,175
339099078,339097104,339112796,15692,588,175
339118885,339116910,339132582,15672,589,175
339138682,339136707,339153034,16327,590,175
339159049,339157074,339172319,15245,591,175
339178441,339176466,339194375,17909,592,175
339200516,339198542,339214846,16304,593,175
339221078,339218886,339235092,16206,594,175
339241197,339239223,339256835,17612,595,175
339262973,339261000,339277008,16008,596,175
339283073,339281098,339299029,17931,597,175
339305138,339303164,339317251,14087,598,175
339323481,339321290,339336229,14939,599,175
339342323,339340349,339356021,15672,600,175
339362145,339360170,339376179,16009,601,175
339382312,339380337,339396981,16644,602,175
339403053,339401078,339416771,15693,603,175
339422901,339420927,339438202,17275,604,175
339444433,339442242,339457814,15572,605,175
339463955,339461981,339478939,16958,606,175
339485001,339483027,339499036,16009,607,175
339505178,339503204,339519529,16325,608,175
339525673,339523698,339537470,13772,609,175
339543592,339541618,339556656,15038,610,175
339562726,339560752,339576105,15353,611,175
339582228,339580254,339597212,16958,612,175
339603443,339601252,339619399,18147,613,175
339625630,339623439,339639645,16206,614,175
339645761,339643787,339660409,16622,615,175
339666518,339664544,339680553,16009,616,175
339686649,339684675,339700663,15988,617,175
339706786,339704812,339720504,15692,618,175
339726629,339724655,339740664,16009,619,175
339746727,339744753,339759791,15038,620,175
339765911,339763937,339780242,16305,621,175
339786306,339784332,339799371,15039,622,175
339805493,339803519,339819211,15692,623,175
339825321,339823347,339840961,17614,624,175
339847053,339845079,339861067,15988,625,175
339867183,339865209,339880880,15671,626,175
339886964,339884990,339899713,14723,627,175
339905854,339903880,339921493,17613,628,175
339927573,339925598,339940638,15040,629,175
339946764,339944790,339959512,14722,630,175
339965744,339963552,339979778,16226,631,175
339985849,339983875,339998913,15038,632,175
340005039,340003064,340018104,15040,633,175
340024221,340022246,340040493,18247,634,175
340046565,340044591,340060895,16304,635,175
340067127,340064935,340081142,16207,636,175
340087251,340085276,340102236,16960,637,175
340108345,340106371,340121093,14722,638,175
340127217,340125243,340140914,15671,639,175
340147145,340144954,340162447,17493,640,175
340168679,340166488,340183030,16542,641,175
340189121,340187148,340202502,15354,642,175
340208733,340206542,340222747,16205,643,175
340228979,340226787,340240778,13991,644,175
340246791,340244817,340261360,16543,645,175
340267440,340265466,340279872,14406,646,175
340285988,340284014,340298420,14406,647,175
340304650,340302459,340318369,15910,648,175
340324385,340322409,340340208,17799,649,175
340346333,340344359,340361318,16959,650,175
340367461,340365487,340382762,17275,651,175
340388993,340386802,340403344,16542,652,175
340409473,340407499,340423488,15989,653,175
340429719,340427528,340442782,15254,654,175
340448911,340446936,340462946,16010,655,175
340469025,340467051,340482723,15672,656,175
340488954,340486763,340503938,17175,657,175
340510169,340507978,340524500,16522,658,175
340530623,340528649,340544637,15988,659,175
340550696,340548722,340564731,16009,660,175
340570871,340568897,340584273,15376,661,175
340590288,340588313,340604203,15890,662,175
340610305,340608331,340622418,14087,663,175
340628536,340626562,340642550,15988,664,175
340648565,340646590,340662796,16206,665,175
340668922,340666947,340681353,14406,666,175
340687477,340685503,340701806,16303,667,175
340708038,340705847,340721418,15571,668,175
340727649,340725458,340742635,17177,669,175
340748738,340746763,340760853,14090,670,175
340767083,340764893,340778881,13988,671,175
340785112,340782921,340798832,15911,672,175
340804955,340802981,340818020,15039,673,175
340824142,340822168,340838156,15988,674,175
340844221,340842247,340858889,16642,675,175
340865119,340862929,340880421,17492,676,175
340886652,340884461,340901952,17491,677,175
340908066,340906091,340921764,15673,678,175
340927840,340925866,340944113,18247,679,175
340950344,340948153,340964991,16838,680,175
340971073,340969099,340985109,16010,681,175
340991239,340989264,341005252,15988,682,175
341011482,341009292,341024547,15255,683,175
341030560,341028586,341046044,17458,684,175
341052059,341050084,341065625,15541,685,175
341071750,341069776,341086081,16305,686,175
341092312,341090121,341106643,16522,687,175
341112728,341110753,341126447,15694,688,175
341132571,341130597,341145952,15355,689,175
341152182,341149991,341166195,16204,690,175
341172426,341170235,341186777,16542,691,175
341193008,341190817,341206072,15255,692,175
341212302,341210111,341225684,15573,693,175
341231819,341229845,341244251,14406,694,175
341250336,341248362,341264370,16008,695,175
341270601,341268410,341283982,15572,696,175
341290093,341288118,341305056,16938,697,175
341311189,341309215,341324253,15038,698,175
341330358,341328384,341345341,16957,699,175
341351355,341349381,341364984,15603,700,175
341371128,341369154,341384847,15693,701,175
341391078,341388887,341404459,15572,702,175
341410566,341408592,341426206,17614,703,175
341432221,341430246,341446154,15908,704,175
341452233,341450258,341466248,15990,705,175
341472347,341470372,341486065,15693,706,175
341492296,341490105,341507597,17492,707,175
341513828,341511637,341527547,15910,708,175
341533778,341531587,341547475,15888,709,175
341553619,341551644,341568287,16643,710,175
341574369,341572395,341592645,20250,711,175
341598778,341596803,341611843,15040,712,175
341617985,341616010,341632336,16326,713,175
341638567,341636376,341652918,16542,714,175
341659063,341657088,341674365,17277,715,175
341680445,341678471,341695429,16958,716,175
341701562,341699587,341714963,15376,717,175
341721088,341719113,341734784,15671,718,175
341740921,341738947,341753352,14405,719,175
341759480,341757506,341773178,15672,720,175
341779408,341777217,341794393,17176,721,175
341800625,341798433,341812423,13990,722,175
341818487,341816512,341833788,17276,723,175
341839925,341837951,341852988,15037,724,175
341859082,341857107,341874065,16958,725,175
341880197,341878222,341894549,16327,726,175
341900639,341898665,341914357,15692,727,175
341920427,341918453,341934777,16324,728,175
341941007,341938817,341955655,16838,729,175
341961669,341959695,341976871,17176,730,175
341983002,341981028,341997353,16325,731,175
342003476,342001501,342019095,17594,732,175
342025196,342023221,342039844,16623,733,175
342045906,342043932,342061524,17592,734,175
342067755,342065564,342082739,17175,735,175
342088865,342086890,342103196,16306,736,175
342109296,342107322,342122675,15353,737,175
342128689,342126715,342142949,16234,738,175
342149046,342147072,342164663,17591,739,175
342170677,342168703,342183642,14939,740,175
342189765,342187789,342203801,16012,741,175
342209815,342207841,342224077,16236,742,175
342230219,342228245,342244255,16010,743,175
342250486,342248295,342266441,18146,744,175
342272672,342270481,342285736,15255,745,175
342291966,342289776,342306634,16858,746,175
342312865,342310675,342325929,15254,747,175
342332035,342330061,342347000,16939,748,175
342353131,342351156,342366511,15355,749,175
342372603,342370628,342386617,15989,750,175
342392632,342390657,342406851,16194,751,175
342412967,342410993,342427635,16642,752,175
342433726,342431751,342446474,14723,753,175
342452600,342450625,342465663,15038,754,175
342471677,342469703,342487511,17808,755,175
342493742,342491551,342509044,17493,756,175
342515154,342513179,342528218,15039,757,175
342534280,342532306,342548313,16007,758,175
342554410,342552435,342569711,17276,759,175
342575942,342573751,342589323,15572,760,175
342595554,342593363,342608935,15572,761,175
342615165,342612974,342627914,14940,762,175
342634050,342632076,342649349,17273,763,175
342655438,342653463,342669136,15673,764,175
342675250,342673275,342688630,15355,765,175
342694862,342692670,342707292,14622,766,175
342713407,342711433,342725520,14087,767,175
342731751,342729560,342747053,17493,768,175
342753197,342751223,342767232,16009,769,175
342773350,342771376,342787365,15989,770,175
342793469,342791494,342805900,14406,771,175
342812044,342810070,342827027,16957,772,175
342833134,342831159,342847148,15989,773,175
342853379,342851188,342867392,16204,774,175
342873522,342871547,342887220,15673,775,175
342893337,342891362,342908005,16643,776,175
342914128,342912153,342926875,14722,777,175
342933106,342930915,342945221,14306,778,175
342951298,342949324,342963728,14404,779,175
342969795,342967821,342984780,16959,780,175
342991012,342988821,343003759,14938,781,175
343009773,343007799,343024026,16227,782,175
343030142,343028168,343044178,16010,783,175
343050409,343048218,343062207,13989,784,175
343068436,343066246,343082451,16205,785,175
343088510,343086536,343104129,17593,786,175
343110360,343108169,343123423,15254,787,175
343129536,343127561,343142283,14722,788,175
343148515,343146323,343163183,16860,789,175
343169246,343167272,343182626,15354,790,175
343188857,343186666,343202576,15910,791,175
343208719,343206745,343222437,15692,792,175
343228533,343226559,343241913,15354,793,175
343247927,343245953,343261842,15889,794,175
343267967,343265993,343281349,15356,795,175
343287580,343285388,343300327,14939,796,175
343306342,343304367,343321892,17525,797,175
343328034,343326059,343342385,16326,798,175
343348618,343346426,343364552,18126,799,175
343370783,343368592,343383531,14939,800,175
343389762,343387571,343402509,14938,801,175
343408597,343406622,343421028,14406,802,175
343427093,343425119,343440495,15376,803,175
343446594,343444620,343459974,15354,804,175
343466035,343464061,343479099,15038,805,175
343485330,343483139,343498712,15573,806,175
343504823,343502850,343519808,16958,807,175
343525873,343523899,343539255,15356,808,175
343545380,343543405,343560048,16643,809,175
343566174,343564200,343580821,16621,810,175
343587053,343584861,343601065,16204,811,175
343607147,343605173,343620528,15355,812,175
343626760,343624568,343640775,16207,813,175
343646897,343644923,343659960,15037,814,175
343666104,343664130,343679505,15375,815,175
343685648,343683674,343698396,14722,816,175
343704410,343702436,343718346,15910,817,175
343724359,343722386,343740181,17795,818,175
343746412,343744221,343760763,16542,819,175
343766885,343764911,343781215,16304,820,175
343787445,343785255,343802429,17174,821,175
343808564,343806590,343822260,15670,822,175
343828329,343826355,343841394,15039,823,175
343847526,343845552,343862828,17276,824,175
343869060,343866869,343883390,16521,825,175
343889621,343887430,343901419,13989,826,175
343907536,343905561,343921888,16327,827,175
343928120,343925928,343941185,15257,828,175
343947293,343945319,343962278,16959,829,175
343968376,343966401,343983339,16938,830,175
343989481,343987507,344004445,16938,831,175
344010572,344008598,344024291,15693,832,175
344030424,344028449,344043488,15039,833,175
344049719,344047528,344064071,16543,834,175
344070302,344068111,344083049,14938,835,175
344089180,344087206,344103531,16325,836,175
344109762,344107571,344123776,16205,837,175
344130007,344127816,344143071,15255,838,175
344149206,344147232,344165159,17927,839,175
344171265,344169292,344184329,15037,840,175
344190559,344188368,344204910,16542,841,175
344211141,344208950,344222939,13989,842,175
344229018,344227045,344242398,15353,843,175
344248628,344246438,344260743,14305,844,175
344266878,344264903,344279942,15039,845,175
344286031,344284056,344299729,15673,846,175
344305743,344303768,344320277,16509,847,175
344326508,344324317,344339256,14939,848,175
344345355,344343381,344358735,15354,849,175
344364795,344362820,344378829,16009,850,175
344384934,344382958,344398653,15695,851,175
344404787,344402813,344418801,15988,852,175
344424815,344422840,344438444,15604,853,175
344444564,344442590,344459232,16642,854,175
344465464,344463272,344479183,15911,855,175
344485295,344483321,344499647,16326,856,175
344505709,344503734,344520039,16305,857,175
344526099,344524126,344541084,16958,858,175
344547315,344545124,344561327,16203,859,175
344567455,344565481,344583094,17613,860,175
344589204,344587229,344602607,15378,861,175
344608752,344606777,344624054,17277,862,175
344630191,344628216,344644521,16305,863,175
344650754,344648561,344665422,16861,864,175
344671655,344669463,344686956,17493,865,175
344693064,344691090,344707712,16622,866,175
344713944,344711753,344727347,15594,867,175
344733577,344731387,344746008,14621,868,175
344752125,344750150,344765504,15354,869,175
344771736,344769544,344785433,15889,870,175
344791664,344789473,344807936,18463,871,175
344814167,344811976,344828202,16226,872,175
344834433,344832242,344850050,17808,873,175
344856281,344854090,344870631,16541,874,175
344876864,344874672,344889927,15255,875,175
344896055,344894081,344909753,15672,876,175
344915984,344913792,344929999,16207,877,175
344936095,344934121,344948209,14088,878,175
344954350,344952375,344968702,16327,879,175
344974820,344972846,344990459,17613,880,175
344996519,344994544,345010849,16305,881,175
345017081,345014890,345032719,17829,882,175
345038793,345036819,345054412,17593,883,175
345060549,345058575,345073295,14720,884,175
345079527,345077335,345093541,16206,885,175
345099643,345097669,345115260,17591,886,175
345121394,345119420,345133509,14089,887,175
345139739,345137548,345154406,16858,888,175
345160511,345158536,345175179,16643,889,175
345181301,345179326,345195949,16623,890,175
345202180,345199989,345214295,14306,891,175
345220393,345218418,345234745,16327,892,175
345240877,345238903,345253625,14722,893,175
345259770,345257794,345272201,14407,894,175
345278267,345276293,345291964,15671,895,175
345298090,345296116,345312124,16008,896,175
345318138,345316164,345333656,17492,897,175
345339886,345337696,345352317,14621,898,175
345358418,345356443,345372135,15692,899,175
345378195,345376221,345390943,14722,900,175
345397173,345394982,345411504,16522,901,175
345417591,345415617,345432575,16958,902,175
345438674,345436699,345454313,17614,903,175
345460546,345458354,345476501,18147,904,175
345482732,345480541,345496451,15910,905,175
345502584,345500610,345515647,15037,906,175
345521877,345519687,345535913,16226,907,175
345542029,345540054,345556698,16644,908,175
345562714,345560738,345579484,18746,909,175
345585715,345583525,345598146,14621,910,175
345604252,345602277,345618288,16011,911,175
345624520,345622328,345638216,15888,912,175
345644447,345642256,345658778,16522,913,175
345665009,345662818,345677440,14622,914,175
345683551,345681576,345696933,15357,915,175
345702948,345700973,345718180,17207,916,175
345724246,345722271,345737628,15357,917,175
345743758,345741783,345757456,15673,918,175
345763470,345761496,345777373,15877,919,175
345783603,345781412,345798905,17493,920,175
345805137,345802945,345819488,16543,921,175
345825720,345823529,345841992,18463,922,175
345848008,345846033,345861887,15854,923,175
345868028,345866054,345880775,14721,924,175
345887006,345884815,345901356,16541,925,175
345907588,345905397,345923206,17809,926,175
345929316,345927342,345944616,17274,927,175
345950632,345948657,345964547,15890,928,175
345970778,345968587,345985445,16858,929,175
345991578,345989604,346004326,14722,930,175
346010558,346008366,346026176,17810,931,175
346032268,346030294,346045649,15355,932,175
346051764,346049790,346064194,14404,933,175
346070304,346068328,346083368,15040,934,175
346089475,346087500,346104460,16960,935,175
346110474,346108500,346124356,15856,936,175
346130588,346128396,346145235,16839,937,175
346151295,346149320,346167566,18246,938,175
346173695,346171721,346186760,15039,939,175
346192901,346190926,346205965,15039,940,175
346212098,346210124,346224845,14721,941,175
346230954,346228980,346243701,14721,942,175
346249788,346247814,346265069,17255,943,175
346271189,346269215,346285202,15987,944,175
346291309,346289335,346306611,17276,945,175
346312843,346310652,346328778,18126,946,175
346334793,346332819,346350912,18093,947,175
346357009,346355035,346370390,15355,948,175
346376525,346374551,346390559,16008,949,175
346396790,346394599,346412409,17810,950,175
346418505,346416530,346432540,16010,951,175
346438617,346436643,346450731,14088,952,175
346456963,346454771,346470028,15257,953,175
346476157,346474183,346491775,17592,954,175
346498007,346495815,346512674,16859,955,175
346518734,346516760,346532432,15672,956,175
346538562,346536588,346552575,15987,957,175
346558683,346556709,346572380,15671,958,175
346578518,346576544,346592237,15693,959,175
346598360,346596386,346611739,15353,960,175
346617860,346615886,346633161,17275,961,175
346639222,346637247,346652623,15376,962,175
346658753,346656778,346671818,15040,963,175
346677948,346675974,346693566,17592,964,175
346699690,346697716,346713725,16009,965,175
346719956,346717765,346734921,17156,966,175
346741152,346738961,346755166,16205,967,175
346761397,346759206,346775411,16205,968,175
346781521,346779546,346795535,15989,969,175
346801676,346799700,346816028,16328,970,175
346822141,346820168,346836788,16620,971,175
346842912,346840938,346856609,15671,972,175
346862670,346860696,346874785,14089,973,175
346880874,346878900,346894593,15693,974,175
346900824,346898633,346913888,15255,975,175
346920120,346917928,346934470,16542,976,175
346940596,346938621,346954926,16305,977,175
346961068,346959094,346976032,16938,978,175
346982152,346980178,346996503,16325,979,175
347002595,347000621,347014710,14089,980,175
347020724,347018750,347036221,17471,981,175
347042313,347040339,347056982,16643,982,175
347063073,347061099,347077086,15987,983,175
347083211,347081236,347095959,14723,984,175
347102190,347099999,347116204,16205,985,175
347122279,347120304,347136314,16010,986,175
347142447,347140472,347156482,16010,987,175
347162544,347160569,347177528,16959,988,175
347183611,347181637,347197625,15988,989,175
347203856,347201665,347215970,14305,990,175
347222106,347220132,347235804,15672,991,175
347242036,347239844,347256069,16225,992,175
347262131,347260157,347277433,17276,993,175
347283665,347281474,347297045,15571,994,175
347303148,347301174,347315580,14406,995,175
347321723,347319748,347337024,17276,996,175
347343119,347341145,347356817,15672,997,175
347363049,347360857,347377085,16228,998,175
347383198,347381224,347398500,17276,999,175
347404731,347402540,347417795,15255,1000,175
347423944,347421970,347436374,14404,1001,175
347442693,347440502,347456391,15889,1002,175
347462710,347460519,347476406,15887,1003,175
347482620,347480646,347496633,15987,1004,175
347502797,347500823,347516810,15987,1005,175
347523020,347521047,347537350,16303,1006,175
347543579,347541605,347556643,15038,1007,175
347562962,347560772,347576343,15571,1008,175
347582545,347580572,347597510,16938,1009,175
347603743,347601770,347616174,14404,1010,175
347622348,347620373,347636067,15694,1011,175
347642388,347640196,347655770,15574,1012,175
347661929,347659954,347676598,16644,1013,175
347682918,347680727,347695982,15255,1014,175
347702301,347700110,347715049,14939,1015,175
347721200,347719225,347734264,15039,1016,175
347740446,347738471,347753510,15039,1017,175
347759711,347757736,347774695,16959,1018,175
347780928,347778954,347793992,15038,1019,175
347800139,347798165,347814152,15987,1020,175
347820472,347818281,347833854,15573,1021,175
347839958,347837983,347854526,16543,1022,175
347860846,347858655,347874859,16204,1023,175
347881179,347878988,347895848,16860,1024,175
347902076,347900102,347914823,14721,1025,175
347921143,347918951,347936127,17176,1026,175
347942447,347940256,347956483,16227,1027,175
347962803,347960612,347977766,17154,1028,175
347983980,347982007,347998648,16641,1029,175
348004970,348002778,348017717,14939,1030,175
348023946,348021972,348036377,14405,1031,175
348042588,348040613,348054702,14089,1032,175
348060918,348058944,348074297,15353,1033,175
348080513,348078540,348095159,16619,1034,175
348101321,348099346,348115651,16305,1035,175
348121843,348119868,348134590,14722,1036,175
348140798,348138823,348152913,14090,1037,175
348159233,348157042,348173269,16227,1038,175
348179475,348177501,348195410,17909,1039,175
348201606,348199631,348217224,17593,1040,175
348223397,348221422,348236777,15355,1041,175
348242970,348240996,348254767,13771,1042,175
348260870,348258895,348275004,16109,1043,175
348281196,348279222,348294578,15356,1044,175
348300726,348298752,348314444,15692,1045,175
348320651,348318676,348334052,15376,1046,175
348340251,348338277,348356523,18246,1047,175
348362843,348360652,348375273,14621,1048,175
348381505,348379531,348396785,17254,1049,175
348403106,348400914,348416509,15595,1050,175
348422716,348420742,348437385,16643,1051,175
348443705,348441514,348455819,14305,1052,175
348462052,348460077,348475432,15355,1053,175
348481650,348479675,348497267,17592,1054,175
348503441,348501467,348517454,15987,1055,175
348523609,348521635,348537960,16325,1056,175
348544177,348542203,348557895,15692,1057,175
348563997,348562023,348577596,15573,1058,175
348583915,348581724,348598267,16543,1059,175
348604470,348602495,348618483,15988,1060,175
348624683,348622710,348639647,16937,1061,175
348645841,348643867,348658906,15039,1062,175
348665105,348663131,348678487,15356,1063,175
348684716,348682741,348698413,15672,1064,175
348704620,348702644,348719267,16623,1065,175
348725587,348723396,348740573,17177,1066,175
348746894,348744702,348760930,16228,1067,175
348767250,348765059,348780947,15888,1068,175
348787133,348785160,348798930,13770,1069,175
348805250,348803059,348818629,15570,1070,175
348824949,348822758,348839279,16521,1071,175
348845599,348843408,348858348,14940,1072,175
348864668,348862476,348879970,17494,1073,175
348886200,348884225,348900234,16009,1074,175
348906429,348904455,348921097,16642,1075,175
348927417,348925226,348940165,14939,1076,175
348946381,348944407,348961366,16959,1077,175
348967545,348965571,348982214,16643,1078,175
348988535,348986343,349002231,15888,1079,175
349008428,349006454,349022442,15988,1080,175
349028646,349026671,349043314,16643,1081,175
349049516,349047543,349065788,18245,1082,175
349071998,349070024,349085716,15692,1083,175
349091941,349089967,349104688,14721,1084,175
349110920,349108945,349126876,17931,1085,175
349133077,349131103,349145508,14405,1086,175
349151827,349149636,349166474,16838,1087,175
349172794,349170603,349187779,17176,1088,175
349193975,349192001,349207989,15988,1089,175
349214204,349212229,349226953,14724,1090,175
349233145,349231170,349246210,15040,1091,175
349252418,349250444,349266115,15671,1092,175
349272333,349270359,349287613,17254,1093,175
349293933,349291742,349307631,15889,1094,175
349313856,349311882,349326921,15039,1095,175
349333152,349331178,349348770,17592,1096,175
349354966,349352991,349369001,16010,1097,175
349375322,349373130,349388386,15256,1098,175
349394705,349392514,349408403,15889,1099,175
349414613,349412639,349427677,15038,1100,175
349433997,349431806,349447062,15256,1101,175
349453381,349451190,349467712,16522,1102,175
349473816,349471841,349488880,17039,1103,175
349495199,349493009,349509868,16859,1104,175
349516073,349514099,349530425,16326,1105,175
349536626,349534651,349550976,16325,1106,175
349557176,349555202,349572794,17592,1107,175
349578971,349576997,349593618,16621,1108,175
349599832,349597858,349614162,16304,1109,175
349620393,349618418,349632824,14406,1110,175
349639144,349636952,349654424,17472,1111,175
349660527,349658553,349674642,16089,1112,175
349680962,349678771,349694659,15888,1113,175
349700980,349698788,349715015,16227,1114,175
349721237,349719262,349735589,16327,1115,175
349741807,349739833,349756453,16620,1116,175
349762649,349760675,349776662,15987,1117,175
349782846,349780872,349795276,14404,1118,175
349801597,349799405,349813395,13990,1119,175
349819581,349817607,349833912,16305,1120,175
349840126,349838151,349853824,15673,1121,175
349860143,349857952,349873207,15255,1122,175
349879527,349877335,349893563,16228,1123,175
349899776,349897802,349913177,15375,1124,175
349919331,349917356,349932080,14724,1125,175
349938243,349936268,349951623,15355,1126,175
349957781,349955807,349973399,17592,1127,175
349979615,349977641,349994917,17276,1128,175
350001108,349999132,350014173,15041,1129,175
350020494,350018302,350034846,16544,1130,175
350040996,350039021,350056298,17277,1131,175
350062401,350060427,350077464,17037,1132,175
350083656,350081682,350097669,15987,1133,175
350103889,350101915,350118557,16642,1134,175
350124763,350122789,350139409,16620,1135,175
350145585,350143611,350158965,15354,1136,175
350165126,350163152,350180428,17276,1137,175
350186585,350184611,350201232,16621,1138,175
350207459,350205486,350220841,15355,1139,175
350227160,350224969,350241828,16859,1140,175
350247932,350245957,350263450,17493,1141,175
350269645,350267671,350284314,16643,1142,175
350290543,350288569,350302657,14088,1143,175
350308976,350306785,350322695,15910,1144,175
350329015,350326824,350344655,17831,1145,175
350350976,350348785,350364040,15255,1146,175
350370246,350368271,350383965,15694,1147,175
350390286,350388094,350406241,18147,1148,175
350412562,350410371,350427231,16860,1149,175
350433379,350431405,350446125,14720,1150,175
350452444,350450253,350465824,15571,1151,175
350472003,350470028,350486037,16009,1152,175
350492264,350490289,350507882,17593,1153,175
350514093,350512119,350526209,14090,1154,175
350532404,350530431,350545786,15355,1155,175
350551971,350549997,350565034,15037,1156,175
350571247,350569273,350585915,16642,1157,175
350592134,350590159,350606169,16010,1158,175
350612356,350610382,350624153,13771,1159,175
350630378,350628404,350643127,14723,1160,175
350649284,350647309,350663614,16305,1161,175
350669830,350667856,350683211,15355,1162,175
350689399,350687425,350703434,16009,1163,175
350709651,350707676,350723665,15989,1164,175
350729848,350727873,350744812,16939,1165,175
350750976,350749002,350763723,14721,1166,175
350769908,350767934,350782022,14088,1167,175
350788206,350786232,350800955,14723,1168,175
350807161,350805187,350821175,15988,1169,175
350827493,350825303,350841528,16225,1170,175
350847849,350845657,350863149,17492,1171,175
350869343,350867368,350884645,17277,1172,175
350890749,350888774,350904231,15457,1173,175
350910442,350908467,350925744,17277,1174,175
350931895,350929920,350947196,17276,1175,175
350953516,350951325,350967551,16226,1176,175
350973871,350971680,350986935,15255,1177,175
350993153,350991179,351006851,15672,1178,175
351013011,351011037,351026076,15039,1179,175
351032240,351030266,351046592,16326,1180,175
351052802,351050828,351067786,16958,1181,175
351074021,351072046,351089977,17931,1182,175
351096297,351094106,351108412,14306,1183,175
351114620,351112645,351127050,14405,1184,175
351133274,351131300,351146654,15354,1185,175
351152878,351150904,351167840,16936,1186,175
351174074,351172100,351189691,17591,1187,175
351195898,351193924,351211198,17274,1188,175
351217413,351215439,351233031,17592,1189,175
351239244,351237270,351253259,15989,1190,175
351259420,351257445,351272802,15357,1191,175
351279122,351276931,351293451,16520,1192,175
351299771,351297580,351315073,17493,1193,175
351321393,351319202,351334458,15256,1194,175
351340609,351338635,351353989,15354,1195,175
351360310,351358118,351374662,16544,1196,175
351380871,351378896,351394273,15377,1197,175
351400482,351398508,351414515,16007,1198,175
351420835,351418644,351435166,16522,1199,175
351441385,351439411,351457002,17591,1200,175
351463201,351461227,351477214,15987,1201,175
351483534,351481342,351497232,15890,1202,175
351503551,351501360,351518218,16858,1203,175
351524321,351522347,351537802,15455,1204,175
351544001,351542027,351558015,15988,1205,175
351564248,351562275,351579549,17274,1206,175
351585870,351583678,351600539,16861,1207,175
351606643,351604669,351621412,16743,1208,175
351627587,351625613,351639385,13772,1209,175
351645487,351643514,351659402,15888,1210,175
351665722,351663531,351678786,15255,1211,175
351684998,351683023,351698061,15038,1212,175
351704280,351702306,351720553,18247,1213,175
351726739,351724765,351741408,16643,1214,175
351747512,351745538,351762891,17353,1215,175
351769086,351767112,351783753,16641,1216,175
351789948,351787975,351802379,14404,1217,175
351808606,351806632,351823275,16643,1218,175
351829595,351827405,351842976,15571,1219,175
351849134,351847160,351860932,13772,1220,175
351867101,351865127,351882382,17255,1221,175
351888575,351886601,351901007,14406,1222,175
351907241,351905267,351922541,17274,1223,175
351928645,351926671,351943095,16424,1224,175
351949416,351947225,351963450,16225,1225,175
351969770,351967579,351983489,15910,1226,175
351989810,351987618,352002241,14623,1227,175
352008416,352006442,352022114,15672,1228,175
352028322,352026348,352042990,16642,1229,175
352049175,352047201,352063844,16643,1230,175
352070029,352068055,352082460,14405,1231,175
352088693,352086718,352102096,15378,1232,175
352108415,352106224,352122113,15889,1233,175
352128264,352126290,352143228,16938,1234,175
352149331,352147357,352164394,17037,1235,175
352170610,352168636,352183042,14406,1236,175
352189262,352187288,352203276,15988,1237,175
352209472,352207498,352222536,15038,1238,175
352228857,352226665,352241605,14940,1239,175
352247811,352245837,352262458,16621,1240,175
352268779,352266587,352282475,15888,1241,175
352288795,352286603,352302831,16228,1242,175
352309151,352306960,352322216,15256,1243,175
352328409,352326435,352342423,15988,1244,175
352348743,352346552,352363727,17175,1245,175
352370047,352367856,352383743,15887,1246,175
352389953,352387979,352402384,14405,1247,175
352408603,352406627,352421668,15041,1248,175
352427987,352425796,352440734,14938,1249,175
352446899,352444924,352462201,17277,1250,175
352468522,352466330,352481587,15257,1251,175
352487803,352485829,352500550,14721,1252,175
352506869,352504679,352520883,16204,1253,175
352526987,352525012,352540466,15454,1254,175
352546569,352544595,352560821,16226,1255,175
352567142,352564950,352582128,17178,1256,175
352588278,352586304,352602292,15988,1257,175
352608479,352606505,352621541,15036,1258,175
352627689,352625715,352640753,15038,1259,175
352646982,352645008,352662915,17907,1260,175
352669149,352667174,352683500,16326,1261,175
352689603,352687629,352705636,18007,1262,175
352711956,352709765,352725359,15594,1263,175
352731679,352729488,352745377,15889,1264,175
352751696,352749505,352764761,15256,1265,175
352770970,352768996,352786271,17275,1266,175
352792487,352790512,352807135,16623,1267,175
352813454,352811264,352827151,15887,1268,175
352833356,352831382,352849628,18246,1269,175
352855948,352853757,352869011,15254,1270,175
352875331,352873140,352889979,16839,1271,175
352896173,352894198,352911156,16958,1272,175
352917361,352915388,352930425,15037,1273,175
352936744,352934553,352951391,16838,1274,175
352957602,352955628,352972566,16938,1275,175
352978774,352976800,352991839,15039,1276,175
352997942,352995968,353011739,15771,1277,175
353017972,353015998,353032641,16643,1278,175
353038862,353036888,353053847,16959,1279,175
353060072,353058098,353072503,14405,1280,175
353078823,353076632,353091570,14938,1281,175
353097721,353095745,353110151,14406,1282,175
353116355,353114380,353129420,15040,1283,175
353135615,353133641,353149630,15989,1284,175
353155858,353153883,353170210,16327,1285,175
353176531,353174339,353190227,15888,1286,175
353196546,353194356,353210561,16205,1287,175
353216880,353214690,353228994,14304,1288,175
353235174,353233200,353249188,15988,1289,175
353255508,353253317,353271443,18126,1290,175
353277594,353275619,353290976,15357,1291,175
353297079,353295105,353310244,15139,1292,175
353316399,353314425,353328514,14089,1293,175
353334833,353332642,353347897,15255,1294,175
353354081,353352107,353366512,14405,1295,175
353372831,353370640,353386844,16204,1296,175
353393165,353390973,353407201,16228,1297,175
353413382,353411408,353426762,15354,1298,175
353433083,353430891,353448068,17177,1299,175
353454280,353452306,353467345,15039,1300,175
353473578,353471603,353486325,14722,1301,175
353492475,353490499,353504906,14407,1302,175
353511091,353509117,353525125,16008,1303,175
353531335,353529360,353544083,14723,1304,175
353550293,353548319,353563675,15356,1305,175
353569777,353567803,353585179,17376,1306,175
353591341,353589366,353604720,15354,1307,175
353610917,353608943,353623349,14406,1308,175
353629579,353627604,353642960,15356,1309,175
353649279,353647088,353663610,16522,1310,175
353669827,353667853,353684495,16642,1311,175
353690706,353688731,353705037,16306,1312,175
353711141,353709167,353727293,18126,1313,175
353733473,353731498,353747488,15990,1314,175
353753651,353751676,353766398,14722,1315,175
353772584,353770610,353785965,15355,1316,175
353792286,353790094,353805666,15572,1317,175
353811883,353809908,353825264,15356,1318,175
353831460,353829486,353845790,16304,1319,175
353852111,353849919,353868066,18147,1320,175
353874386,353872195,353888716,16521,1321,175
353895035,353892845,353909704,16859,1322,175
353915915,353913941,353929612,15671,1323,175
353935807,353933833,353949821,15988,1324,175
353956012,353954037,353970680,16643,1325,175
353977001,353974809,353991667,16858,1326,175
353997988,353995796,354013606,17810,1327,175
354019814,354017840,354034798,16958,1328,175
354041002,354039027,354054700,15673,1329,175
354061020,354058829,354074399,15570,1330,175
354080593,354078619,354092707,14088,1331,175
354098873,354096899,354115146,18247,1332,175
354121363,354119389,354134744,15355,1333,175
354140909,354138935,354153656,14721,1334,175
354159889,354157915,354175508,17593,1335,175
354181664,354179689,354196143,16454,1336,175
354202337,354200363,354215085,14722,1337,175
354221309,354219335,354233423,14088,1338,175
354239743,354237552,354254411,16859,1339,175
354260732,354258540,354274114,15574,1340,175
354280310,354278335,354295590,17255,1341,175
354301910,354299719,354314340,14621,1342,175
354320659,354318468,354333723,15255,1343,175
354339953,354337979,354354284,16305,1344,175
354360507,354358533,354373571,15038,1345,175
354379752,354377778,354393450,15672,1346,175
354399770,354397578,354414735,17157,1347,175
354421055,354418864,354432852,13988,1348,175
354439170,354436980,354453501,16521,1349,175
354459821,354457630,354475122,17492,1350,175
354481442,354479251,354495456,16205,1351,175
354501776,354499585,354514207,14622,1352,175
354520365,354518391,354534400,16009,1353,175
354540593,354538618,354554311,15693,1354,175
354560541,354558566,354574892,16326,1355,175
354581122,354579149,354593554,14405,1356,175
354599769,354597795,354615071,17276,1357,175
354621391,354619200,354635088,15888,1358,175
354641408,354639216,354654789,15573,1359,175
354660986,354659011,354675654,16643,1360,175
354681872,354679898,354694304,14406,1361,175
354700527,354698553,354714562,16009,1362,175
354720665,354718691,354733512,14821,1363,175
354739740,354737767,354753776,16009,1364,175
354759979,354758004,354775597,17593,1365,175
354781811,354779837,354795845,16008,1366,175
354801997,354800023,354817932,17909,1367,175
354824113,354822139,354839098,16959,1368,175
354845301,354843326,354858682,15356,1369,175
354864901,354862926,354880857,17931,1370,175
354887177,354884986,354903111,18125,1371,175
354909324,354907349,354923655,16306,1372,175
354929974,354927784,354944325,16541,1373,175
354950475,354948500,354966410,17910,1374,175
354972625,354970651,354986638,15987,1375,175
354992958,354990767,355008260,17493,1376,175
355014365,355012390,355027962,15572,1377,175
355034161,355032187,355048174,15987,1378,175
355054369,355052394,355066483,14089,1379,175
355072692,355070718,355085757,15039,1380,175
355092077,355089886,355107062,17176,1381,175
355113384,355111192,355126448,15256,1382,175
355132767,355130577,355146803,16226,1383,175
355153123,355150932,355166503,15571,1384,175
355172824,355170632,355185887,15255,1385,175
355192068,355190094,355206082,15988,1386,175
355212236,355210261,355226271,16010,1387,175
355232505,355230531,355246857,16326,1388,175
355253177,355250986,355266240,15254,1389,175
355272421,355270446,355288038,17592,1390,175
355294263,355292288,355307961,15673,1391,175
355314281,355312089,355327979,15890,1392,175
355334211,355332236,355348226,15990,1393,175
355354546,355352355,355367294,14939,1394,175
355373613,355371422,355387626,16204,1395,175
355393946,355391755,355406695,14940,1396,175
355412850,355410877,355426548,15671,1397,175
355432712,355430737,355447041,16304,1398,175
355453144,355451170,355467258,16088,1399,175
355473468,355471494,355486531,15037,1400,175
355492751,355490777,355507420,16643,1401,175
355513569,355511595,355528555,16960,1402,175
355534752,355532778,355548134,15356,1403,175
355554454,355552263,355569418,17155,1404,175
355575630,355573656,355591565,17909,1405,175
355597670,355595695,355610199,14504,1406,175
355616390,355614416,355631374,16958,1407,175
355637586,355635611,355650968,15357,1408,175
355657130,355655156,355671777,16621,1409,175
355678097,355675906,355691162,15256,1410,175
355697380,355695406,355710759,15353,1411,175
355717079,355714888,355729510,14622,1412,175
355735735,355733761,355748800,15039,1413,175
355755120,355752929,355770737,17808,1414,175
355776941,355774967,355789687,14720,1415,175
355796007,355793816,355810359,16543,1416,175
355816550,355814576,355830881,16305,1417,175
355836985,355835011,355850267,15256,1418,175
355856587,355854396,355871571,17175,1419,175
355877770,355875796,355890200,14404,1420,175
355896398,355894423,355910728,16305,1421,175
355916831,355914857,355932667,17810,1422,175
355938901,355936927,355953886,16959,1423,175
355960077,355958103,355974407,16304,1424,175
355980727,355978536,355994108,15572,1425,175
356000266,355998292,356015885,17593,1426,175
356022086,356020112,356037703,17591,1427,175
356043807,356041832,356056770,14938,1428,175
356062945,356060970,356075061,14091,1429,175
356081277,356079303,356096894,17591,1430,175
356103077,356101103,356114876,13773,1431,175
356121083,356119109,356136701,17592,1432,175
356143022,356140831,356157375,16544,1433,175
356163585,356161611,356178887,17276,1434,175
356185207,356183016,356197637,14621,1435,175
356203830,356201856,356217844,15988,1436,175
356224040,356222066,356237422,15356,1437,175
356243743,356241551,356257778,16227,1438,175
356264097,356261907,356277161,15254,1439,175
356283481,356281290,356297199,15909,1440,175
356303350,356301375,356319285,17910,1441,175
356325497,356323523,356339532,16009,1442,175
356345722,356343747,356359736,15989,1443,175
356365929,356363955,356381567,17612,1444,175
356387761,356385787,356403696,17909,1445,175
356409900,356407925,356423915,15990,1446,175
356430234,356428043,356443615,15572,1447,175
356449830,356447856,356463865,16009,1448,175
356470054,356468080,356484406,16326,1449,175
356490726,356488535,356506028,17493,1450,175
356512210,356510235,356527828,17593,1451,175
356534148,356531957,356548817,16860,1452,175
356555136,356552946,356569783,16837,1453,175
356576103,356573912,356588850,14938,1454,175
356595169,356592978,356609181,16203,1455,175
356615396,356613422,356629727,16305,1456,175
356636046,356633856,356649743,15887,1457,175
356655908,356653934,356670238,16304,1458,175
356676558,356674367,356688671,14304,1459,175
356694990,356692799,356707739,14940,1460,175
356713973,356711999,356728957,16958,1461,175
356735149,356733175,356748847,15672,1462,175
356755168,356752976,356769837,16861,1463,175
356776069,356774095,356791370,17275,1464,175
356797690,356795499,356811407,15908,1465,175
356817609,356815634,356831961,16327,1466,175
356838124,356836150,356851188,15038,1467,175
356857362,356855388,356870744,15356,1468,175
356876941,356874966,356890976,16010,1469,175
356897296,356895105,356910360,15255,1470,175
356916463,356914489,356931032,16543,1471,175
356937232,356935258,356952216,16958,1472,175
356958374,356956400,356970490,14090,1473,175
356976702,356974728,356992973,18245,1474,175
356999292,356997102,357013940,16838,1475,175
357020154,357018180,357035772,17592,1476,175
357041933,357039959,357056581,16622,1477,175
357062902,357060711,357079174,18463,1478,175
357085278,357083304,357100025,16721,1479,175
357106236,357104263,357118668,14405,1480,175
357124829,357122854,357139815,16961,1481,175
357145919,357143944,357159537,15593,1482,175
357165858,357163666,357177656,13990,1483,175
357183878,357181903,357196625,14722,1484,175
357202946,357200754,357216960,16206,1485,175
357223159,357221185,357237826,16641,1486,175
357244056,357242082,357257754,15672,1487,175
357264073,357261882,357278086,16204,1488,175
357284406,357282215,357299075,16860,1489,175
357305178,357303204,357320378,17174,1490,175
357326698,357324507,357339446,14939,1491,175
357345764,357343574,357359799,16225,1492,175
357366120,357363929,357379818,15889,1493,175
357385968,357383994,357400003,16009,1494,175
357406323,357404132,357420653,16521,1495,175
357426868,357424893,357441221,16328,1496,175
357447384,357445410,357460131,14721,1497,175
357466319,357464345,357482274,17929,1498,175
357488442,357486467,357503089,16622,1499,175
357509321,357507346,357522386,15040,1500,175
357528706,357526515,357540821,14306,1501,175
357547141,357544949,357560205,15256,1502,175
357566525,357564334,357579590,15256,1503,175
357585752,357583778,357600082,16304,1504,175
357606402,357604211,357620732,16521,1505,175
357626938,357624964,357640636,15672,1506,175
357646739,357644765,357661308,16543,1507,175
357667492,357665518,357681211,15693,1508,175
357687405,357685430,357701420,15990,1509,175
357707613,357705640,357723568,17928,1510,175
357729786,357727812,357743166,15354,1511,175
357749384,357747410,357761814,14404,1512,175
357767992,357766017,357783294,17277,1513,175
357789616,357787424,357804602,17178,1514,175
357810924,357808732,357825592,16860,1515,175
357831913,357829721,357846559,16838,1516,175
357852662,357850688,357868360,17672,1517,175
357874463,357872489,357889526,17037,1518,175
357895745,357893771,357908176,14405,1519,175
357914495,357912304,357928191,15887,1520,175
357934372,357932398,357948407,16009,1521,175
357954728,357952536,357968110,15574,1522,175
357974429,357972239,357989415,17176,1523,175
357995596,357993621,358009314,15693,1524,175
358015536,358013562,358030183,16621,1525,175
358036382,358034406,358050713,16307,1526,175
358057033,358054842,358071995,17153,1527,175
358078227,358076253,358091608,15355,1528,175
358097773,358095798,358112757,16959,1529,175
358118928,358116954,358133912,16958,1530,175
358140233,358138041,358154247,16206,1531,175
358160468,358158493,358173216,14723,1532,175
358179536,358177345,358193233,15888,1533,175
358199433,358197458,358213765,16307,1534,175
358219944,358217970,358234590,16620,1535,175
358240801,358238826,358254182,15356,1536,175
358260503,358258311,358274517,16206,1537,175
358280836,358278646,358293584,14938,1538,175
358299903,358297713,358315522,17809,1539,175
358321744,358319770,358336075,16305,1540,175
358342275,358340301,358354706,14405,1541,175
358360894,358358920,358376196,17276,1542,175
358382354,358380379,358396390,16011,1543,175
358402565,358400591,358417866,17275,1544,175
358424069,358422094,358438400,16306,1545,175
358444575,358442600,358458590,15990,1546,175
358464809,358462834,358478507,15673,1547,175
358484657,358482683,358498354,15671,1548,175
358504571,358502597,358516686,14089,1549,175
358522904,358520931,358537572,16641,1550,175
358543892,358541701,358557273,15572,1551,175
358563431,358561457,358577129,15672,1552,175
358583345,358581371,358596409,15038,1553,175
358602728,358600537,358617079,16542,1554,175
358623238,358621263,358637273,16010,1555,175
358643496,358641522,358658480,16958,1556,175
358664800,358662609,358678519,15910,1557,175
358684748,358682773,358699734,16961,1558,175
358705945,358703971,358718692,14721,1559,175
358724848,358722873,358737913,15040,1560,175
358744124,358742150,358757506,15356,1561,175
358763677,358761703,358777692,15989,1562,175
358783913,358781939,358799531,17592,1563,175
358805688,358803714,358819385,15671,1564,175
358825704,358823513,358839401,15888,1565,175
358845602,358843627,358858033,14406,1566,175
358864351,358862161,358878048,15887,1567,175
358884243,358882269,358896358,14089,1568,175
358902571,358900595,358918189,17594,1569,175
358924509,358922318,358937890,15572,1570,175
358943992,358942018,358957907,15889,1571,175
358964105,358962131,358978139,16008,1572,175
358984243,358982268,358998040,15772,1573,175
359004230,359002256,359017295,15039,1574,175
359023615,359021424,359036047,14623,1575,175
359042278,359040304,359057897,17593,1576,175
359064090,359062116,359076837,14721,1577,175
359083053,359081079,359096434,15355,1578,175
359102662,359100689,359116360,15671,1579,175
359122580,359120605,359137882,17277,1580,175
359144107,359142132,359156537,14405,1581,175
359162640,359160666,359179329,18663,1582,175
359185650,359183459,359199348,15889,1583,175
359205669,359203477,359218101,14624,1584,175
359224318,359222344,359240274,17930,1585,175
359246466,359244492,359259848,15356,1586,175
359266169,359263977,359281469,17492,1587,175
359287789,359285598,359301801,16203,1588,175
359308122,359305930,359322135,16205,1589,175
359328319,359326345,359342035,15690,1590,175
359348223,359346249,359360970,14721,1591,175
359367290,359365098,359381937,16839,1592,175
359388129,359386154,359400559,14405,1593,175
359406778,359404803,359420812,16009,1594,175
359427015,359425040,359441051,16011,1595,175
359447371,359445180,359461702,16522,1596,175
359467893,359465919,359481274,15355,1597,175
359487506,359485531,359502174,16643,1598,175
359508277,359506303,359523046,16743,1599,175
359529275,359527301,359542656,15355,1600,175
359548863,359546888,359561294,14406,1601,175
359567440,359565467,359579555,14088,1602,175
359585750,359583776,359600713,16937,1603,175
359606870,359604896,359621537,16641,1604,175
359627859,359625667,359641261,15594,1605,175
359647412,359645437,359662080,16643,1606,175
359668248,359666274,359682282,16008,1607,175
359688602,359686412,359702616,16204,1608,175
359708937,359706746,359724239,17493,1609,175
359730560,359728369,359744890,16521,1610,175
359751094,359749119,359764159,15040,1611,175
359770479,359768288,359782595,14307,1612,175
359788760,359786785,359801825,15040,1613,175
359807998,359806024,359821062,15038,1614,175
359827266,359825292,359839062,13770,1615,175
359845244,359843270,359859595,16325,1616,175
359865747,359863772,359880097,16325,1617,175
359886311,359884338,359899693,15355,1618,175
359905899,359903925,359919933,16008,1619,175
359926136,359924162,359939833,15671,1620,175
359946153,359943962,359961139,17177,1621,175
359967325,359965350,359981361,16011,1622,175
359987682,359985491,360002646,17155,1623,175
360008802,360006828,360023788,16960,1624,175
360030005,360028030,360044989,16959,1625,175
360051185,360049210,360065517,16307,1626,175
360071739,360069765,360085754,15989,1627,175
360092073,360089883,360106424,16541,1628,175
360112656,360110681,360125720,15039,1629,175
360132040,360129849,360146370,16521,1630,175
360152589,360150614,360165337,14723,1631,175
360171498,360169522,360185828,16306,1632,175
360192007,360190032,360207646,17614,1633,175
360213967,360211776,360228952,17176,1634,175
360235185,360233211,360248250,15039,1635,175
360254448,360252472,360269117,16645,1636,175
360275323,360273349,360288072,14723,1637,175
360294175,360292201,360307773,15572,1638,175
360313979,360312005,360328646,16641,1639,175
360334751,360332776,360350903,18127,1640,175
360357224,360355033,360371555,16522,1641,175
360377755,360375781,360391769,15988,1642,175
360398090,360395899,360411155,15256,1643,175
360417364,360415390,360431695,16305,1644,175
360437928,360435953,360451964,16011,1645,175
360458285,360456094,360471032,14938,1646,175
360477244,360475270,360491257,15987,1647,175
360497474,360495500,360510539,15039,1648,175
360516758,360514785,360528556,13771,1649,175
360534726,360532751,360548762,16011,1650,175
360554935,360552961,360567999,15038,1651,175
360574209,360572235,360586640,14405,1652,175
360592960,360590769,360607608,16839,1653,175
360613929,360611738,360627944,16206,1654,175
360634154,360632179,360648189,16010,1655,175
360654510,360652319,360670444,18125,1656,175
360676632,360674658,360689064,14406,1657,175
360695251,360693277,360707366,14089,1658,175
360713686,360711495,360726434,14939,1659,175
360732755,360730563,360747739,17176,1660,175
360753948,360751973,360768279,16306,1661,175
360774488,360772514,360788502,15988,1662,175
360794733,360792759,360810035,17276,1663,175
360816355,360814165,360830390,16225,1664,175
360836494,360834520,360850925,16405,1665,175
360857133,360855158,360869881,14723,1666,175
360876110,360874136,360890145,16009,1667,175
360896333,360894360,360910031,15671,1668,175
360916259,360914284,360929007,14723,1669,175
360935221,360933247,360950860,17613,1670,175
360957907,360955113,360972338,17225,1671,175
360978538,360976564,360992236,15672,1672,175
360998452,360996478,361012147,15669,1673,175
361018351,361016377,361030783,14406,1674,175
361036981,361035007,361050995,15988,1675,175
361057226,361055252,361072211,16959,1676,175
361078442,361076468,361090239,13771,1677,175
361096448,361094473,361111750,17277,1678,175
361117980,361116005,361132648,16643,1679,175
361138839,361136865,361153189,16324,1680,175
361159355,361157381,361174339,16958,1681,175
361180552,361178577,361194902,16325,1682,175
361201098,361199124,361216062,16938,1683,175
361222251,361220277,361237552,17275,1684,175
361243656,361241682,361258719,17037,1685,175
361265040,361262849,361280975,18126,1686,175
361287208,361285233,361301558,16325,1687,175
361307767,361305793,361321781,15988,1688,175
361327973,361325998,361342642,16644,1689,175
361348863,361346889,361363827,16938,1690,175
361370045,361368071,361383109,15038,1691,175
361389308,361387334,361405263,17929,1692,175
361411584,361409393,361425915,16522,1693,175
361432114,361430140,361447100,16960,1694,175
361453308,361451334,361468294,16960,1695,175
361474455,361472480,361488490,16010,1696,175
361494812,361492620,361507876,15256,1697,175
361514107,361512133,361526222,14089,1698,175
361532325,361530351,361544656,14305,1699,175
361550819,361548845,361563566,14721,1700,175
361569722,361567748,361591207,23459,1701,175
361597529,361595338,361610593,15255,1702,175
361616913,361614722,361633184,18462,1703,175
361639289,361637314,361653856,16542,1704,175
361660084,361658111,361674120,16009,1705,175
361680326,361678351,361695309,16958,1706,175
361701630,361699439,361715327,15888,1707,175
361721517,361719543,361737133,17590,1708,175
361743358,361741384,361757056,15672,1709,175
361763376,361761185,361778044,16859,1710,175
361784365,361782174,361798717,16543,1711,175
361804937,361802963,361819287,16324,1712,175
361825608,361823417,361839939,16522,1713,175
361846043,361844069,361862395,18326,1714,175
361868716,361866525,361883067,16542,1715,175
361889388,361887197,361905028,17831,1716,175
361911192,361909217,361926177,16960,1717,175
361932364,361930389,361945112,14723,1718,175
361951335,361949360,361966002,16642,1719,175
361972107,361970132,361987626,17494,1720,175
361993785,361991810,362010057,18247,1721,175
362016206,362014232,362029588,15356,1722,175
362035691,362033717,362048655,14938,1723,175
362054847,362052872,362069178,16306,1724,175
362075395,362073421,362090380,16959,1725,175
362096554,362094579,362112172,17593,1726,175
362118397,362116423,362132411,15988,1727,175
362138567,362136593,362153215,16622,1728,175
362159426,362157452,362174390,16938,1729,175
362180712,362178520,362195358,16838,1730,175
362201560,362199586,362214309,14723,1731,175
362220497,362218523,362233900,15377,1732,175
362240085,362238111,362256358,18247,1733,175
362262462,362260488,362277346,16858,1734,175
362283537,362281563,362299156,17593,1735,175
362305376,362303401,362317174,13773,1736,175
362323388,362321413,362339322,17909,1737,175
362345509,362343535,362359206,15671,1738,175
362365526,362363335,362379222,15887,1739,175
362385453,362383479,362401726,18247,1740,175
362407940,362405965,362423559,17594,1741,175
362429789,362427815,362442220,14405,1742,175
362448431,362446457,362462762,16305,1743,175
362468867,362466892,362482980,16088,1744,175
362489175,362487200,362501289,14089,1745,175
362507443,362505468,362521479,16011,1746,175
362527672,362525697,362539786,14089,1747,175
362545935,362543960,362559633,15673,1748,175
362565953,362563762,362579989,16227,1749,175
362586205,362584231,362602477,18246,1750,175
362608672,362606698,362621420,14722,1751,175
362627589,362625615,362641623,16008,1752,175
362647816,362645842,362662147,16305,1753,175
362668252,362666277,362682482,16205,1754,175
362688658,362686684,362702037,15353,1755,175
362708246,362706271,362720993,14722,1756,175
362727161,362725186,362743433,18247,1757,175
362749599,362747625,362764266,16641,1758,175
362770472,362768498,362786090,17592,1759,175
362792309,362790335,362806640,16305,1760,175
362812961,362810770,362826343,15573,1761,175
362832510,362830536,362844308,13772,1762,175
362850627,362848437,362865592,17155,1763,175
362871914,362869722,362887533,17811,1764,175
362893724,362891750,362907106,15356,1765,175
362913319,362911345,362925434,14089,1766,175
362931589,362929614,362946891,17277,1767,175
362953065,362951090,362969338,18248,1768,175
362975495,362973521,362989509,15988,1769,175
362995728,362993753,363009426,15673,1770,175
363015587,363013612,363029601,15989,1771,175
363035921,363033730,363051539,17809,1772,175
363057736,363055761,363071118,15357,1773,175
363077334,363075359,363091980,16621,1774,175
363098200,363096226,363112234,16008,1775,175
363118451,363116476,363130881,14405,1776,175
363137053,363135079,363149484,14405,1777,175
363155719,363153744,363169416,15672,1778,175
363175565,363173591,363189917,16326,1779,175
363196098,363194125,363210746,16621,1780,175
363216948,363214974,363230962,15988,1781,175
363237283,363235092,363251298,16206,1782,175
363257619,363255428,363271949,16521,1783,175
363278164,363276190,363291546,15356,1784,175
363297867,363295675,363313168,17493,1785,175
363319489,363317298,363332553,15255,1786,175
363338741,363336767,363353725,16958,1787,175
363360047,363357855,363374061,16206,1788,175
363380217,363378243,363394884,16641,1789,175
363401206,363399014,363413636,14622,1790,175
363419811,363417836,363433846,16010,1791,175
363440167,363437976,363453864,15888,1792,175
363460064,363458089,363474732,16643,1793,175
363481053,363478862,363494435,15573,1794,175
363500601,363498627,363516874,18247,1795,175
363523079,363521104,363539014,17910,1796,175
363545235,363543261,363559587,16326,1797,175
363565775,363563801,363580126,16325,1798,175
363586230,363584256,363599711,15455,1799,175
363606031,363603840,363620065,16225,1800,175
363626257,363624282,363641558,17276,1801,175
363647787,363645813,363662119,16306,1802,175
363668302,363666328,363682021,15693,1803,175
363688253,363686278,363703218,16940,1804,175
363709446,363707472,363724431,16959,1805,175
363730535,363728561,363744765,16204,1806,175
363751086,363748895,363764150,15255,1807,175
363770371,363768397,363785355,16958,1808,175
363791538,363789564,363803652,14088,1809,175
363809820,363807846,363825438,17592,1810,175
363831668,363829693,363846968,17275,1811,175
363853184,363851210,363866586,15376,1812,175
363872749,363870775,363885497,14722,1813,175
363891817,363889626,363906484,16858,1814,175
363912805,363910614,363927452,16838,1815,175
363933674,363931700,363946423,14723,1816,175
363952617,363950643,363966969,16326,1817,175
363973118,363971144,363988736,17592,1818,175
363994951,363992976,364008965,15989,1819,175
364015285,364013094,364028665,15571,1820,175
364034833,364032859,364049502,16643,1821,175
364055659,364053685,364069040,15355,1822,175
364075195,364073221,364090180,16959,1823,175
364096392,364094418,364109773,15355,1824,175
364116093,364113902,364128841,14939,1825,175
364135161,364132971,364148858,15887,1826,175
364154962,364152987,364170660,17673,1827,175
364176980,364174790,364191016,16226,1828,175
364197224,364195249,364212525,17276,1829,175
364218846,364216655,364233830,17175,1830,175
364240151,364237960,364252898,14938,1831,175
364259218,364257027,364273569,16542,1832,175
364279796,364277821,364291910,14089,1833,175
364298230,364296039,364312245,16206,1834,175
364318566,364316375,364330997,14622,1835,175
364337319,364335127,364351966,16839,1836,175
364358121,364356147,364371840,15693,1837,175
364378160,364375969,364392174,16205,1838,175
364398494,364396304,364414112,17808,1839,175
364420331,364418358,364433078,14720,1840,175
364439227,364437253,364453580,16327,1841,175
364459805,364457830,364471921,14091,1842,175
364478241,364476050,364490673,14623,1843,175
364496861,364494887,364509609,14722,1844,175
364515817,364513843,364529831,15988,1845,175
364536034,364534060,364549732,15672,1846,175
364555947,364553973,364570278,16305,1847,175
364576483,364574509,364591467,16958,1848,175
364597681,364595707,364612328,16621,1849,175
364618650,364616458,364632347,15889,1850,175
364638546,364636572,364653215,16643,1851,175
364659536,364657345,364674520,17175,1852,175
364680719,364678744,364695705,16961,1853,175
364702026,364699835,364715724,15889,1854,175
364722044,364719853,364734791,14938,1855,175
364740999,364739025,364755035,16010,1856,175
364761356,364759165,364777291,18126,1857,175
364783612,364781421,364798596,17175,1858,175
364804918,364802726,364818299,15573,1859,175
364824619,364822428,364838022,15594,1860,175
364844235,364842260,364857933,15673,1861,175
364864082,364862108,364875880,13772,1862,175
364882044,364880069,364896059,15990,1863,175
364902380,364900188,364915762,15574,1864,175
364922082,364919891,364935146,15255,1865,175
364941366,364939392,364954430,15038,1866,175
364960578,364958605,364974275,15670,1867,175
364980428,364978453,364996383,17930,1868,175
365002703,365000513,365016718,16205,1869,175
365022913,365020938,365036948,16010,1870,175
365043269,365041078,365057620,16542,1871,175
365063941,365061750,365077005,15255,1872,175
365083173,365081198,365096237,15039,1873,175
365102419,365100445,365117403,16958,1874,175
365123608,365121633,365138256,16623,1875,175
365144463,365142487,365158499,16012,1876,175
365164723,365162749,365179370,16621,1877,175
365185559,365183585,365199573,15988,1878,175
365205894,365203703,365219592,15889,1879,175
365225807,365223833,365238872,15039,1880,175
365245047,365243072,365257794,14722,1881,175
365264014,365262040,365278344,16304,1882,175
365284665,365282475,365299312,16837,1883,175
365305504,365303529,365320171,16642,1884,175
365326387,365324413,365340716,16303,1885,175
365346950,365344976,365361280,16304,1886,175
365367601,365365410,365380033,14623,1887,175
365386248,365384274,365399629,15355,1888,175
365405789,365403814,365418221,14407,1889,175
365424542,365422351,365439210,16859,1890,175
365445366,365443392,365459718,16326,1891,175
365466039,365463848,365479103,15255,1892,175
365485316,365483341,365497747,14406,1893,175
365503900,365501926,365517598,15672,1894,175
365523806,365521832,365537841,16009,1895,175
365544042,365542068,365558709,16641,1896,175
365564936,365562962,365578316,15354,1897,175
365584419,365582445,365598333,15888,1898,175
365604654,365602463,365617086,14623,1899,175
365623406,365621215,365638392,17177,1900,175
365644581,365642607,365658278,15671,1901,175
365664497,365662523,365680432,17909,1902,175
365686632,365684658,365700985,16327,1903,175
365707307,365705115,365723263,18148,1904,175
365729584,365727393,365742014,14621,1905,175
365748335,365746143,365763299,17156,1906,175
365769517,365767542,365781632,14090,1907,175
365787838,365785864,365802507,16643,1908,175
365808689,365806715,365823039,16324,1909,175
365829236,365827262,365842301,15039,1910,175
365848404,365846430,365862000,15570,1911,175
365868321,365866130,365881702,15572,1912,175
365887925,365885950,365902257,16307,1913,175
365908465,365906491,365923430,16939,1914,175
365929753,365927561,365943134,15573,1915,175
365949362,365947389,365965296,17907,1916,175
365971527,365969553,365984274,14721,1917,175
365990430,365988454,366004761,16307,1918,175
366011083,366008891,366025731,16840,1919,175
366031938,366029964,366045634,15670,1920,175
366051853,366049879,366065234,15355,1921,175
366071554,366069363,366085907,16544,1922,175
366092059,366090085,366106410,16325,1923,175
366112633,366110660,366126985,16325,1924,175
366133306,366131115,366146371,15256,1925,175
366152593,366150618,366165341,14723,1926,175
366171537,366169562,366183652,14090,1927,175
366189872,366187897,366202619,14722,1928,175
366208940,366206749,366222975,16226,1929,175
366229179,366227206,366240977,13771,1930,175
366247182,366245207,366263116,17909,1931,175
366269352,366267377,366284632,17255,1932,175
366290799,366288826,366303231,14405,1933,175
366309442,366307468,366322824,15356,1934,175
366329145,366326954,366342526,15572,1935,175
366348758,366346784,366362139,15355,1936,175
366368287,366366313,366381352,15039,1937,175
366387571,366385596,366399685,14089,1938,175
366406005,366403814,366419723,15909,1939,175
366425942,366423969,366438056,14087,1940,175
366444377,366442186,366458730,16544,1941,175
366464836,366462861,366478950,16089,1942,175
366485271,366483080,366498652,15572,1943,175
366504878,366502904,366521129,18225,1944,175
366527235,366525259,366541350,16091,1945,175
366547576,366545601,366561273,15672,1946,175
366567594,366565403,366580975,15572,1947,175
366587157,366585184,366600854,15670,1948,175
366607080,366605105,366620778,15673,1949,175
366626934,366624959,366640316,15357,1950,175
366646510,366644536,366659259,14723,1951,175
366665484,366663510,366678863,15353,1952,175
366685058,366683084,366697490,14406,1953,175
366703648,366701674,366718632,16958,1954,175
366724858,366722883,366739842,16959,1955,175
366745947,366743972,366760812,16840,1956,175
366767025,366765052,366780724,15672,1957,175
366787044,366784854,366802008,17154,1958,175
366808210,366806236,366821592,15356,1959,175
366827914,366825722,366840978,15256,1960,175
366847157,366845182,366862796,17614,1961,175
366869117,366866926,366883765,16839,1962,175
366889975,366888000,366905256,17256,1963,175
366911577,366909386,366925613,16227,1964,175
366931788,366929813,366946118,16305,1965,175
366952304,366950329,366966952,16623,1966,175
366973057,366971082,366985270,14188,1967,175
366991592,366989400,367005607,16207,1968,175
367011811,367009837,367026458,16621,1969,175
367032658,367030685,367046355,15670,1970,175
367052459,367050484,367068177,17693,1971,175
367074350,367072376,367089966,17590,1972,175
367096188,367094213,367111152,16939,1973,175
367117339,367115365,367131690,16325,1974,175
367137901,367135926,367151281,15355,1975,175
367157602,367155411,367171953,16542,1976,175
367178169,367176195,367190283,14088,1977,175
367196466,367194492,367209214,14722,1978,175
367215444,367213469,367229795,16326,1979,175
367236018,367234045,367250982,16937,1980,175
367257188,367255213,367271835,16622,1981,175
367278009,367276035,367291391,15356,1982,175
367297711,367295520,367312062,16542,1983,175
367318383,367316192,367332081,15889,1984,175
367338281,367336306,367350712,14406,1985,175
367356926,367354951,367369042,14091,1986,175
367375145,367373171,367387993,14822,1987,175
367394313,367392122,367409929,17807,1988,175
367416130,367414156,367429195,15039,1989,175
367435390,367433416,367449087,15671,1990,175
367455190,367453216,367469958,16742,1991,175
367476279,367474088,367490609,16521,1992,175
367496818,367494844,367511781,16937,1993,175
367518010,367516036,367532658,16622,1994,175
367538979,367536788,367551093,14305,1995,175
367557297,367555323,367571627,16304,1996,175
367577850,367575877,367591864,15987,1997,175
367598184,367595994,367612852,16858,1998,175
367619049,367617075,367634666,17591,1999,175
367640770,367638796,367655971,17175,2000,175
367662292,367660101,367674724,14623,2001,175
367680943,367678969,367694008,15039,2002,175
367700329,367698138,367714342,16204,2003,175
367720562,367718589,367734595,16006,2004,175
367740746,367738771,367755393,16622,2005,175
367761624,367759650,367775660,16010,2006,175
367781982,367779791,367795362,15571,2007,175
367801537,367799563,367815551,15988,2008,175
367821718,367819744,367835732,15988,2009,175
367841897,367839923,367854328,14405,2010,175
367860650,367858458,367876605,18147,2011,175
367882927,367880736,367895990,15254,2012,175
367902210,367900236,367917194,16958,2013,175
367923401,367921426,367939335,17909,2014,175
367945657,367943466,367960620,17154,2015,175
367966849,367964875,367980568,15693,2016,175
367986794,367984820,368001461,16641,2017,175
368007782,368005591,368021480,15889,2018,175
368027659,368025685,368040407,14722,2019,175
368046510,368044536,368059790,15254,2020,175
368065992,368064017,368080343,16326,2021,175
368086665,368084473,368099730,15257,2022,175
368105935,368103961,368120287,16326,2023,175
368126436,368124462,368140133,15671,2024,175
368146454,368144263,368158883,14620,2025,175
368165203,368163012,368179848,16836,2026,175
368186170,368183978,368201471,17493,2027,175
368207691,368205717,368220440,14723,2028,175
368226544,368224570,368239710,15140,2029,175
368245877,368243902,368260207,16305,2030,175
368266360,368264386,368278474,14088,2031,175
368284686,368282711,368300326,17615,2032,175
368306530,368304555,368320860,16305,2033,175
368327051,368325077,368342352,17275,2034,175
368348673,368346482,368360789,14307,2035,175
368366999,368365025,368379747,14722,2036,175
368385914,368383939,368400266,16327,2037,175
368406449,368404474,368421433,16959,2038,175
368427755,368425564,368442423,16859,2039,175
368448574,368446599,368463242,16643,2040,175
368469565,368467373,368482630,15257,2041,175
368488951,368486759,368503619,16860,2042,175
368509852,368507878,368522916,15038,2043,175
368529096,368527122,368541527,14405,2044,175
368547689,368545715,368559803,14088,2045,175
368566123,368563933,368580138,16205,2046,175
368586364,368584389,368599427,15038,2047,175
368605642,368603668,368620628,16960,2048,175
368626851,368624876,368642151,17275,2049,175
368648336,368646362,368663952,17590,2050,175
368670167,368668192,368683232,15040,2051,175
368689452,368687478,368702516,15038,2052,175
368708731,368706756,368723062,16306,2053,175
368729297,368727322,368744261,16939,2054,175
368750493,368748518,368766447,17929,2055,175
368772606,368770632,368785669,15037,2056,175
368791897,368789923,368805616,15693,2057,175
368811721,368809746,368825519,15773,2058,175
368831747,368829773,368845126,15353,2059,175
368851298,368849323,368864362,15039,2060,175
368870683,368868492,368885034,16542,2061,175
368891355,368889164,368906656,17492,2062,175
368912977,368910786,368927644,16858,2063,175
368933870,368931896,368947568,15672,2064,175
368953785,368951810,368967820,16010,2065,175
368973924,368971950,368989759,17809,2066,175
368996080,368993889,369011698,17809,2067,175
369018018,369015828,369033003,17175,2068,175
369039325,369037133,369051123,13990,2069,175
369057338,369055364,369069136,13772,2070,175
369075328,369073354,369088075,14721,2071,175
369094293,369092317,369108306,15989,2072,175
369114535,369112561,369129182,16621,2073,175
369135344,369133370,369148723,15353,2074,175
369155043,369152853,369168107,15254,2075,175
369174427,369172237,369189072,16835,2076,175
369195392,369193202,369211347,18145,2077,175
369217503,369215528,369231833,16305,2078,175
369238018,369236044,369251398,15354,2079,175
369257595,369255620,369271314,15694,2080,175
369277538,369275563,369290917,15354,2081,175
369297237,369295046,369310933,15887,2082,175
369317131,369315157,369332433,17276,2083,175
369338756,369336564,369351187,14623,2084,175
369357347,369355373,369372331,16958,2085,175
369378540,369376565,369391287,14722,2086,175
369397493,369395519,369412141,16622,2087,175
369418360,369416386,369433978,17592,2088,175
369440188,369438214,369454836,16622,2089,175
369461016,369459042,369474713,15671,2090,175
369480900,369478927,369494598,15671,2091,175
369500703,369498728,369514617,15889,2092,175
369520788,369518813,369534486,15673,2093,175
369540705,369538731,369554740,16009,2094,175
369560845,369558870,369576542,17672,2095,175
369582734,369580759,369598353,17594,2096,175
369604574,369602600,369618587,15987,2097,175
369624760,369622785,369637191,14406,2098,175
369643511,369641320,369657545,16225,2099,175
369663866,369661675,369678513,16838,2100,175
369684724,369682750,369699076,16326,2101,175
369705243,369703269,369717991,14722,2102,175
369724311,369722120,369738959,16839,2103,175
369745193,369743219,369759208,15989,2104,175
369765313,369763338,369779882,16544,2105,175
369786082,369784107,369801383,17276,2106,175
369807705,369805513,369821402,15889,2107,175
369827552,369825578,369839984,14406,2108,175
369846304,369844114,369861606,17492,2109,175
369867757,369865782,369881772,15990,2110,175
369887981,369886007,369902016,16009,2111,175
369908223,369906249,369923523,17274,2112,175
369929740,369927765,369943437,15672,2113,175
369949666,369947692,369962729,15037,2114,175
369968882,369966907,369983529,16622,2115,175
369989720,369987745,370002468,14723,2116,175
370008693,370006718,370023993,17275,2117,175
370030315,370028123,370043695,15572,2118,175
370049888,370047914,370063269,15355,2119,175
370069458,370067484,370082523,15039,2120,175
370088683,370086709,370103014,16305,2121,175
370109336,370107145,370122718,15573,2122,175
370129039,370126848,370143053,16205,2123,175
370149253,370147279,370163922,16643,2124,175
370170242,370168052,370183960,15908,2125,175
370190183,370188209,370202932,14723,2126,175
370209095,370207120,370222476,15356,2127,175
370228684,370226710,370241115,14405,2128,175
370247435,370245245,370262737,17492,2129,175
370268901,370266927,370284520,17593,2130,175
370290624,370288650,370305170,16520,2131,175
370311490,370309300,370325209,15909,2132,175
370331401,370329427,370345731,16304,2133,175
370352052,370349861,370366067,16206,2134,175
370372389,370370197,370386086,15889,2135,175
370392408,370390216,370406760,16544,2136,175
370413082,370410891,370426780,15889,2137,175
370432969,370430995,370447954,16959,2138,175
370454125,370452151,370467506,15355,2139,175
370473827,370471636,370487840,16204,2140,175
370494162,370491971,370509464,17493,2141,175
370515785,370513594,370531066,17472,2142,175
370537388,370535197,370551740,16543,2143,175
370557925,370555949,370571939,15990,2144,175
370578143,370576169,370592790,16621,2145,175
370598985,370597011,370611416,14405,2146,175
370617634,370615660,370630699,15039,2147,175
370636896,370634922,370649644,14722,2148,175
370655747,370653773,370669861,16088,2149,175
370676184,370673992,370691802,17810,2150,175
370698123,370695932,370711505,15573,2151,175
370717669,370715695,370732632,16937,2152,175
370738782,370736808,370752501,15693,2153,175
370758718,370756744,370773049,16305,2154,175
370779371,370777179,370793068,15889,2155,175
370799388,370797197,370813401,16204,2156,175
370819506,370817532,370834687,17155,2157,175
370840906,370838932,370855574,16642,2158,175
370861788,370859814,370877723,17909,2159,175
370883949,370881974,370897646,15672,2160,175
370903830,370901856,370916895,15039,2161,175
370923112,370921137,370935542,14405,2162,175
370941863,370939672,370954293,14621,2163,175
370960397,370958423,370975145,16722,2164,175
370981343,370979368,370996643,17275,2165,175
371002835,371000861,371017503,16642,2166,175
371023824,371021633,371036256,14623,2167,175
371042408,371040433,371056106,15673,2168,175
371062302,371060329,371076000,15671,2169,175
371082203,371080229,371094634,14405,2170,175
371100784,371098810,371115135,16325,2171,175
371121343,371119368,371133142,13774,2172,175
371139369,371137394,371154333,16939,2173,175
371160541,371158567,371173288,14721,2174,175
371179516,371177541,371193214,15673,2175,175
371199372,371197398,371211803,14405,2176,175
371218125,371215933,371232139,16206,2177,175
371238328,371236354,371253312,16958,2178,175
371259632,371257442,371272379,14937,2179,175
371278699,371276509,371294317,17808,2180,175
371300638,371298447,371315307,16860,2181,175
371321533,371319559,371335547,15988,2182,175
371341868,371339677,371355565,15888,2183,175
371361886,371359695,371375266,15571,2184,175
371381471,371379497,371394220,14723,2185,175
371400323,371398349,371414773,16424,2186,175
371421096,371418904,371434477,15573,2187,175
371440581,371438607,371453428,14821,2188,175
371459589,371457615,371474870,17255,2189,175
371481192,371479000,371493624,14624,2190,175
371499946,371497754,371515248,17494,2191,175
371521569,371519378,371534634,15256,2192,175
371540821,371538846,371552935,14089,2193,175
371559139,371557165,371573174,16009,2194,175
371579331,371577357,371591445,14088,2195,175
371597639,371595665,371615282,19617,2196,175
371621515,371619541,371636183,16642,2197,175
371642504,371640313,371654619,14306,2198,175
371660818,371658844,371674832,15988,2199,175
371681154,371678962,371695169,16207,2200,175
371701273,371699299,371715208,15909,2201,175
371721389,371719415,371736372,16957,2202,175
371742559,371740585,371758177,17592,2203,175
371764500,371762308,371776615,14307,2204,175
371782791,371780817,371797143,16326,2205,175
371803297,371801323,371815411,14088,2206,175
371821590,371819616,371835624,16008,2207,175
371841946,371839755,371856931,17176,2208,175
371863141,371861167,371876838,15671,2209,175
371882942,371880967,371895474,14507,2210,175
371901690,371899716,371916043,16327,2211,175
371922194,371920220,371934942,14722,2212,175
371941138,371939164,371956102,16938,2213,175
371962424,371960233,371976458,16225,2214,175
371982680,371980705,371997644,16939,2215,175
372003860,372001886,372015973,14087,2216,175
372022174,372020200,372036210,16010,2217,175
372042365,372040390,372056696,16306,2218,175
372063017,372060826,372077052,16226,2219,175
372083266,372081292,372095064,13772,2220,175
372101257,372099282,372114637,15355,2221,175
372120788,372118813,372134802,15989,2222,175
372141036,372139062,372156021,16959,2223,175
372162231,372160256,372174663,14407,2224,175
372180984,372178793,372194365,15572,2225,175
372200541,372198567,372213605,15038,2226,175
372219836,372217861,372234504,16643,2227,175
372240724,372238749,372253473,14724,2228,175
372259673,372257699,372275943,18244,2229,175
372282264,372280073,372297248,17175,2230,175
372303568,372301378,372318870,17492,2231,175
372325049,372323074,372340350,17276,2232,175
372346672,372344481,372361657,17176,2233,175
372367886,372365912,372380318,14406,2234,175
372386639,372384448,372402256,17808,2235,175
372408464,372406490,372422795,16305,2236,175
372429117,372426926,372443448,16522,2237,175
372449660,372447686,372463674,15988,2238,175
372469863,372467888,372482293,14405,2239,175
372488503,372486530,372502517,15987,2240,175
372508710,372506736,372522406,15670,2241,175
372528726,372526535,372543712,17177,2242,175
372550033,372547842,372564702,16860,2243,175
372570872,372568898,372584252,15354,2244,175
372590446,372588470,372604798,16328,2245,175
372610950,372608975,372624648,15673,2246,175
372630882,372628907,372644264,15357,2247,175
372650585,372648394,372663017,14623,2248,175
372669239,372667266,372681354,14088,2249,175
372687675,372685484,372701056,15572,2250,175
372707377,372705186,372722363,17177,2251,175
372728553,372726579,372741301,14722,2252,175
372747491,372745516,372762160,16644,2253,175
372768346,372766371,372782677,16306,2254,175
372788782,372786807,372805270,18463,2255,175
372811460,372809486,372826128,16642,2256,175
372832320,372830346,372847939,17593,2257,175
372854148,372852174,372868500,16326,2258,175
372874734,372872760,372887164,14404,2259,175
372893486,372891294,372908469,17175,2260,175
372914629,372912655,372926743,14088,2261,175
372932930,372930955,372948549,17594,2262,175
372954773,372952799,372967838,15039,2263,175
372974033,372972058,372986464,14406,2264,175
372992785,372990594,373007748,17154,2265,175
373014070,373011879,373028422,16543,2266,175
373034637,373032663,373047700,15037,2267,175
373053928,373051953,373068280,16327,2268,175
373074480,373072505,373090753,18248,2269,175
373096988,373095014,373109736,14722,2270,175
373116057,373113866,373130409,16543,2271,175
373136568,373134594,373150920,16326,2272,175
373157130,373155155,373172432,17277,2273,175
373178582,373176608,373192594,15986,2274,175
373198777,373196803,373212157,15354,2275,175
373218370,373216396,373233650,17254,2276,175
373239972,373237781,373254936,17155,2277,175
373261110,373259135,373276748,17613,2278,175
373282962,373280988,373297293,16305,2279,175
373303493,373301518,373318141,16623,2280,175
373324462,373322271,373339131,16860,2281,175
373345237,373343262,373361071,17809,2282,175
373367177,373365202,373382261,17059,2283,175
373388470,373386496,373403138,16642,2284,175
373409460,373407269,373421575,14306,2285,175
373427764,373425790,373442115,16325,2286,175
373448329,373446354,373462048,15694,2287,175
373468202,373466228,373482533,16305,2288,175
373488747,373486773,373504703,17930,2289,175
373510855,373508882,373524553,15671,2290,175
373530874,373528683,373545522,16839,2291,175
373551843,373549653,373565223,15570,2292,175
373571413,373569438,373584478,15040,2293,175
373590698,373588724,373604098,15374,2294,175
373610328,373608353,373623392,15039,2295,175
373629621,373627647,373643951,16304,2296,175
373650273,373648081,373664920,16839,2297,175
373671131,373669157,373684195,15038,2298,175
373690516,373688325,373703581,15256,2299,175
373709738,373707764,373725040,17276,2300,175
373731246,373729272,373746547,17275,2301,175
373752740,373750766,373766754,15988,2302,175
373773076,373770884,373788039,17155,2303,175
373794270,373792295,373806069,13774,2304,175
373812389,373810198,373826741,16543,2305,175
373833062,373830871,373848046,17175,2306,175
373854367,373852176,373868086,15910,2307,175
373874407,373872216,373888104,15888,2308,175
373894425,373892234,373908460,16226,2309,175
373914565,373912591,373928817,16226,2310,175
373935009,373933035,373948390,15355,2311,175
373954605,373952630,373966404,13774,2312,175
373972724,373970534,373986738,16204,2313,175
373992900,373990926,374008201,17275,2314,175
374014367,374012393,374028717,16324,2315,175
374034942,374032968,374049590,16622,2316,175
374055792,374053818,374069489,15671,2317,175
374075810,374073619,374088557,14938,2318,175
374094878,374092687,374108892,16205,2319,175
374115213,374113022,374128593,15571,2320,175
374134793,374132819,374149778,16959,2321,175
374155995,374154022,374170325,16303,2322,175
374176647,374174456,374189394,14938,2323,175
374195623,374193649,374209975,16326,2324,175
374216207,374214232,374230538,16306,2325,175
374236860,374234669,374250895,16226,2326,175
374257094,374255120,374272079,16959,2327,175
374278184,374276209,374292952,16743,2328,175
374299273,374297082,374314913,17831,2329,175
374321130,374319156,374334847,15691,2330,175
374341081,374339107,374353829,14722,2331,175
374360149,374357959,374373214,15255,2332,175
374379436,374377461,374391234,13773,2333,175
374397555,374395364,374412538,17174,2334,175
374418700,374416725,374432736,16011,2335,175
374438927,374436953,374452645,15692,2336,175
374458966,374456775,374473002,16227,2337,175
374479161,374477187,374492542,15355,2338,175
374498758,374496784,374510874,14090,2339,175
374517195,374515004,374532812,17808,2340,175
374539136,374536943,374554121,17178,2341,175
374560303,374558329,374574338,16009,2342,175
374580559,374578584,374594911,16327,2343,175
374601146,374599172,374614528,15356,2344,175
374620752,374618778,374633183,14405,2345,175
374639506,374637313,374655776,18463,2346,175
374661998,374660024,374678271,18247,2347,175
374684423,374682448,374699071,16623,2348,175
374705393,374703202,374718142,14940,2349,175
374724464,374722272,374738478,16206,2350,175
374744676,374742701,374759344,16643,2351,175
374765567,374763593,374780214,16621,2352,175
374786320,374784345,374801404,17059,2353,175
374807725,374805534,374820788,15254,2354,175
374827109,374824918,374841440,16522,2355,175
374847623,374845650,374861003,15353,2356,175
374867216,374865242,374882200,16958,2357,175
374888305,374886331,374902535,16204,2358,175
374908733,374906758,374920847,14089,2359,175
374927063,374925089,374942365,17276,2360,175
374948687,374946496,374962067,15571,2361,175
374968226,374966252,374981290,15038,2362,175
374987447,374985473,375002748,17275,2363,175
375008919,375006945,375022639,15694,2364,175
375028835,375026861,375044453,17592,2365,175
375050675,375048701,375066946,18245,2366,175
375073267,375071076,375086014,14938,2367,175
375092232,375090258,375104663,14405,2368,175
375110873,375108899,375125859,16960,2369,175
375132180,375129990,375145561,15571,2370,175
375151748,375149774,375164813,15039,2371,175
375171039,375169065,375184104,15039,2372,175
375190297,375188323,375204331,16008,2373,175
375210652,375208461,375223715,15254,2374,175
375229934,375227959,375243948,15989,2375,175
375250269,375248078,375264915,16837,2376,175
375271236,375269045,375285567,16522,2377,175
375291784,375289811,375305166,15355,2378,175
375311487,375309296,375326789,17493,2379,175
375333110,375330919,375347144,16225,2380,175
375353467,375351275,375368769,17494,2381,175
375375002,375373028,375387749,14721,2382,175
375393911,375391937,375408580,16643,2383,175
375414901,375412710,375429887,17177,2384,175
375436081,375434107,375452016,17909,2385,175
375458222,375456248,375473841,17593,2386,175
375479995,375478021,375494326,16305,2387,175
375500493,375498519,375515794,17275,2388,175
375522116,375519925,375536130,16205,2389,175
375542340,375540366,375555720,15354,2390,175
375561945,375559970,375576276,16306,2391,175
375582598,375580407,375596296,15889,2392,175
375602616,375600426,375617284,16858,2393,175
375623503,375621528,375637200,15672,2394,175
375643393,375641418,375659665,18247,2395,175
375665866,375663891,375680535,16644,2396,175
375686742,375684767,375700123,15356,2397,175
375706271,375704297,375719336,15039,2398,175
375725566,375723592,375737365,13773,2399,175
375743574,375741600,375756639,15039,2400,175
375762872,375760897,375777223,16326,2401,175
375783451,375781477,375798118,16641,2402,175
375804304,375802329,375818973,16644,2403,175
375825297,375823104,375839311,16207,2404,175
375845633,375843442,375859985,16543,2405,175
375866089,375864115,375878937,14822,2406,175
375885258,375883067,375900560,17493,2407,175
375906743,375904769,375920122,15353,2408,175
375926314,375924340,375941593,17253,2409,175
375947915,375945724,375959714,13990,2410,175
375965936,375963961,375980583,16622,2411,175
375986907,375984714,376000604,15890,2412,175
376006798,376004823,376021465,16642,2413,175
376027645,376025671,376043262,17591,2414,175
376049493,376047518,376064793,17275,2415,175
376071115,376068924,376086099,17175,2416,175
376092420,376090229,376107068,16839,2417,175
376113300,376111325,376126682,15357,2418,175
376133003,376130812,376145749,14937,2419,175
376152070,376149879,376165450,15571,2420,175
376171771,376169580,376185807,16227,2421,175
376192129,376189938,376205826,15888,2422,175
376212023,376210049,376227325,17276,2423,175
376233645,376231455,376246707,15252,2424,175
376252893,376250918,376266275,15357,2425,175
376272595,376270405,376286948,16543,2426,175
376293132,376291158,376306514,15356,2427,175
376312836,376310644,376325585,14941,2428,175
376331758,376329783,376346109,16326,2429,175
376352432,376350240,376367733,17493,2430,175
376373837,376371863,376387119,15256,2431,175
376393440,376391249,376409711,18462,2432,175
376415816,376413842,376430583,16741,2433,175
376436904,376434714,376450938,16224,2434,175
376457167,376455192,376471182,15990,2435,175
376477375,376475400,376490439,15039,2436,175
376496760,376494569,376511427,16858,2437,175
376517660,376515685,376531674,15989,2438,175
376537896,376535922,376553198,17276,2439,175
376559384,376557410,376575000,17590,2440,175
376581210,376579236,376594273,15037,2441,175
376600594,376598403,376615263,16860,2442,175
376621450,376619477,376634830,15353,2443,175
376641151,376638960,376654532,15572,2444,175
376660726,376658752,376673474,14722,2445,175
376679796,376677604,376692227,14623,2446,175
376698434,376696459,376712131,15672,2447,175
376718235,376716261,376733415,17154,2448,175
376739614,376737640,376753648,16008,2449,175
376759970,376757779,376773984,16205,2450,175
376780190,376778216,376794542,16326,2451,175
376800864,376798673,376816166,17493,2452,175
376822346,376820371,376835728,15357,2453,175
376841884,376839910,376854632,14722,2454,175
376860781,376858807,376875132,16325,2455,175
376881316,376879342,376894697,15355,2456,175
376900888,376898914,376915556,16642,2457,175
376921779,376919804,376935181,15377,2458,175
376941409,376939435,376956077,16642,2459,175
376962247,376960273,376976261,15988,2460,175
376982434,376980459,376998369,17910,2461,175
377004595,377002621,377017975,15354,2462,175
377024297,377022105,377039599,17494,2463,175
377045764,377043789,377062036,18247,2464,175
377068221,377066247,377082257,16010,2465,175
377088361,377086387,377102475,16088,2466,175
377108674,377106700,377122688,15988,2467,175
377129009,377126818,377145281,18463,2468,175
377151481,377149506,377166149,16643,2469,175
377172471,377170280,377187456,17176,2470,175
377193649,377191674,377209584,17910,2471,175
377215689,377213715,377229802,16087,2472,175
377235984,377234010,377249049,15039,2473,175
377255270,377253297,377269621,16324,2474,175
377275808,377273833,377289823,15990,2475,175
377295927,377293953,377309723,15770,2476,175
377315937,377313962,377328051,14089,2477,175
377334155,377332181,377346487,14306,2478,175
377352808,377350617,377366821,16204,2479,175
377373142,377370951,377387157,16206,2480,175
377393372,377391398,377409643,18245,2481,175
377415813,377413839,377429511,15672,2482,175
377435691,377433717,377450022,16305,2483,175
377456343,377454152,377470041,15889,2484,175
377476226,377474252,377490895,16643,2485,175
377497084,377495109,377513356,18247,2486,175
377519514,377517540,377533865,16325,2487,175
377540034,377538060,377553098,15038,2488,175
377559202,377557228,377573115,15887,2489,175
377579339,377577365,377594325,16960,2490,175
377600431,377598456,377613910,15454,2491,175
377620126,377618152,377633190,15038,2492,175
377639394,377637419,377653408,15989,2493,175
377659728,377657537,377673762,16225,2494,175
377680084,377677892,377694435,16543,2495,175
377700540,377698565,377715088,16523,2496,175
377721238,377719264,377734640,15376,2497,175
377740744,377738770,377754026,15256,2498,175
377760174,377758200,377775158,16958,2499,175
377781480,377779288,377795176,15888,2500,175
377801356,377799382,377815391,16009,2501,175
377821619,377819644,377835971,16327,2502,175
377842169,377840194,377855551,15357,2503,175
377861655,377859681,377874819,15138,2504,175
377881051,377879076,377894115,15039,2505,175
377900436,377898245,377913837,15592,2506,175
377920056,377918082,377935357,17275,2507,175
377941568,377939593,377954948,15355,2508,175
377961144,377959171,377974841,15670,2509,175
377981025,377979051,377993140,14089,2510,175
377999461,377997270,378013474,16204,2511,175
378019682,378017708,378034011,16303,2512,175
378040168,378038195,378053865,15670,2513,175
378060094,378058120,378074741,16621,2514,175
378081064,378078872,378094761,15889,2515,175
378101082,378098891,378114463,15572,2516,175
378120690,378118716,378134704,15988,2517,175
378140923,378138948,378157195,18247,2518,175
378163404,378161429,378176784,15355,2519,175
378183015,378181041,378196713,15672,2520,175
378202930,378200956,378215679,14723,2521,175
378222000,378219809,378234746,14937,2522,175
378240955,378238981,378255941,16960,2523,175
378262152,378260178,378275215,15037,2524,175
378281423,378279449,378294805,15356,2525,175
378301037,378299063,378316338,17275,2526,175
378322492,378320517,378334606,14089,2527,175
378340927,378338736,378354308,15572,2528,175
378360472,378358497,378373537,15040,2529,175
378379859,378377667,378393557,15890,2530,175
378399878,378397687,378413597,15910,2531,175
378419770,378417795,378435386,17591,2532,175
378441708,378439517,378453823,14306,2533,175
378459985,378458010,378472417,14407,2534,175
378478573,378476599,378490688,14089,2535,175
378497009,378494818,378510706,15888,2536,175
378516926,378514952,378529673,14721,2537,175
378535882,378533907,378549263,15356,2538,175
378555584,378553393,378570252,16859,2539,175
378576357,378574382,378590808,16426,2540,175
378596914,378594939,378610829,15890,2541,175
378617038,378615063,378630419,15356,2542,175
378636740,378634549,378652041,17492,2543,175
378658234,378656259,378674506,18247,2544,175
378680670,378678696,378694051,15355,2545,175
378700372,378698181,378715673,17492,2546,175
378721880,378719906,378735599,15693,2547,175
378741704,378739729,378757105,17376,2548,175
378763328,378761355,378777026,15671,2549,175
378783347,378781156,378797677,16521,2550,175
378803905,378801931,378820177,18246,2551,175
378826409,378824435,378841077,16642,2552,175
378847263,378845289,378862248,16959,2553,175
378868570,378866379,378884842,18463,2554,175
378890999,378889024,378906637,17613,2555,175
378912813,378910839,378926193,15354,2556,175
378932343,378930369,378945090,14721,2557,175
378951194,378949220,378964359,15139,2558,175
378970680,378968489,378984713,16224,2559,175
378990937,378988963,379004951,15988,2560,175
379011271,379009081,379023069,13988,2561,175
379029389,379027199,379043424,16225,2562,175
379049530,379047555,379064099,16544,2563,175
379070304,379068330,379083685,15355,2564,175
379089880,379087906,379102311,14405,2565,175
379108633,379106442,379122648,16206,2566,175
379128845,379126871,379144147,17276,2567,175
379150342,379148367,379165011,16644,2568,175
379171237,379169263,379186855,17592,2569,175
379193077,379191103,379205825,14722,2570,175
379212147,379209955,379225210,15255,2571,175
379231419,379229444,379246404,16960,2572,175
379252727,379250535,379267396,16861,2573,175
379273501,379271527,379285716,14189,2574,175
379291895,379289920,379305276,15356,2575,175
379311479,379309504,379325513,16009,2576,175
379331836,379329644,379346189,16545,2577,175
379352360,379350386,379366395,16009,2578,175
379372611,379370636,379385676,15040,2579,175
379391997,379389806,379407615,17809,2580,175
379413848,379411874,379428516,16642,2581,175
379434714,379432740,379448095,15355,2582,175
379454305,379452331,379466418,14087,2583,175
379472739,379470548,379485487,14939,2584,175
379491697,379489722,379505711,15989,2585,175
379511927,379509952,379525308,15356,2586,175
379531629,379529438,379546614,17176,2587,175
379552824,379550850,379567470,16620,2588,175
379573660,379571686,379587378,15692,2589,175
379593615,379591640,379608915,17275,2590,175
379615134,379613160,379631090,17930,2591,175
379637242,379635268,379650939,15671,2592,175
379657134,379655160,379670198,15038,2593,175
379676520,379674329,379690535,16206,2594,175
379696755,379694781,379710453,15672,2595,175
379716636,379714662,379730968,16306,2596,175
379737291,379735099,379752276,17177,2597,175
379758508,379756534,379773176,16642,2598,175
379779497,379777307,379794461,17154,2599,175
379800632,379798658,379816566,17908,2600,175
379822774,379820799,379836789,15990,2601,175
379842991,379841017,379857956,16939,2602,175
379864187,379862213,379879172,16959,2603,175
379885386,379883412,379900686,17274,2604,175
379906869,379904895,379922803,17908,2605,175
379928961,379926987,379941393,14406,2606,175
379947498,379945523,379963217,17694,2607,175
379969396,379967422,379982776,15354,2608,175
379988981,379987007,380004600,17593,2609,175
380010783,380008809,380024818,16009,2610,175
380031139,380028949,380044541,15592,2611,175
380050763,380048789,380066382,17593,2612,175
380072591,380070617,380086605,15988,2613,175
380092710,380090736,380107911,17175,2614,175
380114234,380112043,380127298,15255,2615,175
380133491,380131517,380145606,14089,2616,175
380151834,380149859,380165531,15672,2617,175
380171681,380169707,380186012,16305,2618,175
380192226,380190252,380205606,15354,2619,175
380211928,380209737,380226258,16521,2620,175
380232467,380230494,380245531,15037,2621,175
380251741,380249767,380266725,16958,2622,175
380272877,380270903,380287861,16958,2623,175
380294084,380292110,380307149,15039,2624,175
380313309,380311334,380326691,15357,2625,175
380332892,380330918,380347540,16622,2626,175
380353727,380351753,380367761,16008,2627,175
380374083,380371892,380389701,17809,2628,175
380396022,380393832,380409403,15571,2629,175
380415509,380413534,380429308,15774,2630,175
380435503,380433528,380449538,16010,2631,175
380455756,380453782,380470106,16324,2632,175
380476303,380474328,380489366,15038,2633,175
380495576,380493602,380510245,16643,2634,175
380516567,380514376,380531551,17175,2635,175
380537783,380535809,380552114,16305,2636,175
380558301,380556326,380573940,17614,2637,175
380580262,380578071,380593960,15889,2638,175
380600162,380598188,380615781,17593,2639,175
380621887,380619912,380635051,15139,2640,175
380641374,380639182,380656358,17176,2641,175
380662587,380660612,380677550,16938,2642,175
380683738,380681763,380699693,17930,2643,175
380705798,380703824,380720050,16226,2644,175
380726280,380724306,380739977,15671,2645,175
380746298,380744107,380759680,15573,2646,175
380766003,380763811,380778749,14938,2647,175
380784958,380782984,380797706,14722,2648,175
380803925,380801950,380817621,15671,2649,175
380823825,380821850,380838154,16304,2650,175
380844477,380842285,380860095,17810,2651,175
380866417,380864226,380880748,16522,2652,175
380886969,380884995,380900667,15672,2653,175
380906990,380904798,380921974,17176,2654,175
380928130,380926156,380941511,15355,2655,175
380947694,380945721,380962678,16957,2656,175
380969001,380966809,380984303,17494,2657,175
380990624,380988434,381004975,16541,2658,175
381011297,381009106,381026598,17492,2659,175
381032920,381030729,381046956,16227,2660,175
381053062,381051087,381068896,17809,2661,175
381075219,381073027,381087967,14940,2662,175
381094289,381092097,381108958,16861,2663,175
381115173,381113198,381130158,16960,2664,175
381136394,381134419,381151695,17276,2665,175
381158016,381155826,381173002,17176,2666,175
381179323,381177133,381193019,15886,2667,175
381199170,381197196,381215441,18245,2668,175
381221671,381219697,381234736,15039,2669,175
381240917,381238943,381255248,16305,2670,175
381261569,381259379,381277187,17808,2671,175
381283509,381281318,381296258,14940,2672,175
381302453,381300479,381318071,17592,2673,175
381324289,381322314,381338620,16306,2674,175
381344839,381342865,381360479,17614,2675,175
381366801,381364610,381382735,18125,2676,175
381388892,381386918,381402590,15672,2677,175
381408744,381406770,381422125,15355,2678,175
381428284,381426309,381442298,15989,2679,175
381448485,381446511,381460916,14405,2680,175
381467097,381465123,381481110,15987,2681,175
381487312,381485338,381499427,14089,2682,175
381505591,381503617,381519288,15671,2683,175
381525478,381523504,381538860,15356,2684,175
381545079,381543105,381561352,18247,2685,175
381567674,381565483,381582976,17493,2686,175
381589298,381587107,381601411,14304,2687,175
381607733,381605542,381622064,16522,2688,175
381628169,381626195,381642283,16088,2689,175
381648494,381646520,381661242,14722,2690,175
381667563,381665372,381682211,16839,2691,175
381688424,381686450,381701826,15376,2692,175
381708054,381706079,381720801,14722,2693,175
381726905,381724931,381740724,15793,2694,175
381746943,381744968,381760324,15356,2695,175
381766481,381764507,381781127,16620,2696,175
381787362,381785388,381801397,16009,2697,175
381807599,381805625,381822900,17275,2698,175
381829127,381827152,381842192,15040,2699,175
381848380,381846406,381863365,16959,2700,175
381869687,381867496,381882752,15256,2701,175
381888955,381886981,381902990,16009,2702,175
381909208,381907233,381921955,14722,2703,175
381928122,381926148,381942791,16643,2704,175
381949002,381947028,381964936,17908,2705,175
381971143,381969169,381984524,15355,2706,175
381990737,381988764,382003801,15037,2707,175
382010124,382007932,382024158,16226,2708,175
382030480,382028289,382045444,17155,2709,175
382051767,382049576,382065486,15910,2710,175
382071692,382069717,382086340,16623,2711,175
382092560,382090586,382104991,14405,2712,175
382111226,382109252,382123657,14405,2713,175
382129864,382127890,382143879,15989,2714,175
382150201,382148010,382162950,14940,2715,175
382169155,382167181,382183190,16009,2716,175
382189512,382187321,382202576,15255,2717,175
382208899,382206707,382223251,16544,2718,175
382229463,382227489,382242844,15355,2719,175
382249017,382247043,382263031,15988,2720,175
382269186,382267212,382280985,13773,2721,175
382287306,382285115,382301954,16839,2722,175
382308119,382306145,382321184,15039,2723,175
382327356,382325382,382341687,16305,2724,175
382347898,382345924,382362884,16960,2725,175
382369110,382367136,382384750,17614,2726,175
382390955,382388981,382403702,14721,2727,175
382410024,382407832,382424693,16861,2728,175
382430852,382428878,382444233,15355,2729,175
382450555,382448364,382465857,17493,2730,175
382472180,382469988,382486848,16860,2731,175
382493068,382491094,382508369,17275,2732,175
382514572,382512598,382528587,15989,2733,175
382534692,382532718,382549895,17177,2734,175
382556090,382554116,382569788,15672,2735,175
382576012,382574037,382591630,17593,2736,175
382597953,382595761,382611017,15256,2737,175
382617338,382615148,382633294,18146,2738,175
382639448,382637473,382654117,16644,2739,175
382660323,382658348,382673070,14722,2740,175
382679289,382677315,382693621,16306,2741,175
382699943,382697752,382713958,16206,2742,175
382720115,382718141,382733497,15356,2743,175
382739656,382737682,382753671,15989,2744,175
382759880,382757905,382773599,15694,2745,175
382779703,382777729,382794905,17176,2746,175
382801131,382799156,382815778,16622,2747,175
382821938,382819964,382836267,16303,2748,175
382842458,382840484,382856811,16327,2749,175
382863019,382861044,382877372,16328,2750,175
382883565,382881591,382895680,14089,2751,175
382901886,382899913,382914951,15038,2752,175
382921121,382919146,382934817,15671,2753,175
382941033,382939058,382954414,15356,2754,175
382960570,382958596,382973635,15039,2755,175
382979956,382977766,382991755,13989,2756,175
382997960,382995985,383011996,16011,2757,175
383018318,383016127,383033619,17492,2758,175
383039942,383037750,383054907,17157,2759,175
383061060,383059086,383073490,14404,2760,175
383079668,383077694,383093704,16010,2761,175
383100026,383097835,383113724,15889,2762,175
383119889,383117915,383133903,15988,2763,175
383140123,383138148,383156395,18247,2764,175
383162717,383160526,383176434,15908,2765,175
383182624,383180650,383196005,15355,2766,175
383202229,383200255,383215927,15672,2767,175
383222078,383220105,383235796,15691,2768,175
383241999,383240025,383255379,15354,2769,175
383261701,383259509,383275420,15911,2770,175
383281593,383279619,383295629,16010,2771,175
383301736,383299761,383314584,14823,2772,175
383320765,383318791,383334146,15355,2773,175
383340306,383338332,383353053,14721,2774,175
383359376,383357184,383373412,16228,2775,175
383379563,383377588,383393599,16011,2776,175
383399807,383397833,383414158,16325,2777,175
383420376,383418401,383435677,17276,2778,175
383441907,383439932,383454654,14722,2779,175
383460976,383458785,383473408,14623,2780,175
383479604,383477628,383491403,13775,2781,175
383497611,383495637,383509726,14089,2782,175
383515832,383513857,383531330,17473,2783,175
383537481,383535507,383550544,15037,2784,175
383556752,383554778,383571736,16958,2785,175
383578058,383575867,383592705,16838,2786,175
383599028,383596837,383613357,16520,2787,175
383619679,383617488,383634347,16859,2788,175
383640507,383638533,383655154,16621,2789,175
383661372,383659398,383675704,16306,2790,175
383681891,383679916,383696223,16307,2791,175
383702451,383700477,383717119,16642,2792,175
383723286,383721311,383737300,15989,2793,175
383743623,383741431,383757321,15890,2794,175
383763643,383761452,383778311,16859,2795,175
383784634,383782443,383800590,18147,2796,175
383806913,383804721,383820947,16226,2797,175
383827270,383825079,383841306,16227,2798,175
383847533,383845558,383861230,15672,2799,175
383867381,383865406,383881711,16305,2800,175
383888033,383885842,383902066,16224,2801,175
383908388,383906198,383921769,15571,2802,175
383927975,383926001,383941673,15672,2803,175
383947994,383945804,383960742,14938,2804,175
383966978,383965003,383980675,15672,2805,175
383986997,383984806,383999746,14940,2806,175
384006067,384003877,384020714,16837,2807,175
384027036,384024845,384040100,15255,2808,175
384046292,384044317,384058723,14406,2809,175
384064949,384062975,384078645,15670,2810,175
384084843,384082869,384099491,16622,2811,175
384105653,384103679,384118718,15039,2812,175
384124872,384122898,384138591,15693,2813,175
384144808,384142833,384159139,16306,2814,175
384165374,384163399,384181646,18247,2815,175
384187842,384185867,384200274,14407,2816,175
384206595,384204404,384219976,15572,2817,175
384226297,384224106,384239679,15573,2818,175
384246000,384243809,384260352,16543,2819,175
384266549,384264574,384281216,16642,2820,175
384287539,384285347,384301236,15889,2821,175
384307556,384305366,384321887,16521,2822,175
384328105,384326130,384341803,15673,2823,175
384348124,384345933,384361822,15889,2824,175
384368007,384366033,384380753,14720,2825,175
384387075,384384884,384401722,16838,2826,175
384407918,384405944,384420666,14722,2827,175
384426835,384424861,384441820,16959,2828,175
384448047,384446073,384462082,16009,2829,175
384468268,384466293,384482303,16010,2830,175
384488625,384486434,384502659,16225,2831,175
384508895,384506921,384522909,15988,2832,175
384529088,384527113,384544051,16938,2833,175
384550372,384548182,384562803,14621,2834,175
384569035,384567060,384583049,15989,2835,175
384589275,384587301,384603289,15988,2836,175
384609519,384607543,384623532,15989,2837,175
384629853,384627662,384643233,15571,2838,175
384649337,384647363,384663135,15772,2839,175
384669361,384667387,384683079,15692,2840,175
384689287,384687313,384702033,14720,2841,175
384708137,384706163,384722568,16405,2842,175
384728771,384726797,384743440,16643,2843,175
384749666,384747692,384762731,15039,2844,175
384768936,384766962,384783604,16642,2845,175
384789927,384787735,384803624,15889,2846,175
384809729,384807755,384824297,16542,2847,175
384830507,384828532,384845807,17275,2848,175
384852025,384850050,384864772,14722,2849,175
384871093,384868902,384885127,16225,2850,175
384891283,384889308,384905614,16306,2851,175
384911851,384909876,384925549,15673,2852,175
384931870,384929679,384945251,15572,2853,175
384951430,384949456,384964831,15375,2854,175
384970991,384969016,384984371,15355,2855,175
384990692,384988501,385005677,17176,2856,175
385011999,385009808,385026984,17176,2857,175
385033134,385031159,385046832,15673,2858,175
385053025,385051051,385068663,17612,2859,175
385074894,385072920,385087326,14406,2860,175
385093647,385091456,385107683,16227,2861,175
385113871,385111897,385128539,16642,2862,175
385134861,385132670,385149213,16543,2863,175
385155384,385153410,385170368,16958,2864,175
385176690,385174499,385191357,16858,2865,175
385197577,385195603,385213512,17909,2866,175
385219705,385217730,385233402,15672,2867,175
385239723,385237532,385254708,17176,2868,175
385260892,385258918,385275223,16305,2869,175
385281410,385279436,385294157,14721,2870,175
385300479,385298288,385316414,18126,2871,175
385322626,385320651,385337928,17277,2872,175
385344138,385342164,385356569,14405,2873,175
385362890,385360699,385376272,15573,2874,175
385382422,385380448,385394854,14406,2875,175
385400958,385398984,385415843,16859,2876,175
385422057,385420083,385434805,14722,2877,175
385441126,385438935,385454190,15255,2878,175
385460341,385458367,385475643,17276,2879,175
385481965,385479774,385495684,15910,2880,175
385502005,385499814,385514435,14621,2881,175
385520643,385518669,385536282,17613,2882,175
385542498,385540523,385556534,16011,2883,175
385562695,385560721,385576707,15986,2884,175
385583029,385580838,385597065,16227,2885,175
385603240,385601265,385616621,15356,2886,175
385622779,385620804,385635844,15040,2887,175
385642003,385640028,385655068,15040,2888,175
385661302,385659327,385675317,15990,2889,175
385681496,385679522,385694560,15038,2890,175
385700768,385698794,385717040,18246,2891,175
385723250,385721275,385737265,15990,2892,175
385743498,385741523,385756562,15039,2893,175
385762884,385760693,385775632,14939,2894,175
385781835,385779860,385796820,16960,2895,175
385803142,385800951,385817176,16225,2896,175
385823281,385821307,385839337,18030,2897,175
385845660,385843469,385859674,16205,2898,175
385865898,385863923,385878645,14722,2899,175
385884804,385882829,385899135,16306,2900,175
385905350,385903376,385920652,17276,2901,175
385926864,385924890,385941828,16938,2902,175
385948037,385946062,385961419,15357,2903,175
385967570,385965596,385980318,14722,2904,175
385986640,385984449,386000675,16226,2905,175
386006884,386004910,386018998,14088,2906,175
386025102,386023128,386040166,17038,2907,175
386046488,386044297,386060503,16206,2908,175
386066673,386064699,386081003,16304,2909,175
386087162,386085187,386101809,16622,2910,175
386108001,386106027,386122353,16326,2911,175
386128675,386126484,386143661,17177,2912,175
386149985,386147793,386165623,17830,2913,175
386171729,386169754,386185327,15573,2914,175
386191505,386189531,386206490,16959,2915,175
386212678,386210703,386225742,15039,2916,175
386231955,386229981,386247573,17592,2917,175
386253895,386251704,386267275,15571,2918,175
386273597,386271406,386287949,16543,2919,175
386294179,386292205,386306610,14405,2920,175
386312931,386310740,386328885,18145,2921,175
386335092,386333118,386350394,17276,2922,175
386356589,386354614,386370287,15673,2923,175
386376610,386374418,386390961,16543,2924,175
386397185,386395211,386411199,15988,2925,175
386417414,386415439,386430478,15039,2926,175
386436683,386434707,386451035,16328,2927,175
386457357,386455166,386469473,14307,2928,175
386475689,386473714,386490653,16939,2929,175
386496866,386494892,386511197,16305,2930,175
386517518,386515328,386531847,16519,2931,175
386538075,386536100,386552090,15990,2932,175
386558411,386556220,386572446,16226,2933,175
386578642,386576668,386592994,16326,2934,175
386599183,386597208,386612563,15355,2935,175
386618884,386616693,386631631,14938,2936,175
386637837,386635862,386652485,16623,2937,175
386658686,386656712,386673988,17276,2938,175
386680200,386678226,386694215,15989,2939,175
386700392,386698418,386713457,15039,2940,175
386719779,386717587,386733160,15573,2941,175
386739322,386737348,386752702,15354,2942,175
386758854,386756880,386772552,15672,2943,175
386778873,386776682,386792570,15888,2944,175
386798893,386796701,386813561,16860,2945,175
386819784,386817809,386833820,16011,2946,175
386839979,386838004,386854626,16622,2947,175
386860848,386858874,386876465,17591,2948,175
386882690,386880716,386897359,16643,2949,175
386903572,386901598,386917270,15672,2950,175
386923464,386921489,386936213,14724,2951,175
386942534,386940343,386957518,17175,2952,175
386963669,386961695,386976417,14722,2953,175
386982614,386980639,386995993,15354,2954,175
387002314,387000123,387014745,14622,2955,175
387020962,387018988,387032761,13773,2956,175
387038984,387037010,387052048,15038,2957,175
387058370,387056178,387072722,16544,2958,175
387078907,387076933,387092604,15671,2959,175
387098925,387096734,387113594,16860,2960,175
387119812,387117838,387134141,16303,2961,175
387140368,387138394,387152167,13773,2962,175
387158488,387156297,387171235,14938,2963,175
387177386,387175412,387191083,15671,2964,175
387197403,387195213,387211122,15909,2965,175
387217443,387215252,387230189,14937,2966,175
387236510,387234319,387249257,14938,2967,175
387255432,387253457,387270712,17255,2968,175
387276817,387274843,387291248,16405,2969,175
387297570,387295379,387313842,18463,2970,175
387320164,387317973,387335781,17808,2971,175
387342103,387339912,387355482,15570,2972,175
387361586,387359612,387373799,14187,2973,175
387379966,387377991,387396239,18248,2974,175
387402445,387400470,387415826,15356,2975,175
387422146,387419956,387436181,16225,2976,175
387442397,387440423,387457361,16938,2977,175
387463683,387461492,387478034,16542,2978,175
387484214,387482240,387498228,15988,2979,175
387504548,387502358,387517295,14937,2980,175
387523507,387521532,387536888,15356,2981,175
387543209,387541018,387557877,16859,2982,175
387564074,387562100,387578110,16010,2983,175
387584282,387582308,387598950,16642,2984,175
387605183,387603208,387618880,15672,2985,175
387625032,387623057,387639067,16010,2986,175
387645260,387643286,387660562,17276,2987,175
387666772,387664798,387680153,15355,2988,175
387686368,387684394,387700403,16009,2989,175
387706725,387704534,387721393,16859,2990,175
387727610,387725635,387741012,15377,2991,175
387747198,387745224,387758996,13772,2992,175
387765100,387763126,387779353,16227,2993,175
387785561,387783587,387799892,16305,2994,175
387806108,387804133,387820122,15989,2995,175
387826302,387824328,387839366,15038,2996,175
387845471,387843497,387861187,17690,2997,175
387867509,387865318,387882493,17175,2998,175
387888701,387886727,387902715,15988,2999,175
387909037,387906846,387923706,16860,3000,175
387929928,387927954,387943307,15353,3001,175
387949529,387947555,387964198,16643,3002,175
387970407,387968431,387985392,16961,3003,175
387991562,387989587,388006526,16939,3004,175
388012848,388010657,388026546,15889,3005,175
388032759,388030785,388046140,15355,3006,175
388052350,388050375,388066998,16623,3007,175
388073105,388071130,388086268,15138,3008,175
388092478,388090504,388106176,15672,3009,175
388112338,388110363,388126669,16306,3010,175
388132873,388130899,388146570,15671,3011,175
388152892,388150700,388167560,16860,3012,175
388173765,388171791,388187144,15353,3013,175
388193465,388191274,388208449,17175,3014,175
388214682,388212708,388228085,15377,3015,175
388234271,388232296,388248306,16010,3016,175
388254627,388252437,388268347,15910,3017,175
388274668,388272478,388287733,15255,3018,175
388293962,388291988,388309917,17929,3019,175
388316073,388314099,388329770,15671,3020,175
388335874,388333900,388350327,16427,3021,175
388356649,388354458,388371318,16860,3022,175
388377521,388375546,388390268,14722,3023,175
388396590,388394398,388411892,17494,3024,175
388418110,388416134,388430541,14407,3025,175
388436767,388434793,388448882,14089,3026,175
388455204,388453013,388470821,17808,3027,175
388477143,388474952,388491790,16838,3028,175
388498001,388496027,388513303,17276,3029,175
388519538,388517564,388532287,14723,3030,175
388538501,388536527,388552199,15672,3031,175
388558410,388556436,388572108,15672,3032,175
388578300,388576325,388592653,16328,3033,175
388598838,388596863,388611586,14723,3034,175
388617909,388615717,388633528,17811,3035,175
388639634,388637659,388653548,15889,3036,175
388659759,388657784,388675060,17276,3037,175
388681382,388679191,388695397,16206,3038,175
388701624,388699650,388713740,14090,3039,175
388719891,388717916,388733589,15673,3040,175
388739910,388737720,388755211,17491,3041,175
388761534,388759342,388773648,14306,3042,175
388779752,388777779,388793666,15887,3043,175
388799865,388797890,388812929,15039,3044,175
388819250,388817059,388833601,16542,3045,175
388839753,388837779,388854422,16643,3046,175
388860744,388858553,388874125,15572,3047,175
388880230,388878256,388894977,16721,3048,175
388901143,388899170,388915157,15987,3049,175
388921339,388919365,388935691,16326,3050,175
388941901,388939927,388954649,14722,3051,175
388960866,388958891,388976168,17277,3052,175
388982339,388980365,388996690,16325,3053,175
389003012,389000821,389015759,14938,3054,175
389022080,389019889,389035460,15571,3055,175
389041686,389039712,389055721,16009,3056,175
389061954,389059980,389077256,17276,3057,175
389083483,389081510,389095281,13771,3058,175
389101386,389099412,389114866,15454,3059,175
389121065,389119090,389135712,16622,3060,175
389142033,389139843,389157989,18146,3061,175
389164311,389162120,389178028,15908,3062,175
389184202,389182228,389199186,16958,3063,175
389205509,389203317,389220155,16838,3064,175
389226346,389224371,389238461,14090,3065,175
389244659,389242685,389259643,16958,3066,175
389265815,389263841,389278879,15038,3067,175
389285201,389283010,389299215,16205,3068,175
389305401,389303427,389320386,16959,3069,175
389326542,389324568,389340556,15988,3070,175
389346877,389344686,389362179,17493,3071,175
389368501,389366310,389383485,17175,3072,175
389389682,389387707,389402747,15040,3073,175
389408956,389406981,389423602,16621,3074,175
389429924,389427733,389445564,17831,3075,175
389451784,389449811,389465165,15354,3076,175
389471321,389469347,389487592,18245,3077,175
389493772,389491798,389506836,15038,3078,175
389513062,389511089,389526444,15355,3079,175
389532667,389530693,389548285,17592,3080,175
389554483,389552508,389569784,17276,3081,175
389576017,389574043,389590368,16325,3082,175
389596529,389594554,389609910,15356,3083,175
389616074,389614099,389629138,15039,3084,175
389635360,389633386,389648109,14723,3085,175
389654430,389652239,389669098,16859,3086,175
389675296,389673322,389690280,16958,3087,175
389696486,389694511,389711788,17277,3088,175
389718021,389716047,389732056,16009,3089,175
389738240,389736266,389752590,16324,3090,175
389758911,389756721,389772947,16226,3091,175
389779124,389777150,389793455,16305,3092,175
389799619,389797644,389813654,16010,3093,175
389819880,389817905,389833262,15357,3094,175
389839584,389837393,389852964,15571,3095,175
389859190,389857216,389872571,15355,3096,175
389878747,389876773,389891496,14723,3097,175
389897693,389895720,389911075,15355,3098,175
389917397,389915206,389931748,16542,3099,175
389937854,389935879,389951987,16108,3100,175
389958197,389956222,389971894,15672,3101,175
389978055,389976081,389990487,14406,3102,175
389996685,389994711,390011669,16958,3103,175
390017854,390015880,390031868,15988,3104,175
390038064,390036090,390052416,16326,3105,175
390058738,390056547,390071486,14939,3106,175
390077669,390075695,390089783,14088,3107,175
390096012,390094037,390110680,16643,3108,175
390116894,390114921,390129643,14722,3109,175
390135851,390133876,390149231,15355,3110,175
390155336,390153362,390168183,14821,3111,175
390174505,390172314,390188836,16522,3112,175
390195158,390192967,390206956,13989,3113,175
390213166,390211192,390225598,14406,3114,175
390231807,390229833,390245821,15988,3115,175
390251973,390249999,390265671,15672,3116,175
390271776,390269802,390287178,17376,3117,175
390293391,390291417,390306773,15356,3118,175
390313095,390310904,390329051,18147,3119,175
390335374,390333183,390348439,15256,3120,175
390354658,390352683,390368692,16009,3121,175
390374880,390372905,390388893,15988,3122,175
390395090,390393116,390408787,15671,3123,175
390415109,390412918,390428172,15254,3124,175
390434494,390432302,390448213,15911,3125,175
390454412,390452437,390466210,13773,3126,175
390472428,390470454,390486145,15691,3127,175
390492337,390490363,390506373,16010,3128,175
390512603,390510628,390525984,15356,3129,175
390532306,390530115,390546341,16226,3130,175
390552446,390550472,390567531,17059,3131,175
390573853,390571662,390589809,18147,3132,175
390595960,390593986,390608708,14722,3133,175
390614900,390612925,390629885,16960,3134,175
390636207,390634016,390649272,15256,3135,175
390655500,390653526,390671434,17908,3136,175
390677757,390675565,390690822,15257,3137,175
390696979,390695005,390710676,15671,3138,175
390716904,390714929,390731889,16960,3139,175
390738039,390736065,390752053,15988,3140,175
390758375,390756184,390773042,16858,3141,175
390779208,390777233,390792590,15357,3142,175
390798810,390796835,390811240,14405,3143,175
390817418,390815444,390833352,17908,3144,175
390839524,390837549,390854509,16960,3145,175
390860832,390858640,390875162,16522,3146,175
390881329,390879356,390896631,17275,3147,175
390902954,390900763,390915385,14622,3148,175
390921595,390919621,390933710,14089,3149,175
390940032,390937841,390954068,16227,3150,175
390960278,390958304,390972077,13773,3151,175
390978287,390976313,390991036,14723,3152,175
390997356,390995166,391012658,17492,3153,175
391018980,391016789,391032045,15256,3154,175
391038256,391036280,391050688,14408,3155,175
391056916,391054942,391070612,15670,3156,175
391076827,391074853,391089576,14723,3157,175
391095897,391093706,391109595,15889,3158,175
391115801,391113826,391129183,15357,3159,175
391135396,391133423,391148460,15037,3160,175
391154617,391152642,391169919,17277,3161,175
391176141,391174167,391190810,16643,3162,175
391197132,391194941,391211484,16543,3163,175
391217639,391215665,391231653,15988,3164,175
391237835,391235861,391253137,17276,3165,175
391259357,391257383,391273687,16304,3166,175
391280009,391277818,391294360,16542,3167,175
391300561,391298586,391314258,15672,3168,175
391320478,391318504,391333859,15355,3169,175
391340180,391337989,391352295,14306,3170,175
391358514,391356539,391373816,17277,3171,175
391379965,391377991,391393347,15356,3172,175
391399567,391397593,391412631,15038,3173,175
391418812,391416838,391433164,16326,3174,175
391439330,391437356,391452731,15375,3175,175
391459051,391456861,391473719,16858,3176,175
391479956,391477981,391493675,15694,3177,175
391499883,391497909,391512629,14720,3178,175
391518952,391516760,391532017,15257,3179,175
391538239,391536264,391553224,16960,3180,175
391559546,391557355,391574511,17156,3181,175
391580739,391578765,391595071,16306,3182,175
391601176,391599202,391615121,15919,3183,175
391621341,391619367,391636643,17276,3184,175
391642851,391640877,391657520,16643,3185,175
391663843,391661652,391676907,15255,3186,175
391683096,391681121,391697111,15990,3187,175
391703270,391701295,391717915,16620,3188,175
391724237,391722046,391738251,16205,3189,175
391744470,391742495,391758168,15673,3190,175
391764490,391762299,391778187,15888,3191,175
391784394,391782420,391799063,16643,3192,175
391805287,391803313,391817718,14405,3193,175
391823929,391821955,391839884,17929,3194,175
391846041,391844066,391859760,15694,3195,175
391865963,391863990,391879998,16008,3196,175
391886322,391884130,391901308,17178,3197,175
391907528,391905553,391921226,15673,3198,175
391927432,391925458,391940181,14723,3199,175
391946357,391944382,391958470,14088,3200,175
391964651,391962677,391979614,16937,3201,175
391985835,391983861,391999870,16009,3202,175
392006082,392004108,392021045,16937,3203,175
392027254,392025280,392040635,15355,3204,175
392046957,392044765,392062576,17811,3205,175
392068791,392066817,392083439,16622,3206,175
392089761,392087570,392103479,15909,3207,175
392109801,392107609,392124786,17177,3208,175
392131108,392128917,392146748,17831,3209,175
392152950,392150976,392168905,17929,3210,175
392175094,392173120,392189763,16643,3211,175
392195868,392193894,392210003,16109,3212,175
392216163,392214188,392229226,15038,3213,175
392235548,392233357,392249582,16225,3214,175
392255904,392253713,392268653,14940,3215,175
392274838,392272864,392288240,15376,3216,175
392294408,392292434,392308442,16008,3217,175
392314629,392312654,392328981,16327,3218,175
392335133,392333159,392347247,14088,3219,175
392353568,392351377,392367921,16544,3220,175
392374098,392372123,392386846,14723,3221,175
392392950,392390976,392405913,14937,3222,175
392412234,392410044,392425298,15254,3223,175
392431460,392429486,392446445,16959,3224,175
392452551,392450577,392465198,14621,3225,175
392471303,392469329,392487676,18347,3226,175
392493889,392491914,392509506,17592,3227,175
392515716,392513742,392530700,16958,3228,175
392536898,392534923,392551567,16644,3229,175
392557672,392555698,392571468,15770,3230,175
392577688,392575713,392592040,16327,3231,175
392598362,392596171,392612061,15890,3232,175
392618263,392616289,392632276,15987,3233,175
392638485,392636511,392651234,14723,3234,175
392657389,392655415,392670138,14723,3235,175
392676243,392674269,392692731,18462,3236,175
392699054,392696863,392712751,15888,3237,175
392718959,392716984,392732657,15673,3238,175
392738979,392736788,392752044,15256,3239,175
392758366,392756175,392770795,14620,3240,175
392776990,392775017,392791004,15987,3241,175
392797204,392795229,392811219,15990,3242,175
392817417,392815443,392830799,15356,3243,175
392837121,392834930,392852423,17493,3244,175
392858633,392856659,392873598,16939,3245,175
392879795,392877821,392895731,17910,3246,175
392901948,392899974,392916933,16959,3247,175
392923255,392921064,392937584,16520,3248,175
392943778,392941804,392956526,14722,3249,175
392962847,392960656,392977811,17155,3250,175
392984133,392981942,392997198,15256,3251,175
393003417,393001443,393018085,16642,3252,175
393024408,393022216,393039710,17494,3253,175
393045932,393043958,393060263,16305,3254,175
393066441,393064466,393082713,18247,3255,175
393088937,393086962,393102634,15672,3256,175
393108844,393106870,393121593,14723,3257,175
393127753,393125779,393141133,15354,3258,175
393147292,393145317,393161645,16328,3259,175
393167871,393165896,393181568,15672,3260,175
393187762,393185787,393202114,16327,3261,175
393208437,393206245,393224709,18464,3262,175
393230920,393228946,393245589,16643,3263,175
393251816,393249843,393265851,16008,3264,175
393272009,393270034,393285390,15356,3265,175
393291594,393289619,393304342,14723,3266,175
393310663,393308472,393323093,14621,3267,175
393329413,393327223,393344397,17174,3268,175
393350719,393348528,393363150,14622,3269,175
393369344,393367369,393384329,16960,3270,175
393390650,393388460,393404348,15888,3271,175
393410561,393408586,393424597,16011,3272,175
393430808,393428834,393445160,16326,3273,175
393451482,393449291,393466149,16858,3274,175
393472471,393470280,393484902,14622,3275,175
393491223,393489032,393505871,16839,3276,175
393512096,393510122,393526109,15987,3277,175
393532336,393530362,393546372,16010,3278,175
393552582,393550608,393568199,17591,3279,175
393574521,393572330,393588217,15887,3280,175
393594430,393592455,393608783,16328,3281,175
393614970,393612995,393630271,17276,3282,175
393636450,393634475,393648248,13773,3283,175
393654445,393652470,393669429,16959,3284,175
393675640,393673666,393690624,16958,3285,175
393696816,393694842,393712433,17591,3286,175
393718659,393716683,393731091,14408,3287,175
393737412,393735221,393750477,15256,3288,175
393756797,393754607,393769546,14939,3289,175
393775751,393773776,393790419,16643,3290,175
393796622,393794648,393811607,16959,3291,175
393817929,393815738,393831310,15572,3292,175
393837508,393835533,393852493,16960,3293,175
393858815,393856624,393872851,16227,3294,175
393878957,393876982,393893821,16839,3295,175
393900038,393898063,393914390,16327,3296,175
393920712,393918521,393934748,16227,3297,175
393940965,393938990,393954662,15672,3298,175
393960883,393958909,393972681,13772,3299,175
393978785,393976811,393991632,14821,3300,175
393997840,393995866,394011536,15670,3301,175
394017858,394015666,394031240,15574,3302,175
394037561,394035370,394052546,17176,3303,175
394058651,394056677,394071933,15256,3304,175
394078131,394076157,394091829,15672,3305,175
394098150,394095959,394112481,16522,3306,175
394118642,394116668,394133628,16960,3307,175
394139846,394137871,394154198,16327,3308,175
394160378,394158403,394175025,16622,3309,175
394181219,394179245,394195234,15989,3310,175
394201416,394199441,394215769,16328,3311,175
394221970,394219995,394237609,17614,3312,175
394243809,394241836,394259764,17928,3313,175
394265973,394263999,394279671,15672,3314,175
394285897,394283922,394301197,17275,3315,175
394307387,394305412,394323005,17593,3316,175
394329213,394327238,394343226,15988,3317,175
394349548,394347356,394364194,16838,3318,175
394370300,394368325,394385702,17377,3319,175
394392024,394389833,394406354,16521,3320,175
394412508,394410533,394426205,15672,3321,175
394432526,394430335,394445906,15571,3322,175
394452107,394450132,394465805,15673,3323,175
394472126,394469935,394486457,16522,3324,175
394492652,394490677,394506983,16306,3325,175
394513306,394511114,394526054,14940,3326,175
394532206,394530231,394547189,16958,3327,175
394553295,394551320,394568180,16860,3328,175
394574391,394572416,394587771,15355,3329,175
394593983,394592008,394608018,16010,3330,175
394614204,394612230,394627923,15693,3331,175
394634152,394632177,394649454,17277,3332,175
394655559,394653585,394670960,17375,3333,175
394677123,394675149,394690188,15039,3334,175
394696397,394694423,394712668,18245,3335,175
394718842,394716867,394732243,15376,3336,175
394738564,394736373,394750678,14305,3337,175
394757001,394754809,394772303,17494,3338,175
394778531,394776557,394792882,16325,3339,175
394799204,394797013,394812923,15910,3340,175
394819246,394817054,394832942,15888,3341,175
394839096,394837122,394854398,17276,3342,175
394860610,394858635,394873991,15356,3343,175
394880312,394878121,394894009,15888,3344,175
394900200,394898226,394912946,14720,3345,175
394919171,394917197,394933501,16304,3346,175
394939667,394937693,394955306,17613,3347,175
394961514,394959540,394974579,15039,3348,175
394980774,394978800,394992889,14089,3349,175
394999209,394997019,395012589,15570,3350,175
395018762,395016787,395034064,17277,3351,175
395040218,395038243,395055202,16959,3352,175
395061394,395059420,395075430,16010,3353,175
395081615,395079640,395094997,15357,3354,175
395101103,395099128,395115354,16226,3355,175
395121585,395119611,395136570,16959,3356,175
395142891,395140701,395157222,16521,3357,175
395163442,395161468,395177772,16304,3358,175
395184001,395182026,395197699,15673,3359,175
395204021,395201830,395217718,15888,3360,175
395223924,395221950,395237642,15692,3361,175
395243875,395241901,395257571,15670,3362,175
395263789,395261814,395278141,16327,3363,175
395284463,395282272,395299110,16838,3364,175
395305433,395303241,395319152,15911,3365,175
395325473,395323282,395338537,15255,3366,175
395344731,395342757,395360033,17276,3367,175
395366356,395364164,395380075,15911,3368,175
395386240,395384267,395400570,16303,3369,175
395406892,395404701,395422193,17492,3370,175
395428417,395426443,395441482,15039,3371,175
395447677,395445702,395462028,16326,3372,175
395468350,395466159,395482386,16227,3373,175
395488619,395486644,395503921,17277,3374,175
395510145,395508171,395524160,15989,3375,175
395530481,395528290,395542913,14623,3376,175
395549234,395547043,395564851,17808,3377,175
395571062,395569088,395585412,16324,3378,175
395591642,395589668,395604707,15039,3379,175
395611028,395608837,395625043,16206,3380,175
395631276,395629302,395645628,16326,3381,175
395651950,395649759,395665646,15887,3382,175
395671816,395669842,395684881,15039,3383,175
395691090,395689115,395704154,15039,3384,175
395710309,395708335,395724007,15672,3385,175
395730222,395728247,395743919,15672,3386,175
395750082,395748108,395763146,15038,3387,175
395769321,395767346,395783989,16643,3388,175
395790173,395788198,395804524,16326,3389,175
395810845,395808655,395826147,17492,3390,175
395832470,395830278,395847118,16840,3391,175
395853441,395851249,395866504,15255,3392,175
395872735,395870761,395885484,14723,3393,175
395891651,395889677,395904715,15038,3394,175
395910943,395908968,395925274,16306,3395,175
395931431,395929457,395946732,17275,3396,175
395953054,395950863,395966119,15256,3397,175
395972343,395970369,395986990,16621,3398,175
395993146,395991172,396007182,16010,3399,175
396013354,396011379,396029288,17909,3400,175
396035457,396033482,396050420,16938,3401,175
396056612,396054638,396071913,17275,3402,175
396078065,396076090,396092417,16327,3403,175
396098629,396096655,396112642,15987,3404,175
396118867,396116893,396134485,17592,3405,175
396140685,396138711,396155353,16642,3406,175
396161675,396159484,396176026,16542,3407,175
396182245,396180270,396197862,17592,3408,175
396204065,396202091,396217447,15356,3409,175
396223770,396221578,396236834,15256,3410,175
396242993,396241018,396257344,16326,3411,175
396263666,396261475,396276731,15256,3412,175
396282950,396280976,396296965,15989,3413,175
396303285,396301095,396317300,16205,3414,175
396323472,396321497,396339427,17930,3415,175
396345618,396343643,396360285,16642,3416,175
396366390,396364416,396382878,18462,3417,175
396389076,396387102,396404715,17613,3418,175
396410951,396408977,396424965,15988,3419,175
396431177,396429203,396446793,17590,3420,175
396453116,396450925,396467763,16838,3421,175
396473974,396472000,396487672,15672,3422,175
396493822,396491848,396506570,14722,3423,175
396512732,396510758,396527400,16642,3424,175
396533722,396531531,396547103,15572,3425,175
396553289,396551315,396566353,15038,3426,175
396572518,396570543,396587165,16622,3427,175
396593342,396591367,396605456,14089,3428,175
396611687,396609712,396624750,15038,3429,175
396630976,396629001,396645962,16961,3430,175
396652164,396650188,396668436,18248,3431,175
396674632,396672658,396687062,14404,3432,175
396693382,396691192,396706130,14938,3433,175
396712234,396710260,396726031,15771,3434,175
396732207,396730232,396746854,16622,3435,175
396753046,396751071,396767060,15989,3436,175
396773252,396771277,396788870,17593,3437,175
396795193,396793002,396809522,16520,3438,175
396815688,396813714,396829702,15988,3439,175
396835906,396833932,396849287,15355,3440,175
396855484,396853510,396870153,16643,3441,175
396876360,396874386,396890691,16305,3442,175
396896875,396894901,396910573,15672,3443,175
396916894,396914703,396931562,16859,3444,175
396937783,396935809,396952452,16643,3445,175
396958663,396956690,396971727,15037,3446,175
396977919,396975945,396991616,15671,3447,175
396997832,396995858,397013134,17276,3448,175
397019456,397017265,397033470,16205,3449,175
397039655,397037679,397055274,17595,3450,175
397061596,397059405,397076898,17493,3451,175
397083220,397081029,397098205,17176,3452,175
397104424,397102450,397116855,14405,3453,175
397123040,397121065,397136422,15357,3454,175
397142647,397140673,397157315,16642,3455,175
397163519,397161545,397179137,17592,3456,175
397185353,397183379,397200337,16958,3457,175
397206536,397204562,397220551,15989,3458,175
397226770,397224795,397239202,14407,3459,175
397245387,397243413,397260055,16642,3460,175
397266378,397264186,397280730,16544,3461,175
397286948,397284974,397300962,15988,3462,175
397307284,397305093,397320348,15255,3463,175
397326549,397324575,397339296,14721,3464,175
397345479,397343504,397357909,14405,3465,175
397364062,397362088,397376494,14406,3466,175
397382815,397380624,397394929,14305,3467,175
397401112,397399138,397413543,14405,3468,175
397419864,397417673,397435165,17492,3469,175
397441401,397439426,397456386,16960,3470,175
397462600,397460626,397477564,16938,3471,175
397483886,397481695,397499188,17493,3472,175
397505510,397503319,397518890,15571,3473,175
397525112,397523138,397538176,15038,3474,175
397544498,397542307,397559800,17493,3475,175
397566123,397563932,397578237,14305,3476,175
397584468,397582494,397597531,15037,3477,175
397603852,397601661,397619808,18147,3478,175
397625972,397623997,397639669,15672,3479,175
397645990,397643800,397659372,15572,3480,175
397665540,397663565,397678287,14722,3481,175
397684478,397682504,397700097,17593,3482,175
397706418,397704228,397719798,15570,3483,175
397726000,397724025,397739698,15673,3484,175
397745852,397743877,397758283,14406,3485,175
397764604,397762413,397779589,17176,3486,175
397785802,397783828,397799521,15693,3487,175
397805714,397803740,397820360,16620,3488,175
397826682,397824491,397839429,14938,3489,175
397845656,397843682,397859986,16304,3490,175
397866139,397864164,397880153,15989,3491,175
397886475,397884283,397901460,17177,3492,175
397907666,397905692,397922651,16959,3493,175
397928861,397926886,397944817,17931,3494,175
397951036,397949061,397964734,15673,3495,175
397971057,397968865,397984752,15887,3496,175
397990910,397988935,398006211,17276,3497,175
398012532,398010342,398027180,16838,3498,175
398033502,398031311,398048170,16859,3499,175
398054367,398052393,398068382,15989,3500,175
398074587,398072612,398088602,15990,3501,175
398094923,398092732,398108937,16205,3502,175
398115138,398113163,398128518,15355,3503,175
398134729,398132755,398148743,15988,3504,175
398154942,398152967,398169906,16939,3505,175
398176011,398174037,398189925,15888,3506,175
398196138,398194164,398210488,16324,3507,175
398216717,398214742,398231386,16644,3508,175
398237547,398235572,398250296,14724,3509,175
398256486,398254513,398270500,15987,3510,175
398276730,398274756,398291083,16327,3511,175
398297263,398295289,398311614,16325,3512,175
398317822,398315848,398330571,14723,3513,175
398336778,398334803,398350180,15377,3514,175
398356501,398354310,398370516,16206,3515,175
398376839,398374647,398390536,15889,3516,175
398396858,398394667,398411844,17177,3517,175
398418166,398415975,398431230,15255,3518,175
398437334,398435360,398451585,16225,3519,175
398457763,398455788,398471778,15990,3520,175
398477996,398476022,398492327,16305,3521,175
398498536,398496562,398510650,14088,3522,175
398516880,398514906,398530577,15671,3523,175
398536791,398534817,398551437,16620,3524,175
398557652,398555677,398571983,16306,3525,175
398578165,398576191,398592180,15989,3526,175
398598383,398596408,398612080,15672,3527,175
398618185,398616211,398632121,15910,3528,175
398638225,398636252,398654061,17809,3529,175
398660256,398658281,398673953,15672,3530,175
398680275,398678084,398692706,14622,3531,175
398698911,398696937,398712947,16010,3532,175
398719269,398717078,398735225,18147,3533,175
398741434,398739459,398755469,16010,3534,175
398761636,398759662,398777275,17613,3535,175
398783494,398781519,398797507,15988,3536,175
398803734,398801760,398817749,15989,3537,175
398824070,398821879,398838421,16542,3538,175
398844743,398842552,398861016,18464,3539,175
398867122,398865147,398879336,14189,3540,175
398885657,398883466,398900621,17155,3541,175
398906774,398904798,398920155,15357,3542,175
398926477,398924286,398940807,16521,3543,175
398946961,398944987,398961630,16643,3544,175
398967858,398965884,398981240,15356,3545,175
398987439,398985466,399002403,16937,3546,175
399008600,399006626,399023564,16938,3547,175
399029669,399027695,399044099,16404,3548,175
399050422,399048230,399063487,15257,3549,175
399069684,399067710,399083380,15670,3550,175
399089581,399087607,399102012,14405,3551,175
399108200,399106226,399121898,15672,3552,175
399128220,399126029,399141284,15255,3553,175
399147507,399145532,399160571,15039,3554,175
399166893,399164702,399181223,16521,3555,175
399187416,399185442,399203370,17928,3556,175
399209544,399207569,399221659,14090,3557,175
399227980,399225789,399243282,17493,3558,175
399249474,399247500,399262539,15039,3559,175
399268723,399266749,399281788,15039,3560,175
399287984,399286010,399300732,14722,3561,175
399306944,399304970,399320324,15354,3562,175
399326504,399324530,399340202,15672,3563,175
399346306,399344332,399358953,14621,3564,175
399365276,399363084,399378657,15573,3565,175
399384857,399382883,399396971,14088,3566,175
399403196,399401221,399418498,17277,3567,175
399424821,399422629,399440440,17811,3568,175
399446623,399444649,399460321,15672,3569,175
399466426,399464451,399480974,16523,3570,175
399487079,399485105,399501510,16405,3571,175
399507697,399505723,399523631,17908,3572,175
399529952,399527762,399542384,14622,3573,175
399548573,399546599,399561004,14405,3574,175
399567183,399565208,399579297,14089,3575,175
399585618,399583427,399598682,15255,3576,175
399604850,399602876,399617915,15039,3577,175
399624236,399622046,399639537,17491,3578,175
399645859,399643668,399661497,17829,3579,175
399667730,399665756,399681110,15354,3580,175
399687215,399685241,399700062,14821,3581,175
399706281,399704306,399718080,13774,3582,175
399724186,399722211,399739904,17693,3583,175
399746095,399744121,399758841,14720,3584,175
399765013,399763038,399780314,17276,3585,175
399786517,399784543,399799898,15355,3586,175
399806111,399804137,399820462,16325,3587,175
399826613,399824639,399839045,14406,3588,175
399845265,399843291,399857694,14403,3589,175
399863919,399861944,399877954,16010,3590,175
399884275,399882085,399900210,18125,3591,175
399906405,399904431,399919469,15038,3592,175
399925790,399923599,399940141,16542,3593,175
399946345,399944371,399959727,15356,3594,175
399965831,399963857,399980399,16542,3595,175
399986600,399984626,399999665,15039,3596,175
400005872,400003898,400019254,15356,3597,175
400025431,400023457,400040417,16960,3598,175
400046639,400044664,400060969,16305,3599,175
400067166,400065192,400082466,17274,3600,175
400088684,400086709,400104303,17594,3601,175
400110626,400108434,400125610,17176,3602,175
400131815,400129840,400144879,15039,3603,175
400151048,400149073,400165061,15988,3604,175
400171268,400169294,400184648,15354,3605,175
400190843,400188869,400205510,16641,3606,175
400211740,400209766,400223855,14089,3607,175
400230176,400227985,400243558,15573,3608,175
400249748,400247773,400264416,16643,3609,175
400270738,400268547,400284774,16227,3610,175
400291095,400288905,400303842,14937,3611,175
400310164,400307972,400326436,18464,3612,175
400332758,400330567,400347406,16839,3613,175
400353728,400351537,400366792,15255,3614,175
400372995,400371021,400388296,17275,3615,175
400394618,400392427,400409286,16859,3616,175
400415608,400413417,400428672,15255,3617,175
400434845,400432871,400448226,15355,3618,175
400454547,400452356,400468560,16204,3619,175
400474711,400472737,400488747,16010,3620,175
400494965,400492991,400509929,16938,3621,175
400516161,400514187,400529878,15691,3622,175
400536082,400534107,400548514,14407,3623,175
400554699,400552725,400568101,15376,3624,175
400574422,400572231,400588436,16205,3625,175
400594636,400592662,400609621,16959,3626,175
400615813,400613838,400629826,15988,3627,175
400636017,400634043,400648448,14405,3628,175
400654681,400652706,400668063,15357,3629,175
400674286,400672312,400687984,15672,3630,175
400694134,400692160,400707832,15672,3631,175
400714012,400712038,400729629,17591,3632,175
400735817,400733843,400747933,14090,3633,175
400754134,400752161,400766881,14720,3634,175
400773067,400771092,400786132,15040,3635,175
400792364,400790390,400805429,15039,3636,175
400811613,400809638,400825648,16010,3637,175
400831819,400829844,400844251,14407,3638,175
400850462,400848488,400863526,15038,3639,175
400869712,400867738,400885647,17909,3640,175
400891829,400889854,400903945,14091,3641,175
400910165,400908190,400925465,17275,3642,175
400931684,400929710,400946986,17276,3643,175
400953309,400951117,400965741,14624,3644,175
400972062,400969871,400986098,16227,3645,175
400992421,400990229,401004853,14624,3646,175
401011174,401008983,401025821,16838,3647,175
401032143,401029952,401046812,16860,3648,175
401052996,401051022,401067980,16958,3649,175
401074157,401072182,401087221,15039,3650,175
401093443,401091468,401107774,16306,3651,175
401114096,401111905,401126526,14621,3652,175
401132754,401130780,401149026,18246,3653,175
401155206,401153232,401167953,14721,3654,175
401174144,401172170,401188157,15987,3655,175
401194309,401192334,401208640,16306,3656,175
401214803,401212829,401227235,14406,3657,175
401233339,401231365,401248204,16839,3658,175
401254419,401252445,401268434,15989,3659,175
401274656,401272682,401289957,17275,3660,175
401296160,401294185,401308907,14722,3661,175
401315229,401313037,401331500,18463,3662,175
401337670,401335696,401350734,15038,3663,175
401356937,401354962,401372239,17277,3664,175
401378563,401376371,401393863,17492,3665,175
401400032,401398058,401415650,17592,3666,175
401421756,401419781,401434918,15137,3667,175
401441092,401439117,401454473,15356,3668,175
401460796,401458603,401474177,15574,3669,175
401480498,401478307,401492929,14622,3670,175
401499250,401497059,401513285,16226,3671,175
401519507,401517533,401533205,15672,3672,175
401539526,401537335,401554193,16858,3673,175
401560514,401558324,401574211,15887,3674,175
401580439,401578465,401594137,15672,3675,175
401600242,401598268,401615306,17038,3676,175
401621628,401619437,401635009,15572,3677,175
401641330,401639139,401656632,17493,3678,175
401662814,401660840,401676195,15355,3679,175
401682396,401680422,401695797,15375,3680,175
401701980,401700005,401716965,16960,3681,175
401723150,401721176,401736532,15356,3682,175
401742764,401740789,401757431,16642,3683,175
401763753,401761562,401778716,17154,3684,175
401784907,401782933,401798605,15672,3685,175
401804710,401802735,401818190,15455,3686,175
401824511,401822320,401838546,16226,3687,175
401844868,401842677,401859219,16542,3688,175
401865541,401863350,401877655,14305,3689,175
401883859,401881885,401896923,15038,3690,175
401903132,401901158,401918750,17592,3691,175
401925072,401922881,401941007,18126,3692,175
401947188,401945214,401962807,17593,3693,175
401969129,401966938,401982827,15889,3694,175
401989148,401986957,402002866,15909,3695,175
402008970,402006996,402023223,16227,3696,175
402029426,402027452,402044727,17275,3697,175
402050926,402048952,402065911,16959,3698,175
402072234,402070042,402084983,14941,3699,175
402091211,402089236,402105878,16642,3700,175
402112042,402110067,402125106,15039,3701,175
402131427,402129236,402144809,15573,3702,175
402151023,402149048,402164088,15040,3703,175
402170305,402168331,402184339,16008,3704,175
402190661,402188470,402203726,15256,3705,175
402209908,402207934,402224893,16959,3706,175
402231068,402229094,402244133,15039,3707,175
402250454,402248263,402266071,17808,3708,175
402272261,402270287,402288533,18246,3709,175
402294729,402292755,402309693,16938,3710,175
402315926,402313952,402330593,16641,3711,175
402336793,402334818,402350491,15673,3712,175
402356655,402354680,402372589,17909,3713,175
402378799,402376824,402391230,14406,3714,175
402397335,402395360,402411786,16426,3715,175
402418108,402415917,402432122,16205,3716,175
402438314,402436340,402452032,15692,3717,175
402458246,402456271,402472597,16326,3718,175
402478810,402476836,402493163,16327,3719,175
402499383,402497409,402512448,15039,3720,175
402518651,402516677,402532666,15989,3721,175
402538849,402536875,402552231,15356,3722,175
402558553,402556362,402572568,16206,3723,175
402578759,402576784,402590874,14090,3724,175
402597075,402595101,402611405,16304,3725,175
402617631,402615656,402632933,17277,3726,175
402639166,402637191,402653518,16327,3727,175
402659727,402657752,402673763,16011,3728,175
402680084,402677894,402693486,15592,3729,175
402699661,402697687,402715615,17928,3730,175
402721811,402719837,402733925,14088,3731,175
402740030,402738056,402755113,17057,3732,175
402761219,402759244,402775966,16722,3733,175
402782188,402780214,402796835,16621,3734,175
402802994,402801019,402815742,14723,3735,175
402821970,402819996,402836956,16960,3736,175
402843109,402841135,402856489,15354,3737,175
402862811,402860620,402876509,15889,3738,175
402882692,402880717,402895439,14722,3739,175
402901761,402899570,402914825,15255,3740,175
402921003,402919029,402935037,16008,3741,175
402941359,402939168,402954740,15572,3742,175
402960951,402958976,402974647,15671,3743,175
402980800,402978825,402996100,17275,3744,175
403002325,403000351,403017943,17592,3745,175
403024266,403022075,403037648,15573,3746,175
403043971,403041779,403058934,17155,3747,175
403065256,403063065,403079588,16523,3748,175
403085910,403083719,403099312,15593,3749,175
403105521,403103547,403118269,14722,3750,175
403124475,403122500,403138826,16326,3751,175
403145037,403143062,403158734,15672,3752,175
403164936,403162961,403177366,14405,3753,175
403183687,403181496,403199327,17831,3754,175
403205541,403203567,403219555,15988,3755,175
403225770,403223796,403239172,15376,3756,175
403245276,403243302,403258124,14822,3757,175
403264336,403262362,403279321,16959,3758,175
403285530,403283555,403298279,14724,3759,175
403304600,403302409,403318297,15888,3760,175
403324520,403322545,403339188,16643,3761,175
403345510,403343319,403358892,15573,3762,175
403365049,403363075,403380984,17909,3763,175
403387306,403385115,403400054,14939,3764,175
403406375,403404184,403419757,15573,3765,175
403425986,403424012,403439368,15356,3766,175
403445689,403443498,403460674,17176,3767,175
403466996,403464805,403479744,14939,3768,175
403486065,403483874,403500100,16226,3769,175
403506313,403504339,403520347,16008,3770,175
403526500,403524525,403539903,15378,3771,175
403546135,403544160,403559833,15673,3772,175
403566059,403564086,403579440,15354,3773,175
403585761,403583570,403599776,16206,3774,175
403605980,403604006,403620333,16327,3775,175
403626656,403624464,403640986,16522,3776,175
403647308,403645117,403662293,17176,3777,175
403668616,403666425,403683284,16859,3778,175
403689607,403687415,403702355,14940,3779,175
403708565,403706591,403722284,15693,3780,175
403728441,403726467,403743425,16958,3781,175
403749608,403747634,403765224,17590,3782,175
403771451,403769476,403785801,16325,3783,175
403791991,403790017,403807291,17274,3784,175
403813518,403811544,403826264,14720,3785,175
403832587,403830395,403846285,15890,3786,175
403852434,403850460,403865182,14722,3787,175
403871503,403869312,403883935,14623,3788,175
403890164,403888190,403904494,16304,3789,175
403910648,403908674,403924346,15672,3790,175
403930539,403928565,403942970,14405,3791,175
403949123,403947148,403962819,15671,3792,175
403969141,403966950,403985076,18126,3793,175
403991398,403989207,404003196,13989,3794,175
404009409,404007435,404023128,15693,3795,175
404029450,404027259,404043781,16522,3796,175
404049973,404047999,404064304,16305,3797,175
404070627,404068435,404086246,17811,3798,175
404092351,404090377,404104998,14621,3799,175
404111102,404109128,404127136,18008,3800,175
404133459,404131267,404146523,15256,3801,175
404152721,404150747,404166757,16010,3802,175
404173080,404170888,404188064,17176,3803,175
404194271,404192297,404208622,16325,3804,175
404214774,404212800,404228786,15986,3805,175
404235109,404232917,404249778,16861,3806,175
404256101,404253909,404268849,14940,3807,175
404275067,404273093,404289419,16326,3808,175
404295618,404293644,404311257,17613,3809,175
404317448,404315473,404332433,16960,3810,175
404338659,404336685,404352357,15672,3811,175
404358506,404356532,404373490,16958,3812,175
404379813,404377622,404392245,14623,3813,175
404398349,404396375,404413097,16722,3814,175
404419293,404417318,404434279,16961,3815,175
404440474,404438501,404455774,17273,3816,175
404461969,404459994,404475984,15990,3817,175
404482200,404480226,404495918,15692,3818,175
404502126,404500152,404516479,16327,3819,175
404522801,404520610,404536499,15889,3820,175
404542724,404540751,404557370,16619,3821,175
404563692,404561501,404579331,17830,3822,175
404585653,404583462,404599351,15889,3823,175
404605456,404603481,404618303,14822,3824,175
404624511,404622537,404637892,15355,3825,175
404644123,404642148,404658792,16644,3826,175
404664997,404663022,404679012,15990,3827,175
404685215,404683240,404701170,17930,3828,175
404707492,404705301,404721506,16205,3829,175
404727739,404725764,404740803,15039,3830,175
404747124,404744933,404761772,16839,3831,175
404767990,404766016,404782659,16643,3832,175
404788982,404786791,404802047,15256,3833,175
404808261,404806286,404823879,17593,3834,175
404830035,404828062,404844682,16620,3835,175
404850912,404848938,404864948,16010,3836,175
404871164,404869189,404883279,14090,3837,175
404889480,404887506,404903516,16010,3838,175
404909724,404907750,404924055,16305,3839,175
404930378,404928186,404943442,15256,3840,175
404949593,404947618,404962974,15356,3841,175
404969127,404967153,404982191,15038,3842,175
404988513,404986322,405004131,17809,3843,175
405010350,405008375,405025652,17277,3844,175
405031835,405029861,405045870,16009,3845,175
405052101,405050126,405066137,16011,3846,175
405072288,405070314,405085352,15038,3847,175
405091557,405089583,405104305,14722,3848,175
405110627,405108436,405125592,17156,3849,175
405131744,405129770,405146074,16304,3850,175
405152276,405150302,405166943,16641,3851,175
405173049,405171074,405185896,14822,3852,175
405192218,405190027,405206866,16839,3853,175
405213030,405211056,405227698,16642,3854,175
405233804,405231829,405247402,15573,3855,175
405253723,405251532,405266154,14622,3856,175
405272373,405270399,405285755,15356,3857,175
405291969,405289996,405305667,15671,3858,175
405311987,405309797,405325706,15909,3859,175
405332027,405329836,405345408,15572,3860,175
405351512,405349538,405365742,16204,3861,175
405371962,405369987,405385342,15355,3862,175
405391573,405389599,405403689,14090,3863,175
405409883,405407908,405424868,16960,3864,175
405431190,405428999,405443939,14940,3865,175
405450261,405448070,405466217,18147,3866,175
405472390,405470416,405486404,15988,3867,175
405492617,405490643,405505366,14723,3868,175
405511525,405509551,405525538,15987,3869,175
405531760,405529786,405546112,16326,3870,175
405552307,405550333,405566638,16305,3871,175
405572960,405570769,405586658,15889,3872,175
405592893,405590918,405607245,16327,3873,175
405613567,405611376,405627919,16543,3874,175
405634107,405632133,405647804,15671,3875,175
405653961,405651986,405667658,15672,3876,175
405673980,405671789,405687360,15571,3877,175
405693681,405691490,405709637,18147,3878,175
405715959,405713768,405729656,15888,3879,175
405735849,405733875,405748281,14406,3880,175
405754480,405752506,405769443,16937,3881,175
405775670,405773696,405790022,16326,3882,175
405796254,405794279,405810922,16643,3883,175
405817074,405815100,405829822,14722,3884,175
405836018,405834043,405849083,15040,3885,175
405855248,405853274,405869599,16325,3886,175
405875922,405873730,405889957,16227,3887,175
405896164,405894190,405909883,15693,3888,175
405916100,405914126,405932035,17909,3889,175
405938357,405936166,405953025,16859,3890,175
405959208,405957235,405974172,16937,3891,175
405980493,405978303,405995478,17175,3892,175
406001657,405999682,406014405,14723,3893,175
406020596,406018621,406033976,15355,3894,175
406040166,406038192,406053230,15038,3895,175
406059335,406057361,406073904,16543,3896,175
406080077,406078103,406094724,16621,3897,175
406100933,406098958,406113997,15039,3898,175
406120232,406118257,406134880,16623,3899,175
406141203,406139012,406153002,13990,3900,175
406159159,406157185,406171907,14722,3901,175
406178013,406176038,406191928,15890,3902,175
406198136,406196161,406211201,15040,3903,175
406217435,406215461,406233391,17930,3904,175
406239587,406237612,406253307,15695,3905,175
406259521,406257547,406273217,15670,3906,175
406279442,406277467,406292507,15040,3907,175
406298737,406296762,406312436,15674,3908,175
406318596,406316622,406332946,16324,3909,175
406339114,406337139,406352833,15694,3910,175
406359154,406356963,406371902,14939,3911,175
406378066,406376091,406390497,14406,3912,175
406396601,406394627,406412656,18029,3913,175
406418978,406416787,406433012,16225,3914,175
406439118,406437143,406452399,15256,3915,175
406458604,406456630,406474244,17614,3916,175
406480565,406478375,406494601,16226,3917,175
406500768,406498794,406515120,16326,3918,175
406521291,406519316,406537226,17910,3919,175
406543331,406541357,406555662,14305,3920,175
406561766,406559792,406574414,14622,3921,175
406580602,406578627,406592718,14091,3922,175
406599039,406596848,406612103,15255,3923,175
406618277,406616302,406633895,17593,3924,175
406640217,406638026,406654253,16227,3925,175
406660358,406658384,406675853,17469,3926,175
406682175,406679984,406694923,14939,3927,175
406701158,406699184,406713589,14405,3928,175
406719911,406717720,406734264,16544,3929,175
406740449,406738474,406754147,15673,3930,175
406760311,406758337,406772426,14089,3931,175
406778531,406776557,406794048,17491,3932,175
406800370,406798179,406815018,16839,3933,175
406821341,406819149,406835694,16545,3934,175
406841894,406839919,406855591,15672,3935,175
406861914,406859722,406876900,17178,3936,175
406883223,406881031,406898525,17494,3937,175
406904719,406902745,406917151,14406,3938,175
406923378,406921404,406936758,15354,3939,175
406942940,406940966,406956975,16009,3940,175
406963132,406961158,406975564,14406,3941,175
406981784,406979810,406995819,16009,3942,175
407002141,406999950,407015837,15887,3943,175
407022017,407020041,407037319,17278,3944,175
407043640,407041450,407056070,14620,3945,175
407062174,407060200,407076425,16225,3946,175
407082629,407080655,407096643,15988,3947,175
407102747,407100773,407116029,15256,3948,175
407122350,407120159,407135414,15255,3949,175
407141619,407139645,407157891,18246,3950,175
407164102,407162127,407178749,16622,3951,175
407184982,407183007,407198047,15040,3952,175
407204222,407202248,407217604,15356,3953,175
407223821,407221847,407236252,14405,3954,175
407242573,407240382,407256587,16205,3955,175
407262780,407260806,407274578,13772,3956,175
407280900,407278709,407293965,15256,3957,175
407300177,407298203,407314825,16622,3958,175
407321045,407319070,407335397,16327,3959,175
407341627,407339652,407355347,15695,3960,175
407361546,407359572,407374611,15039,3961,175
407380774,407378799,407393839,15040,3962,175
407400160,407397970,407414194,16224,3963,175
407420516,407418325,407436134,17809,3964,175
407442328,407440353,407454125,13772,3965,175
407460353,407458377,407474051,15674,3966,175
407480373,407478182,407494724,16542,3967,175
407500942,407498968,407516559,17591,3968,175
407522734,407520760,407536137,15377,3969,175
407542353,407540378,407556706,16328,3970,175
407562811,407560837,407577696,16859,3971,175
407584017,407581827,407597736,15909,3972,175
407604058,407601867,407615854,13987,3973,175
407622013,407620040,407636364,16324,3974,175
407642470,407640495,407655752,15257,3975,175
407661915,407659940,407674979,15039,3976,175
407681181,407679207,407693612,14405,3977,175
407699933,407697742,407713631,15889,3978,175
407719952,407717761,407732383,14622,3979,175
407738576,407736602,407751957,15355,3980,175
407758175,407756199,407771239,15040,3981,175
407777561,407775370,407790310,14940,3982,175
407796477,407794501,407810174,15673,3983,175
407816279,407814305,407831364,17059,3984,175
407837568,407835595,407853524,17929,3985,175
407859722,407857748,407874391,16643,3986,175
407880713,407878523,407895044,16521,3987,175
407901243,407899268,407915596,16328,3988,175
407921919,407919728,407934983,15255,3989,175
407941089,407939114,407956806,17692,3990,175
407962956,407960982,407977308,16326,3991,175
407983531,407981557,407997567,16010,3992,175
408003768,408001794,408018437,16643,3993,175
408024646,408022671,408037710,15039,3994,175
408044031,408041840,408058699,16859,3995,175
408064928,408062954,408077676,14722,3996,175
408083874,408081900,408099175,17275,3997,175
408105334,408103359,408120636,17277,3998,175
408126959,408124768,408141290,16522,3999,175
408147613,408145421,408161647,16226,4000,175
408167808,408165833,408183108,17275,4001,175
408189430,408187240,408204098,16858,4002,175
408210279,408208304,408223343,15039,4003,175
408229665,408227474,408243363,15889,4004,175
408249577,408247602,408265196,17594,4005,175
408271519,408269328,408283950,14622,4006,175
408290272,408288081,408303018,14937,4007,175
408309341,408307149,408323376,16227,4008,175
408329582,408327608,408344567,16959,4009,175
408350673,408348698,408366391,17693,4010,175
408372585,408370609,408386599,15990,4011,175
408392751,408390777,408405815,15038,4012,175
408412039,408410065,408427658,17593,4013,175
408433981,408431790,408449599,17809,4014,175
408455811,408453837,408469193,15356,4015,175
408475385,408473411,408489083,15672,4016,175
408495405,408493214,408511362,18148,4017,175
408517467,408515493,408531264,15771,4018,175
408537467,408535493,408550848,15355,4019,175
408557009,408555035,408570728,15693,4020,175
408576882,408574907,408590263,15356,4021,175
408596487,408594512,408611789,17277,4022,175
408618111,408615920,408632780,16860,4023,175
408638886,408636912,408653117,16205,4024,175
408659319,408657345,408672384,15039,4025,175
408678551,408676576,408693219,16643,4026,175
408699421,408697447,408711851,14404,4027,175
408718053,408716078,408730485,14407,4028,175
408736721,408734746,408751073,16327,4029,175
408757261,408755287,408771930,16643,4030,175
408778254,408776062,408792290,16228,4031,175
408798523,408796549,408813825,17276,4032,175
408820148,408817956,408835132,17176,4033,175
408841343,408839368,408855695,16327,4034,175
408861883,408859909,408877502,17593,4035,175
408883676,408881702,408897057,15355,4036,175
408903268,408901294,408916648,15354,4037,175
408922857,408920883,408937842,16959,4038,175
408944055,408942080,408957753,15673,4039,175
408963940,408961966,408980213,18247,4040,175
408986415,408984441,408999162,14721,4041,175
409005484,409003292,409017598,14306,4042,175
409023813,409021839,409036562,14723,4043,175
409042763,409040788,409055826,15038,4044,175
409062038,409060064,409074787,14723,4045,175
409080986,409079012,409095337,16325,4046,175
409101570,409099596,409114635,15039,4047,175
409120786,409118812,409136088,17276,4048,175
409142296,409140321,409158250,17929,4049,175
409164457,409162483,409180729,18246,4050,175
409186893,409184920,409200590,15670,4051,175
409206912,409204721,409218710,13989,4052,175
409224863,409222888,409238245,15357,4053,175
409244567,409242376,409257315,14939,4054,175
409263638,409261446,409279277,17831,4055,175
409285481,409283506,409299812,16306,4056,175
409306037,409304064,409319418,15354,4057,175
409325739,409323548,409339754,16206,4058,175
409346075,409343885,409359773,15888,4059,175
409365979,409364004,409381915,17911,4060,175
409388239,409386047,409401641,15594,4061,175
409407962,409405772,409423263,17491,4062,175
409429499,409427525,409443514,15989,4063,175
409449749,409447775,409462814,15039,4064,175
409468919,409466945,409483805,16860,4065,175
409490013,409488039,409503711,15672,4066,175
409509935,409507960,409523634,15674,4067,175
409529854,409527879,409543868,15989,4068,175
409550190,409547999,409563888,15889,4069,175
409570121,409568146,409583502,15356,4070,175
409589824,409587633,409604810,17177,4071,175
409611044,409609070,409625394,16324,4072,175
409631574,409629599,409644639,15040,4073,175
409650849,409648874,409664883,16009,4074,175
409671056,409669081,409686042,16961,4075,175
409692364,409690174,409706082,15908,4076,175
409712264,409710290,409726616,16326,4077,175
409732939,409730748,409746005,15257,4078,175
409752157,409750183,409765222,15039,4079,175
409771545,409769353,409783977,14624,4080,175
409790300,409788108,409803364,15256,4081,175
409809686,409807495,409823384,15889,4082,175
409829489,409827515,409844669,17154,4083,175
409850889,409848915,409864904,15989,4084,175
409871227,409869036,409885580,16544,4085,175
409891686,409889712,409906572,16860,4086,175
409912743,409910768,409927411,16643,4087,175
409933593,409931618,409947608,15990,4088,175
409953830,409951856,409967549,15693,4089,175
409973770,409971796,409986834,15038,4090,175
409992939,409990965,410006537,15572,4091,175
410012642,410010668,410027410,16742,4092,175
410033733,410031542,410048064,16522,4093,175
410054388,410052196,410067136,14940,4094,175
410073457,410071267,410085573,14306,4095,175
410091768,410089794,410105169,15375,4096,175
410111388,410109413,410123819,14406,4097,175
410130043,410128069,410142159,14090,4098,175
410148481,410146290,410164436,18146,4099,175
410170543,410168568,410185429,16861,4100,175
410191662,410189688,410204725,15037,4101,175
410210920,410208946,410225903,16957,4102,175
410232227,410230035,410246559,16524,4103,175
410252739,410250765,410266121,15356,4104,175
410272334,410270359,410287003,16644,4105,175
410293222,410291247,410306624,15377,4106,175
410312775,410310800,410327760,16960,4107,175
410333866,410331892,410346715,14823,4108,175
410352941,410350968,410366955,15987,4109,175
410373278,410371087,410386027,14940,4110,175
410392226,410390252,410406894,16642,4111,175
410413086,410411112,410427438,16326,4112,175
410433595,410431621,410448559,16938,4113,175
410454665,410452691,410466879,14188,4114,175
410473201,410471010,410487552,16542,4115,175
410493875,410491684,410506940,15256,4116,175
410513103,410511128,410526485,15357,4117,175
410532684,410530711,410545750,15039,4118,175
410552071,410549881,410565770,15889,4119,175
410571938,410569964,410586291,16327,4120,175
410592445,410590471,410607410,16939,4121,175
410613635,410611662,410627649,15987,4122,175
410633862,410631888,410647264,15376,4123,175
410653471,410651497,410668455,16958,4124,175
410674658,410672684,410689643,16959,4125,175
410695850,410693876,410709886,16010,4126,175
410716112,410714138,410730149,16011,4127,175
410736382,410734408,410750397,15989,4128,175
410756628,410754653,410770643,15990,4129,175
410776860,410774885,410791825,16940,4130,175
410798019,410796045,410810768,14723,4131,175
410816980,410815005,410832282,17277,4132,175
410838439,410836465,410853087,16622,4133,175
410859194,410857219,410873646,16427,4134,175
410879809,410877835,410894479,16644,4135,175
410900802,410898611,410912916,14305,4136,175
410919133,410917158,410932514,15356,4137,175
410938746,410936772,410952128,15356,4138,175
410958451,410956259,410970250,13991,4139,175
410976573,410974382,410989955,15573,4140,175
410996176,410994201,411011161,16960,4141,175
411017320,411015345,411029753,14408,4142,175
411036076,411033885,411049773,15888,4143,175
411055988,411054013,411069054,15041,4144,175
411075232,411073259,411090851,17592,4145,175
411097045,411095070,411112663,17593,4146,175
411118987,411116796,411132051,15255,4147,175
411138268,411136294,411151967,15673,4148,175
411158118,411156144,411172133,15989,4149,175
411178359,411176383,411194632,18249,4150,175
411200856,411198882,411213920,15038,4151,175
411220118,411218143,411234470,16327,4152,175
411240794,411238602,411254830,16228,4153,175
411261063,411259089,411275730,16641,4154,175
411281897,411279923,411297516,17593,4155,175
411303697,411301722,411318366,16644,4156,175
411324555,411322581,411339202,16621,4157,175
411345525,411343334,411361481,18147,4158,175
411367804,411365613,411381819,16206,4159,175
411388142,411385951,411403107,17156,4160,175
411409213,411407239,411422179,14940,4161,175
411428353,411426377,411442705,16328,4162,175
411448907,411446933,411463892,16959,4163,175
411470089,411468114,411482521,14407,4164,175
411488756,411486782,411503720,16938,4165,175
411509954,411507980,411523336,15356,4166,175
411529442,411527468,411545160,17692,4167,175
411551317,411549343,411564066,14723,4168,175
411570389,411568198,411585354,17156,4169,175
411591543,411589569,411610474,20905,4170,175
411616798,411614607,411630834,16227,4171,175
411637042,411635068,411651057,15989,4172,175
411657251,411655277,411671266,15989,4173,175
411677589,411675397,411691287,15890,4174,175
411697448,411695474,411712413,16939,4175,175
411718735,411716545,411733383,16838,4176,175
411739580,411737606,411752327,14721,4177,175
411758558,411756584,411772256,15672,4178,175
411778579,411776387,411792932,16545,4179,175
411799254,411797064,411812636,15572,4180,175
411818808,411816832,411831555,14723,4181,175
411837878,411835687,411853495,17808,4182,175
411859648,411857673,411873662,15989,4183,175
411879825,411877851,411893840,15989,4184,175
411899945,411897971,411914196,16225,4185,175
411920405,411918431,411935053,16622,4186,175
411941377,411939185,411955412,16227,4187,175
411961519,411959544,411977553,18009,4188,175
411983784,411981809,411996533,14724,4189,175
412002747,412000773,412016445,15672,4190,175
412022678,412020704,412037009,16305,4191,175
412043179,412041204,412056243,15039,4192,175
412062450,412060476,412077435,16959,4193,175
412083758,412081567,412095874,14307,4194,175
412102197,412100006,412114946,14940,4195,175
412121268,412119078,412133701,14623,4196,175
412139931,412137957,412153649,15692,4197,175
412159973,412157781,412173356,15575,4198,175
412179569,412177595,412193584,15989,4199,175
412199742,412197767,412212491,14724,4200,175
412218719,412216745,412232437,15692,4201,175
412238759,412236568,412252162,15594,4202,175
412258485,412256294,412274441,18147,4203,175
412280764,412278573,412294146,15573,4204,175
412300468,412298277,412314165,15888,4205,175
412320488,412318297,412333553,15256,4206,175
412339876,412337685,412354228,16543,4207,175
412360552,412358361,412373300,14939,4208,175
412379496,412377522,412393532,16010,4209,175
412399740,412397765,412413143,15378,4210,175
412419358,412417384,412431790,14406,4211,175
412438112,412435921,412451178,15257,4212,175
412457401,412455426,412471099,15673,4213,175
412477330,412475356,412492948,17592,4214,175
412499271,412497080,412514257,17177,4215,175
412520475,412518499,412536747,18248,4216,175
412542853,412540879,412558372,17493,4217,175
412564694,412562504,412579995,17491,4218,175
412586202,412584228,412599584,15356,4219,175
412605761,412603787,412619796,16009,4220,175
412626022,412624048,412639404,15356,4221,175
412645573,412643599,412660875,17276,4222,175
412667070,412665096,412683006,17910,4223,175
412689330,412687139,412702079,14940,4224,175
412708403,412706211,412721805,15594,4225,175
412728128,412725937,412743113,17176,4226,175
412749333,412747359,412763031,15672,4227,175
412769137,412767163,412783052,15889,4228,175
412789159,412787184,412804361,17177,4229,175
412810592,412808618,412825894,17276,4230,175
412832115,412830141,412845497,15356,4231,175
412851715,412849741,412865413,15672,4232,175
412871638,412869664,412885337,15673,4233,175
412891554,412889580,412906223,16643,4234,175
412912546,412910355,412926898,16543,4235,175
412933113,412931138,412945545,14407,4236,175
412951867,412949676,412964616,14940,4237,175
412970938,412968747,412984635,15888,4238,175
412990800,412988826,413004836,16010,4239,175
413010943,413008968,413025396,16428,4240,175
413031595,413029621,413044660,15039,4241,175
413050984,413048792,413064999,16207,4242,175
413071105,413069131,413083954,14823,4243,175
413090164,413088189,413105129,16940,4244,175
413111453,413109261,413126755,17494,4245,175
413133077,413130887,413146776,15889,4246,175
413152992,413151018,413169264,18246,4247,175
413175451,413173477,413191387,17910,4248,175
413197604,413195629,413211301,15672,4249,175
413217513,413215539,413233448,17909,4250,175
413239604,413237629,413253303,15674,4251,175
413259626,413257435,413274294,16859,4252,175
413280503,413278529,413293885,15356,4253,175
413300208,413298017,413316144,18127,4254,175
413322325,413320351,413336044,15693,4255,175
413342367,413340175,413355748,15573,4256,175
413361957,413359983,413375676,15693,4257,175
413381861,413379887,413396847,16960,4258,175
413403170,413400979,413416867,15888,4259,175
413423079,413421105,413436459,15354,4260,175
413442617,413440643,413456652,16009,4261,175
413462976,413460784,413476358,15574,4262,175
413482573,413480598,413496608,16010,4263,175
413502930,413500740,413516944,16204,4264,175
413523268,413521076,413538571,17495,4265,175
413544772,413542799,413560727,17928,4266,175
413566960,413564985,413581312,16327,4267,175
413587420,413585445,413601967,16522,4268,175
413608156,413606182,413621855,15673,4269,175
413628030,413626056,413642677,16621,4270,175
413649001,413646810,413663354,16544,4271,175
413669574,413667599,413684560,16961,4272,175
413690883,413688692,413703632,14940,4273,175
413709800,413707826,413724785,16959,4274,175
413730959,413728985,413743707,14722,4275,175
413749813,413747838,413763411,15573,4276,175
413769564,413767590,413782945,15355,4277,175
413789051,413787077,413803165,16088,4278,175
413809353,413807379,413824316,16937,4279,175
413830639,413828448,413845941,17493,4280,175
413852122,413850146,413865188,15042,4281,175
413871511,413869320,413886160,16840,4282,175
413892312,413890338,413905693,15355,4283,175
413911911,413909937,413926560,16623,4284,175
413932786,413930812,413946483,15671,4285,175
413952685,413950710,413966700,15990,4286,175
413973023,413970832,413987038,16206,4287,175
413993201,413991227,414008187,16960,4288,175
414014404,414012429,414026520,14091,4289,175
414032702,414030728,414047350,16622,4290,175
414053536,414051561,414065652,14091,4291,175
414071853,414069879,414086206,16327,4292,175
414092531,414090339,414105280,14941,4293,175
414111602,414109412,414125616,16204,4294,175
414131797,414129822,414145496,15674,4295,175
414151706,414149731,414172874,23143,4296,175
414179091,414177116,414195362,18246,4297,175
414201469,414199494,414217484,17990,4298,175
414223591,414221616,414237506,15890,4299,175
414243732,414241758,414259035,17277,4300,175
414265360,414263168,414279691,16523,4301,175
414285874,414283899,414300839,16940,4302,175
414307042,414305068,414322660,17592,4303,175
414328842,414326868,414343511,16643,4304,175
414349717,414347743,414364385,16642,4305,175
414370710,414368518,414384092,15574,4306,175
414390415,414388224,414405400,17176,4307,175
414411507,414409532,414425104,15572,4308,175
414431275,414429301,414446894,17593,4309,175
414453125,414451150,414468111,16961,4310,175
414474434,414472243,414490053,17810,4311,175
414496376,414494185,414511678,17493,4312,175
414517896,414515922,414532226,16304,4313,175
414538550,414536358,414552881,16523,4314,175
414559204,414557013,414574822,17809,4315,175
414580975,414579001,414595328,16327,4316,175
414601516,414599542,414616186,16644,4317,175
414622398,414620423,414635147,14724,4318,175
414641312,414639337,414654693,15356,4319,175
414661016,414658825,414674714,15889,4320,175
414680906,414678932,414697179,18247,4321,175
414703503,414701312,414719777,18465,4322,175
414725994,414724019,414740325,16306,4323,175
414746557,414744583,414760910,16327,4324,175
414767098,414765123,414782716,17593,4325,175
414788882,414786908,414803868,16960,4326,175
414810035,414808061,414825337,17276,4327,175
414831492,414829518,414845824,16306,4328,175
414852006,414850031,414866992,16961,4329,175
414873196,414871222,414888499,17277,4330,175
414894700,414892725,414909369,16644,4331,175
414915592,414913618,414928972,15354,4332,175
414935294,414933103,414949964,16861,4333,175
414956144,414954169,414969526,15357,4334,175
414975632,414973658,414991468,17810,4335,175
414997791,414995600,415012144,16544,4336,175
415018251,415016276,415032048,15772,4337,175
415038371,415036180,415051119,14939,4338,175
415057442,415055251,415073378,18127,4339,175
415079535,415077561,415093867,16306,4340,175
415100080,415098106,415114748,16642,4341,175
415120854,415118880,415135740,16860,4342,175
415141971,415139997,415155036,15039,4343,175
415161253,415159278,415176871,17593,4344,175
415183194,415181003,415197209,16206,4345,175
415203439,415201465,415218108,16643,4346,175
415224432,415222241,415238468,16227,4347,175
415244692,415242718,415258708,15990,4348,175
415264895,415262921,415279880,16959,4349,175
415286048,415284073,415300696,16623,4350,175
415306902,415304928,415320599,15671,4351,175
415326807,415324833,415340506,15673,4352,175
415346728,415344753,415361377,16624,4353,175
415367582,415365608,415381618,16010,4354,175
415387841,415385867,415402509,16642,4355,175
415408693,415406719,415423046,16327,4356,175
415429369,415427178,415444038,16860,4357,175
415450145,415448171,415465325,17154,4358,175
415471541,415469567,415486842,17275,4359,175
415493165,415490975,415509437,18462,4360,175
415515646,415513672,415529365,15693,4361,175
415535688,415533497,415550357,16860,4362,175
415556574,415554600,415571242,16642,4363,175
415577479,415575505,415589595,14090,4364,175
415595829,415593855,415608895,15040,4365,175
415615218,415613027,415629571,16544,4366,175
415635893,415633703,415649930,16227,4367,175
415656133,415654160,415670169,16009,4368,175
415676332,415674358,415688764,14406,4369,175
415694955,415692981,415708654,15673,4370,175
415714977,415712786,415728676,15890,4371,175
415734897,415732923,415750200,17277,4372,175
415756431,415754457,415769180,14723,4373,175
415775344,415773370,415789676,16306,4374,175
415796000,415793808,415809699,15891,4375,175
415816022,415813831,415829720,15889,4376,175
415835906,415833932,415851841,17909,4377,175
415858000,415856025,415871066,15041,4378,175
415877276,415875302,415890994,15692,4379,175
415897175,415895201,415912159,16958,4380,175
415918376,415916402,415932074,15672,4381,175
415938398,415936206,415952414,16208,4382,175
415958626,415956652,415973295,16643,4383,175
415979512,415977538,415992577,15039,4384,175
415998901,415996709,416011966,15257,4385,175
416018165,416016191,416032813,16622,4386,175
416038992,416037018,416054293,17275,4387,175
416060461,416058487,416073526,15039,4388,175
416079736,416077761,416091851,14090,4389,175
416098043,416096069,416111424,15355,4390,175
416117747,416115555,416131128,15573,4391,175
416137312,416135338,416151348,16010,4392,175
416157574,416155600,416170639,15039,4393,175
416176744,416174770,416191492,16722,4394,175
416197703,416195729,416211718,15989,4395,175
416217921,416215947,416231957,16010,4396,175
416238281,416236089,416252949,16860,4397,175
416259104,416257130,416273457,16327,4398,175
416279781,416277589,416292530,14941,4399,175
416298741,416296768,416311489,14721,4400,175
416317714,416315739,416330780,15041,4401,175
416336968,416334994,416349084,14090,4402,175
416355281,416353306,416368346,15040,4403,175
416374513,416372538,416388527,15989,4404,175
416394726,416392752,416409058,16306,4405,175
416415242,416413268,416430544,17276,4406,175
416436747,416434772,416451710,16938,4407,175
416457923,416455948,416470987,15039,4408,175
416477171,416475196,416491503,16307,4409,175
416497663,416495689,416509463,13774,4410,175
416515690,416513716,416530043,16327,4411,175
416536366,416534175,416550718,16543,4412,175
416556932,416554958,416569995,15037,4413,175
416576220,416574246,416592175,17929,4414,175
416598397,416596423,416611779,15356,4415,175
416618103,416615911,416632454,16543,4416,175
416638658,416636684,416652377,15693,4417,175
416658568,416656594,416671000,14406,4418,175
416677322,416675131,416692624,17493,4419,175
416698836,416696861,416713168,16307,4420,175
416719358,416717384,416732424,15040,4421,175
416738660,416736686,416751409,14723,4422,175
416757569,416755595,416771267,15672,4423,175
416777437,416775463,416789869,14406,4424,175
416796063,416794089,416809444,15355,4425,175
416815664,416813690,416830965,17275,4426,175
416837142,416835168,416852445,17277,4427,175
416858768,416856577,416872466,15889,4428,175
416878652,416876677,416892034,15357,4429,175
416898191,416896217,416913809,17592,4430,175
416920000,416918026,416934648,16622,4431,175
416940872,416938898,416954571,15673,4432,175
416960894,416958702,416974909,16207,4433,175
416981231,416979041,416993663,14622,4434,175
416999986,416997795,417013705,15910,4435,175
417019857,417017883,417033873,15990,4436,175
417040089,417038115,417055707,17592,4437,175
417061920,417059945,417075323,15378,4438,175
417081646,417079455,417094394,14939,4439,175
417100585,417098611,417114282,15671,4440,175
417120606,417118414,417134622,16208,4441,175
417140946,417138755,417154983,16228,4442,175
417161306,417159115,417174054,14939,4443,175
417180255,417178281,417193320,15039,4444,175
417199519,417197544,417214187,16643,4445,175
417220391,417218416,417233139,14723,4446,175
417239316,417237342,417253352,16010,4447,175
417259676,417257485,417272109,14624,4448,175
417278307,417276333,417293946,17613,4449,175
417300269,417298078,417314620,16542,4450,175
417320845,417318871,417333909,15038,4451,175
417340015,417338041,417354880,16839,4452,175
417361098,417359124,417374500,15376,4453,175
417380823,417378632,417397096,18464,4454,175
417403262,417401287,417416328,15041,4455,175
417422537,417420562,417438177,17615,4456,175
417444500,417442310,417460140,17830,4457,175
417466464,417464272,417479529,15257,4458,175
417485852,417483661,417499550,15889,4459,175
417505873,417503682,417520859,17177,4460,175
417527037,417525063,417539785,14722,4461,175
417546108,417543917,417561727,17810,4462,175
417568050,417565859,417582717,16858,4463,175
417588886,417586912,417602267,15355,4464,175
417608591,417606399,417622606,16207,4465,175
417628713,417626738,417643282,16544,4466,175
417649479,417647504,417664147,16643,4467,175
417670318,417668344,417685620,17276,4468,175
417691772,417689798,417704204,14406,4469,175
417710434,417708459,417724154,15695,4470,175
417730378,417728403,417745046,16643,4471,175
417751216,417749242,417764598,15356,4472,175
417770921,417768730,417784641,15911,4473,175
417790821,417788846,417804519,15673,4474,175
417810744,417808770,417826046,17276,4475,175
417832269,417830294,417848225,17931,4476,175
417854449,417852475,417868778,16303,4477,175
417874984,417873010,417889019,16009,4478,175
417895342,417893151,417909673,16522,4479,175
417915904,417913930,417931522,17592,4480,175
417937724,417935749,417951106,15357,4481,175
417957329,417955354,417971997,16643,4482,175
417978222,417976247,417991920,15673,4483,175
417998244,417996052,418012259,16207,4484,175
418018583,418016391,418032618,16227,4485,175
418038809,418036835,418054427,17592,4486,175
418060750,418058559,418074131,15572,4487,175
418080326,418078352,418094341,15989,4488,175
418100664,418098473,418116282,17809,4489,175
418122472,418120498,418135853,15355,4490,175
418142069,418140095,418155134,15039,4491,175
418161301,418159327,418176604,17277,4492,175
418182928,418180737,418197913,17176,4493,175
418204134,418202160,418217516,15356,4494,175
418223676,418221702,418236742,15040,4495,175
418242927,418240953,418256962,16009,4496,175
418263156,418261181,418278142,16961,4497,175
418284349,418282374,418297097,14723,4498,175
418303306,418301332,418316372,15040,4499,175
418322695,418320504,418336077,15573,4500,175
418342306,418340332,418356975,16643,4501,175
418363298,418361107,418376364,15257,4502,175
418382687,418380496,418396386,15890,4503,175
418402584,418400609,418416619,16010,4504,175
418422941,418420751,418435690,14939,4505,175
418441867,418439893,418457823,17930,4506,175
418464032,418462057,418479987,17930,4507,175
418486164,418484190,418501466,17276,4508,175
418507662,418505687,418523619,17932,4509,175
418529851,418527877,418545470,17593,4510,175
418551706,418549732,418565720,15988,4511,175
418571950,418569975,418587886,17911,4512,175
418594121,418592147,418606553,14406,4513,175
418612875,418610684,418627860,17176,4514,175
418634098,418632123,418648767,16644,4515,175
418654966,418652992,418668348,15356,4516,175
418674566,418672592,418688265,15673,4517,175
418694495,418692522,418708826,16304,4518,175
418715150,418712959,418728849,15890,4519,175
418735075,418733101,418750061,16960,4520,175
418756280,418754305,418770316,16011,4521,175
418776640,418774449,418790042,15593,4522,175
418796266,418794292,418809985,15693,4523,175
418816307,418814117,418830660,16543,4524,175
418836869,418834895,418852170,17275,4525,175
418858396,418856422,418873066,16644,4526,175
418879303,418877328,418892366,15038,4527,175
418898596,418896622,418911660,15038,4528,175
418917983,418915792,418932632,16840,4529,175
418938837,418936863,418953169,16306,4530,175
418959493,418957301,418973191,15890,4531,175
418979296,418977323,418994065,16742,4532,175
419000265,418998290,419015884,17594,4533,175
419022208,419020017,419034322,14305,4534,175
419040428,419038454,419054344,15890,4535,175
419060668,419058476,419073731,15255,4536,175
419079966,419077992,419094635,16643,4537,175
419100958,419098767,419113391,14624,4538,175
419119714,419117523,419131828,14305,4539,175
419137987,419136012,419151051,15039,4540,175
419157279,419155305,419170026,14721,4541,175
419176349,419174158,419190047,15889,4542,175
419196201,419194226,419209900,15674,4543,175
419216223,419214032,419228656,14624,4544,175
419234846,419232872,419247909,15037,4545,175
419254075,419252100,419267773,15673,4546,175
419274098,419271905,419286531,14626,4547,175
419292752,419290778,419307105,16327,4548,175
419313316,419311342,419327646,16304,4549,175
419333880,419331906,419350153,18247,4550,175
419356478,419354286,419370810,16524,4551,175
419377011,419375036,419389760,14724,4552,175
419395976,419394001,419411594,17593,4553,175
419417831,419415856,419433451,17595,4554,175
419439775,419437583,419452839,15256,4555,175
419459161,419456970,419472543,15573,4556,175
419478728,419476754,419492741,15987,4557,175
419498847,419496872,419513615,16743,4558,175
419519938,419517746,419532685,14939,4559,175
419539007,419536816,419553993,17177,4560,175
419560315,419558125,419575617,17492,4561,175
419581818,419579843,419596170,16327,4562,175
419602390,419600415,419616426,16011,4563,175
419622604,419620630,419636956,16326,4564,175
419643063,419641088,419658897,17809,4565,175
419665220,419663029,419677335,14306,4566,175
419683658,419681466,419697356,15890,4567,175
419703556,419701582,419719512,17930,4568,175
419725836,419723644,419739554,15910,4569,175
419745877,419743685,419759576,15891,4570,175
419765899,419763708,419779596,15888,4571,175
419785701,419783727,419797715,13988,4572,175
419804038,419801846,419819001,17155,4573,175
419825218,419823244,419840540,17296,4574,175
419846863,419844672,419861214,16542,4575,175
419867537,419865345,419881571,16226,4576,175
419887740,419885765,419901775,16010,4577,175
419908006,419906031,419921387,15356,4578,175
419927612,419925638,419939728,14090,4579,175
419945925,419943951,419960573,16622,4580,175
419966896,419964705,419979645,14940,4581,175
419985751,419983776,420000836,17060,4582,175
420007159,420004968,420020224,15256,4583,175
420026379,420024405,420041362,16957,4584,175
420047573,420045599,420060638,15039,4585,175
420066832,420064858,420081184,16326,4586,175
420087335,420085361,420102975,17614,4587,175
420109177,420107202,420123508,16306,4588,175
420129831,420127640,420142579,14939,4589,175
420148900,420146710,420163548,16838,4590,175
420169747,420167773,420183128,15355,4591,175
420189355,420187380,420204340,16960,4592,175
420210504,420208530,420225172,16642,4593,175
420231329,420229355,420243761,14406,4594,175
420249866,420247892,420264098,16206,4595,175
420270315,420268340,420284667,16327,4596,175
420290858,420288883,420305843,16960,4597,175
420312030,420310055,420326698,16643,4598,175
420332925,420330951,420347275,16324,4599,175
420353599,420351407,420367952,16545,4600,175
420374136,420372162,420388172,16010,4601,175
420394399,420392424,420408434,16010,4602,175
420414657,420412683,420428038,15355,4603,175
420434214,420432240,420447280,15040,4604,175
420453491,420451517,420468476,16959,4605,175
420474799,420472608,420487865,15257,4606,175
420494057,420492083,420508072,15989,4607,175
420514223,420512248,420529526,17278,4608,175
420535849,420533658,420549229,15571,4609,175
420555414,420553440,420569450,16010,4610,175
420575635,420573660,420589966,16306,4611,175
420596162,420594188,420609225,15037,4612,175
420615442,420613468,420629159,15691,4613,175
420635344,420633370,420649380,16010,4614,175
420655561,420653586,420669260,15674,4615,175
420675488,420673512,420690157,16645,4616,175
420696365,420694390,420708481,14091,4617,175
420714700,420712726,420728419,15693,4618,175
420734742,420732551,420746857,14306,4619,175
420753053,420751079,420767405,16326,4620,175
420773575,420771600,420789849,18249,4621,175
420796075,420794102,420810744,16642,4622,175
420817068,420814876,420830766,15890,4623,175
420836994,420835020,420852295,17275,4624,175
420858618,420856427,420871684,15257,4625,175
420877895,420875920,420892881,16961,4626,175
420899204,420897013,420911635,14622,4627,175
420917742,420915767,420932606,16839,4628,175
420938929,420936738,420952964,16226,4629,175
420959906,420957932,420974505,16573,4630,175
420980696,420978721,420993444,14723,4631,175
420999654,420997680,421012086,14406,4632,175
421018303,421016329,421031368,15039,4633,175
421037690,421035499,421052042,16543,4634,175
421058366,421056175,421072719,16544,4635,175
421078939,421076964,421093291,16327,4636,175
421099445,421097470,421115083,17613,4637,175
421121312,421119338,421135959,16621,4638,175
421142153,421140179,421155534,15355,4639,175
421161857,421159666,421177497,17831,4640,175
421183723,421181749,421196155,14406,4641,175
421202385,421200411,421217054,16643,4642,175
421223224,421221249,421236943,15694,4643,175
421243265,421241074,421257913,16839,4644,175
421264123,421262149,421276872,14723,4645,175
421283058,421281083,421297389,16306,4646,175
421303603,421301629,421317638,16009,4647,175
421323961,421321770,421338311,16541,4648,175
421344635,421342443,421357699,15256,4649,175
421363928,421361954,421377963,16009,4650,175
421384179,421382205,421399482,17277,4651,175
421405805,421403614,421420474,16860,4652,175
421426797,421424606,421442438,17832,4653,175
421448611,421446636,421463279,16643,4654,175
421469463,421467488,421482209,14721,4655,175
421488418,421486444,421502116,15672,4656,175
421508336,421506362,421521739,15377,4657,175
421527934,421525961,421540682,14721,4658,175
421546858,421544884,421561843,16959,4659,175
421568055,421566081,421580487,14406,4660,175
421586723,421584748,421599471,14723,4661,175
421605793,421603602,421620145,16543,4662,175
421626468,421624277,421642741,18464,4663,175
421649065,421646873,421664048,17175,4664,175
421670371,421668180,421683773,15593,4665,175
421689989,421688015,421704973,16958,4666,175
421711079,421709105,421725628,16523,4667,175
421731827,421729853,421746497,16644,4668,175
421752682,421750708,421766063,15355,4669,175
421772386,421770195,421788343,18148,4670,175
421794578,421792603,421808593,15990,4671,175
421814818,421812844,421827250,14406,4672,175
421833572,421831381,421847607,16226,4673,175
421853763,421851788,421867460,15672,4674,175
421873659,421871686,421889933,18247,4675,175
421896102,421894128,421909166,15038,4676,175
421915361,421913386,421930031,16645,4677,175
421936221,421934247,421950891,16644,4678,175
421957214,421955023,421972177,17154,4679,175
421978285,421976309,421991134,14825,4680,175
421997457,421995265,422011155,15890,4681,175
422017339,422015365,422031354,15989,4682,175
422037516,422035542,422051868,16326,4683,175
422058041,422056067,422072394,16327,4684,175
422078602,422076628,422092638,16010,4685,175
422098962,422096771,422112996,16225,4686,175
422119319,422117128,422134957,17829,4687,175
422141280,422139089,422154977,15888,4688,175
422161201,422159227,422175871,16644,4689,175
422182063,422180087,422196733,16646,4690,175
422202839,422200865,422217071,16206,4691,175
422223265,422221290,422238567,17277,4692,175
422244799,422242826,422260417,17591,4693,175
422266589,422264614,422280604,15990,4694,175
422286811,422284837,422302114,17277,4695,175
422308314,422306340,422323954,17614,4696,175
422330151,422328177,422344503,16326,4697,175
422350699,422348725,422364102,15377,4698,175
422370426,422368234,422384757,16523,4699,175
422390943,422388968,422404008,15040,4700,175
422410184,422408211,422425169,16958,4701,175
422431402,422429428,422447359,17931,4702,175
422453596,422451622,422468896,17274,4703,175
422475048,422473073,422487162,14089,4704,175
422493313,422491339,422505428,14089,4705,175
422511660,422509686,422526013,16327,4706,175
422532249,422530275,422544047,13772,4707,175
422550227,422548252,422564580,16328,4708,175
422570788,422568814,422584822,16008,4709,175
422591144,422588954,422604525,15571,4710,175
422610711,422608736,422622825,14089,4711,175
422628931,422626957,422643817,16860,4712,175
422650140,422647949,422664810,16861,4713,175
422671001,422669026,422683434,14408,4714,175
422689665,422687691,422703385,15694,4715,175
422709612,422707638,422723626,15988,4716,175
422729948,422727757,422743013,15256,4717,175
422749335,422747144,422763688,16544,4718,175
422770011,422767820,422782443,14623,4719,175
422788639,422786664,422804912,18248,4720,175
422811116,422809142,422826100,16958,4721,175
422832311,422830336,422845377,15041,4722,175
422851585,422849610,422866253,16643,4723,175
422872444,422870470,422887112,16642,4724,175
422893320,422891346,422907335,15989,4725,175
422913658,422911466,422926089,14623,4726,175
422932413,422930221,422946766,16545,4727,175
422952982,422951008,422966996,15988,4728,175
422973199,422971224,422987530,16306,4729,175
422993748,422991773,423009387,17614,4730,175
423015710,423013519,423029724,16205,4731,175
423036049,423033857,423049769,15912,4732,175
423055931,423053957,423070917,16960,4733,175
423077133,423075159,423091801,16642,4734,175
423098020,423096046,423112984,16938,4735,175
423119196,423117222,423133549,16327,4736,175
423139872,423137681,423153886,16205,4737,175
423160077,423158103,423173775,15672,4738,175
423179961,423177987,423193342,15355,4739,175
423199524,423197550,423212927,15377,4740,175
423219250,423217058,423232969,15911,4741,175
423239191,423237217,423253227,16010,4742,175
423259550,423257359,423274852,17493,4743,175
423281008,423279034,423295022,15988,4744,175
423301237,423299263,423314617,15354,4745,175
423320940,423318749,423334638,15889,4746,175
423340962,423338770,423355610,16840,4747,175
423361825,423359851,423376175,16324,4748,175
423382281,423380307,423395129,14822,4749,175
423401291,423399317,423414988,15671,4750,175
423421311,423419120,423435643,16523,4751,175
423441800,423439825,423456130,16305,4752,175
423462237,423460262,423475719,15457,4753,175
423481913,423479939,423496582,16643,4754,175
423502806,423500832,423517792,16960,4755,175
423524010,423522035,423537709,15674,4756,175
423543930,423541956,423558577,16621,4757,175
423564747,423562773,423577180,14407,4758,175
423583396,423581422,423596798,15376,4759,175
423603121,423600930,423616503,15573,4760,175
423622825,423620634,423636861,16227,4761,175
423643185,423640993,423657200,16207,4762,175
423663523,423661332,423678825,17493,4763,175
423685042,423683067,423698107,15040,4764,175
423704213,423702238,423717377,15139,4765,175
423723592,423721618,423736025,14407,4766,175
423742259,423740285,423756273,15988,4767,175
423762379,423760405,423777244,16839,4768,175
423783463,423781489,423799082,17593,4769,175
423805287,423803313,423818986,15673,4770,175
423825169,423823195,423839204,16009,4771,175
423845417,423843443,423858165,14722,4772,175
423864390,423862416,423877456,15040,4773,175
423883652,423881678,423898300,16622,4774,175
423904624,423902433,423919589,17156,4775,175
423925794,423923819,423938860,15041,4776,175
423945072,423943098,423959425,16327,4777,175
423965637,423963662,423979019,15357,4778,175
423985341,423983151,423999378,16227,4779,175
424005580,424003606,424018960,15354,4780,175
424025283,424023092,424039002,15910,4781,175
424045155,424043181,424058220,15039,4782,175
424064325,424062351,424078873,16522,4783,175
424085196,424083005,424099231,16226,4784,175
424105555,424103363,424119907,16544,4785,175
424126013,424124039,424140464,16425,4786,175
424146678,424144704,424161031,16327,4787,175
424167138,424165163,424182201,17038,4788,175
424188421,424186447,424203385,16938,4789,175
424209558,424207585,424222938,15353,4790,175
424229261,424227070,424243613,16543,4791,175
424249805,424247830,424263502,15672,4792,175
424269825,424267634,424282889,15255,4793,175
424289212,424287021,424302910,15889,4794,175
424309101,424307126,424322503,15377,4795,175
424328826,424326635,424343178,16543,4796,175
424349372,424347397,424363725,16328,4797,175
424369944,424367968,424383642,15674,4798,175
424389964,424387773,424404634,16861,4799,175
424410957,424408766,424427230,18464,4800,175
424433399,424431425,424447098,15673,4801,175
424453420,424451230,424465853,14623,4802,175
424472176,424469984,424486507,16523,4803,175
424492658,424490684,424506989,16305,4804,175
424513187,424511213,424527223,16010,4805,175
424533546,424531355,424546927,15572,4806,175
424553250,424551058,424568552,17494,4807,175
424574737,424572762,424589406,16644,4808,175
424595729,424593538,424611032,17494,4809,175
424617356,424615165,424632342,17177,4810,175
424638666,424636474,424653336,16862,4811,175
424659658,424657468,424673672,16204,4812,175
424679883,424677909,424693898,15989,4813,175
424700113,424698138,424715078,16940,4814,175
424721292,424719318,424733091,13773,4815,175
424739298,424737324,424753967,16643,4816,175
424760178,424758204,424774846,16642,4817,175
424780998,424779023,424793114,14091,4818,175
424799435,424797245,424814103,16858,4819,175
424820302,424818328,424834020,15692,4820,175
424840178,424838203,424856451,18248,4821,175
424862653,424860678,424874768,14090,4822,175
424880980,424879006,424895333,16327,4823,175
424901569,424899594,424914950,15356,4824,175
424921273,424919082,424934021,14939,4825,175
424940241,424938266,424953960,15694,4826,175
424960177,424958203,424973875,15672,4827,175
424980030,424978056,424994382,16326,4828,175
425000704,424998514,425014422,15908,4829,175
425020633,425018659,425034964,16305,4830,175
425041144,425039170,425054210,15040,4831,175
425060380,425058406,425073444,15038,4832,175
425079617,425077643,425092365,14722,4833,175
425098560,425096586,425111942,15356,4834,175
425118124,425116149,425133743,17594,4835,175
425139927,425137953,425152676,14723,4836,175
425158999,425156807,425171748,14941,4837,175
425177911,425175937,425191609,15672,4838,175
425197844,425195870,425209644,13774,4839,175
425215844,425213870,425230830,16960,4840,175
425237014,425235039,425251049,16010,4841,175
425257218,425255244,425269016,13772,4842,175
425275251,425273276,425289286,16010,4843,175
425295492,425293518,425309528,16010,4844,175
425315747,425313773,425330732,16959,4845,175
425337055,425334864,425349170,14306,4846,175
425355375,425353401,425370677,17276,4847,175
425377000,425374809,425389747,14938,4848,175
425395967,425393992,425410298,16306,4849,175
425416493,425414518,425430846,16328,4850,175
425437048,425435074,425453322,18248,4851,175
425459556,425457582,425473254,15672,4852,175
425479577,425477386,425492008,14622,4853,175
425498114,425496139,425512566,16427,4854,175
425518738,425516765,425532774,16009,4855,175
425539001,425537026,425553014,15988,4856,175
425559192,425557218,425575148,17930,4857,175
425581341,425579366,425595061,15695,4858,175
425601271,425599297,425615307,16010,4859,175
425621529,425619555,425634909,15354,4860,175
425641231,425639040,425656532,17492,4861,175
425662855,425660664,425678791,18127,4862,175
425685115,425682923,425697862,14939,4863,175
425704185,425701993,425719488,17495,4864,175
425725678,425723704,425740008,16304,4865,175
425746201,425744227,425758632,14405,4866,175
425764789,425762814,425778824,16010,4867,175
425785147,425782956,425800786,17830,4868,175
425806994,425805019,425821325,16306,4869,175
425827511,425825537,425841843,16306,4870,175
425848165,425845975,425861863,15888,4871,175
425868075,425866100,425884031,17931,4872,175
425890227,425888252,425903924,15672,4873,175
425910246,425908056,425926203,18147,4874,175
425932527,425930336,425946225,15889,4875,175
425952547,425950357,425967533,17176,4876,175
425973858,425971666,425986924,15258,4877,175
425993247,425991055,426007600,16545,4878,175
426013816,426011841,426029116,17275,4879,175
426035439,426033248,426049771,16523,4880,175
426055960,426053986,426069025,15039,4881,175
426075178,426073204,426088876,15672,4882,175
426095198,426093007,426109867,16860,4883,175
426116190,426113999,426129572,15573,4884,175
426135779,426133804,426151102,17298,4885,175
426157327,426155352,426170076,14724,4886,175
426176398,426174207,426189146,14939,4887,175
426195351,426193377,426210969,17592,4888,175
426217190,426215215,426232491,17276,4889,175
426238671,426236696,426251737,15041,4890,175
426257960,426255986,426271974,15988,4891,175
426278204,426276229,426294160,17931,4892,175
426300382,426298408,426315683,17275,4893,175
426321859,426319885,426336528,16643,4894,175
426342728,426340754,426358345,17591,4895,175
426364573,426362600,426379558,16958,4896,175
426385881,426383690,426399916,16226,4897,175
426406109,426404135,426420778,16643,4898,175
426427101,426424910,426439850,14940,4899,175
426446172,426443981,426461789,17808,4900,175
426468111,426465921,426482779,16858,4901,175
426488885,426486911,426502800,15889,4902,175
426509019,426507044,426524638,17594,4903,175
426530806,426528832,426544525,15693,4904,175
426550847,426548656,426563913,15257,4905,175
426570019,426568044,426585084,17040,4906,175
426591406,426589216,426605442,16226,4907,175
426611659,426609684,426624723,15039,4908,175
426631045,426628854,426646345,17491,4909,175
426652564,426650590,426667212,16622,4910,175
426673536,426671344,426687550,16206,4911,175
426693746,426691772,426708416,16644,4912,175
426714739,426712548,426729407,16859,4913,175
426735618,426733643,426749653,16010,4914,175
426755976,426753785,426769357,15572,4915,175
426775510,426773534,426788891,15357,4916,175
426795054,426793080,426808753,15673,4917,175
426815076,426812885,426829723,16838,4918,175
426836046,426833855,426849428,15573,4919,175
426855610,426853636,426869309,15673,4920,175
426875541,426873567,426888606,15039,4921,175
426894929,426892738,426908944,16206,4922,175
426915124,426913150,426928822,15672,4923,175
426935145,426932954,426948527,15573,4924,175
426954848,426952658,426970150,17492,4925,175
426976256,426974282,426991142,16860,4926,175
426997376,426995401,427010124,14723,4927,175
427016295,427014320,427031914,17594,4928,175
427038237,427036046,427051619,15573,4929,175
427057828,427055854,427073131,17277,4930,175
427079453,427077263,427091885,14622,4931,175
427098092,427096118,427112762,16644,4932,175
427118920,427116945,427132301,15356,4933,175
427138530,427136556,427152860,16304,4934,175
427159042,427157068,427172762,15694,4935,175
427178951,427176977,427193599,16622,4936,175
427199812,427197838,427215748,17910,4937,175
427221975,427220001,427236327,16326,4938,175
427242536,427240562,427257522,16960,4939,175
427263845,427261654,427279145,17491,4940,175
427285364,427283389,427299379,15990,4941,175
427305486,427303511,427321660,18149,4942,175
427327866,427325891,427341248,15357,4943,175
427347465,427345490,427362767,17277,4944,175
427368920,427366945,427383905,16960,4945,175
427390139,427388165,427404176,16011,4946,175
427410499,427408308,427423880,15572,4947,175
427430085,427428111,427444438,16327,4948,175
427450761,427448570,427462876,14306,4949,175
427469045,427467071,427484029,16958,4950,175
427490255,427488282,427504924,16642,4951,175
427511090,427509116,427524809,15693,4952,175
427531041,427529067,427546027,16960,4953,175
427552225,427550251,427565921,15670,4954,175
427572077,427570103,427587062,16959,4955,175
427593279,427591305,427607314,16009,4956,175
427613548,427611573,427627878,16305,4957,175
427634087,427632112,427647151,15039,4958,175
427653312,427651338,427665427,14089,4959,175
427671652,427669678,427686320,16642,4960,175
427692642,427690452,427706974,16522,4961,175
427713296,427711106,427728281,17175,4962,175
427734438,427732464,427749739,17275,4963,175
427755950,427753976,427768698,14722,4964,175
427774920,427772945,427787986,15041,4965,175
427794309,427792118,427808345,16227,4966,175
427814548,427812573,427829217,16644,4967,175
427835428,427833452,427850729,17277,4968,175
427856928,427854954,427871281,16327,4969,175
427877604,427875413,427891323,15910,4970,175
427897508,427895534,427910256,14722,4971,175
427916580,427914388,427932199,17811,4972,175
427938394,427936420,427954011,17591,4973,175
427960117,427958143,427973599,15456,4974,175
427979704,427977730,427993503,15773,4975,175
427999694,427997720,428014659,16939,4976,175
428020874,428018899,428035859,16960,4977,175
428042044,428040070,428057663,17593,4978,175
428063892,428061918,428077908,15990,4979,175
428084137,428082163,428097835,15672,4980,175
428104158,428101967,428117222,15255,4981,175
428123414,428121439,428138378,16939,4982,175
428144593,428142618,428157974,15356,4983,175
428164156,428162181,428176904,14723,4984,175
428183097,428181123,428195845,14722,4985,175
428202167,428199976,428216520,16544,4986,175
428222686,428220712,428234800,14088,4987,175
428241028,428239053,428257302,18249,4988,175
428263512,428261537,428278161,16624,4989,175
428284484,428282293,428299787,17494,4990,175
428306112,428303920,428320782,16862,4991,175
428326978,428325004,428341013,16009,4992,175
428347199,428345224,428362184,16960,4993,175
428368384,428366409,428381447,15038,4994,175
428387665,428385689,428401364,15675,4995,175
428407559,428405583,428421257,15674,4996,175
428427580,428425389,428442249,16860,4997,175
428448572,428446381,428464211,17830,4998,175
428470534,428468343,428484570,16227,4999,175
428490893,428488702,428504929,16227,5000,175
428511394,428509120,428526777,17657,1,200
428533130,428530640,428548176,17536,2,200
428554529,428552039,428568014,15975,3,200
428574367,428571877,428589096,17219,4,200
428595449,428592959,428608280,15321,5,200
428614631,428612142,428627756,15614,6,200
428633939,428631665,428647403,15738,7,200
428653648,428651374,428668082,16708,8,200
428674435,428671945,428690134,18189,9,200
428696316,428694043,428711362,17319,10,200
428717803,428715314,428731582,16268,11,200
428738023,428735534,428751465,15931,12,200
428757908,428755417,428772954,17537,13,200
428779298,428777025,428794049,17024,14,200
428800490,428798001,428816189,18188,15,200
428822632,428820141,428836749,16608,16,200
428843191,428840701,428858892,18191,17,200
428865334,428862844,428880401,17557,18,200
428886843,428884353,428899988,15635,19,200
428906428,428903939,428921473,17534,20,200
428927751,428925478,428941214,15736,21,200
428947504,428945230,428961264,16034,22,200
428967706,428965216,428982457,17241,23,200
428988766,428986493,429001913,15420,24,200
429008245,429005972,429021076,15104,25,200
429027518,429025028,429039399,14371,26,200
429045694,429043420,429060108,16688,27,200
429066438,429064165,429080218,16053,28,200
429086659,429084170,429100754,16584,29,200
429107196,429104706,429119710,15004,30,200
429125981,429123709,429140711,17002,31,200
429147035,429144763,429161153,16390,32,200
429167466,429165193,429183484,18291,33,200
429189925,429187436,429205941,18505,34,200
429212271,429209999,429227654,17655,35,200
429234096,429231606,429250112,18506,36,200
429256554,429254065,429271305,17240,37,200
429277593,429275320,429291689,16369,38,200
429298130,429295641,429311910,16269,39,200
429318351,429315862,429333396,17534,40,200
429339837,429337348,429354566,17218,41,200
429360919,429358646,429375353,16707,42,200
429381795,429379305,429395892,16587,43,200
429402241,429399968,429415071,15103,44,200
429421513,429419023,429436265,17242,45,200
429442708,429440218,429455539,15321,46,200
429461981,429459491,429477999,18508,47,200
429484296,429482023,429496789,14766,48,200
429503126,429500853,429515323,14470,49,200
429521765,429519275,429534258,14983,50,200
429540699,429538210,429554795,16585,51,200
429561238,429558748,429575334,16586,52,200
429581667,429579394,429596080,16686,53,200
429602523,429600033,429615670,15637,54,200
429622112,429619621,429634941,15320,55,200
429641290,429639017,429656020,17003,56,200
429662462,429659972,429675925,15953,57,200
429682366,429679877,429695513,15636,58,200
429701955,429699465,429715418,15953,59,200
429721729,429719457,429734875,15418,60,200
429741316,429738827,429755730,16903,61,200
429762174,429759682,429775320,15638,62,200
429781661,429779388,429794491,15103,63,200
429800932,429798443,429814396,15953,64,200
429820838,429818348,429834618,16270,65,200
429841060,429838571,429855790,17219,66,200
429862107,429859833,429874303,14470,67,200
429880613,429878340,429895047,16707,68,200
429901489,429898999,429915923,16924,69,200
429922239,429919967,429936653,16686,70,200
429943096,429940605,429957529,16924,71,200
429963877,429961604,429979578,17974,72,200
429985894,429983621,429998070,14449,73,200
430004405,430002132,430018816,16684,74,200
430025148,430022875,430039266,16391,75,200
430045708,430043218,430059171,15953,76,200
430065522,430063248,430079618,16370,77,200
430086061,430083571,430101423,17852,78,200
430107710,430105437,430122777,17340,79,200
430129218,430126729,430142998,16269,80,200
430149440,430146950,430161953,15003,81,200
430168395,430165904,430184411,18507,82,200
430190854,430188363,430203050,14687,83,200
430209491,430207001,430225825,18824,84,200
430232266,430229777,430246996,17219,85,200
430253292,430251018,430268360,17342,86,200
430274642,430272368,430288738,16370,87,200
430295180,430292690,430309910,17220,88,200
430316245,430313971,430331313,17342,89,200
430337756,430335265,430351535,16270,90,200
430357977,430355487,430373678,18191,91,200
430380119,430377630,430394530,16900,92,200
430400972,430398482,430413464,14982,93,200
430419907,430417416,430434975,17559,94,200
430441416,430438927,430455513,16586,95,200
430461954,430459465,430473835,14370,96,200
430480119,430477846,430492632,14786,97,200
430499073,430496583,430511883,15300,98,200
430518191,430515918,430532604,16686,99,200
430539045,430536556,430553457,16901,100,200
430559988,430557498,430575055,17557,101,200
430581585,430579096,430596652,17556,102,200
430603075,430600802,430616876,16074,103,200
430623304,430621030,430638034,17004,104,200
430644433,430642160,430659816,17656,105,200
430666347,430663857,430681097,17240,106,200
430687532,430685259,430702916,17657,107,200
430709348,430707074,430722474,15400,108,200
430728891,430726617,430743324,16707,109,200
430749855,430747365,430762031,14666,110,200
430768388,430766116,430784722,18606,111,200
430791162,430788889,430805576,16687,112,200
430812107,430809617,430826519,16902,113,200
430833050,430830560,430847800,17240,114,200
430854331,430851841,430866822,14981,115,200
430873352,430870862,430887447,16585,116,200
430893976,430891488,430909360,17872,117,200
430915804,430913531,430930553,17022,118,200
430936914,430934641,430950694,16053,119,200
430957225,430954735,430970688,15953,120,200
430977218,430974728,430989711,14983,121,200
430996241,430993751,431011287,17536,122,200
431017817,431015328,431033201,17873,123,200
431039732,431037242,431053216,15974,124,200
431059637,431057363,431075336,17973,125,200
431081753,431079480,431097114,17634,126,200
431103538,431101264,431117319,16055,127,200
431123850,431121360,431137630,16270,128,200
431144161,431141671,431157603,15932,129,200
431164133,431161643,431179179,17536,130,200
431185709,431183220,431199806,16586,131,200
431206337,431203847,431221067,17220,132,200
431227447,431225173,431239327,14154,133,200
431245708,431243436,431259488,16052,134,200
431266019,431263529,431277899,14370,135,200
431284430,431281940,431298547,16607,136,200
431304947,431302673,431319359,16686,137,200
431325778,431323506,431339263,15757,138,200
431345792,431343303,431358919,15616,139,200
431365359,431363087,431377555,14468,140,200
431384085,431381595,431399469,17874,141,200
431406000,431403510,431420096,16586,142,200
431426626,431424137,431439772,15635,143,200
431446302,431443812,431458182,14370,144,200
431464712,431462222,431478174,15952,145,200
431484578,431482305,431496755,14450,146,200
431503287,431500796,431519621,18825,147,200
431526152,431523663,431540901,17238,148,200
431547433,431544942,431561549,16607,149,200
431567980,431565707,431591279,25572,150,200
431597810,431595321,431609986,14665,151,200
431616517,431614027,431631267,17240,152,200
431637635,431635362,431652364,17002,153,200
431658742,431656469,431673810,17341,154,200
431680341,431677851,431695386,17535,155,200
431701917,431699427,431717618,18191,156,200
431723979,431721706,431739996,18290,157,200
431746527,431744037,431758723,14686,158,200
431765156,431762883,431779569,16686,159,200
431786100,431783610,431799226,15616,160,200
431805608,431803335,431821623,18288,161,200
431828155,431825665,431842569,16904,162,200
431849101,431846611,431863198,16587,163,200
431869728,431867239,431884141,16902,164,200
431890586,431888312,431903078,14766,165,200
431909609,431907119,431922755,15636,166,200
431929139,431926866,431943573,16707,167,200
431950105,431947615,431964518,16903,168,200
431970892,431968619,431983721,15102,169,200
431990150,431987877,432006167,18290,170,200
432012699,432010209,432025824,15615,171,200
432032269,432029995,432045098,15103,172,200
432051630,432049139,432066697,17558,173,200
432073091,432070818,432089108,18290,174,200
432095510,432093237,432108341,15104,175,200
432114752,432112479,432129799,17320,176,200
432136329,432133840,432151080,17240,177,200
432157611,432155121,432170758,15637,178,200
432177184,432174911,432190668,15757,179,200
432197199,432194709,432213217,18508,180,200
432219748,432217259,432235766,18507,181,200
432242170,432239897,432255316,15419,182,200
432261846,432259357,432275943,16586,183,200
432282475,432279985,432297205,17220,184,200
432303737,432301247,432316251,15004,185,200
432322688,432320415,432335201,14786,186,200
432341731,432339242,432356165,16923,187,200
432362574,432360301,432377641,17340,188,200
432384057,432381784,432398175,16391,189,200
432404544,432402271,432417690,15419,190,200
432424221,432421731,432439287,17556,191,200
432445821,432443329,432459938,16609,192,200
432466470,432463980,432481853,17873,193,200
432488255,432485982,432503321,17339,194,200
432509852,432507363,432523970,16607,195,200
432530502,432528012,432546518,18506,196,200
432553050,432550560,432567463,16903,197,200
432573994,432571504,432588111,16607,198,200
432594553,432592280,432610254,17974,199,200
432616785,432614295,432630269,15974,200,200
432636801,432634311,432649631,15320,201,200
432656162,432653672,432672179,18507,202,200
432678711,432676221,432691857,15636,203,200
432698274,432696001,432711400,15399,204,200
432717778,432715504,432732191,16687,205,200
432738723,432736233,432752820,16587,206,200
432759351,432756862,432774418,17556,207,200
432780835,432778562,432795881,17319,208,200
432802412,432799923,432816191,16268,209,200
432822628,432820356,432837990,17634,210,200
432844522,432842032,432857965,15933,211,200
432864498,432862007,432878911,16904,212,200
432885305,432883033,432899738,16705,213,200
432906180,432903908,432919644,15736,214,200
432926175,432923685,432939639,15954,215,200
432946170,432943680,432961554,17874,216,200
432968085,432965596,432981548,15952,217,200
432988079,432985589,433002492,16903,218,200
433009023,433006534,433023120,16586,219,200
433029651,433027162,433044063,16901,220,200
433050593,433048105,433065343,17238,221,200
433071778,433069505,433087140,17635,222,200
433093673,433091183,433107453,16270,223,200
433113985,433111495,433128398,16903,224,200
433134929,433132440,433150946,18506,225,200
433157365,433155092,433171144,16052,226,200
433177676,433175186,433191476,16290,227,200
433197898,433195624,433212311,16687,228,200
433218752,433216479,433235085,18606,229,200
433241617,433239127,433254109,14982,230,200
433260640,433258151,433274736,16585,231,200
433281268,433278778,433295048,16270,232,200
433301579,433299090,433314092,15002,233,200
433320455,433318183,433333918,15735,234,200
433340316,433338044,433354729,16685,235,200
433361148,433358875,433376532,17657,236,200
433382926,433380654,433397654,17000,237,200
433404185,433401696,433417014,15318,238,200
433423415,433421143,433437511,16368,239,200
433444043,433441553,433458457,16904,240,200
433464989,433462499,433478769,16270,241,200
433485195,433482922,433498342,15420,242,200
433504766,433502493,433519200,16707,243,200
433525732,433523242,433539512,16270,244,200
433545929,433543656,433562262,18606,245,200
433568679,433566406,433583409,17003,246,200
433589843,433587570,433602990,15420,247,200
433609521,433607031,433622035,15004,248,200
433628444,433626171,433641570,15399,249,200
433647992,433645719,433661770,16051,250,200
433668301,433665812,433683663,17851,251,200
433690074,433687801,433702904,15103,252,200
433709319,433707046,433721832,14786,253,200
433728363,433725873,433742776,16903,254,200
433749170,433746897,433763583,16686,255,200
433770114,433767625,433782628,15003,256,200
433789159,433786669,433803256,16587,257,200
433809668,433807395,433823764,16369,258,200
433830297,433827806,433844710,16904,259,200
433851153,433848880,433864953,16073,260,200
433871390,433869117,433885824,16707,261,200
433892203,433889930,433906300,16370,262,200
433912703,433910430,433927116,16686,263,200
433933648,433931158,433948397,17239,264,200
433954815,433952542,433969860,17318,265,200
433976284,433974011,433989409,15398,266,200
433995939,433993450,434010669,17219,267,200
434017201,434014711,434031002,16291,268,200
434037419,434035147,434050880,15733,269,200
434057411,434054922,434073111,18189,270,200
434079531,434077258,434092995,15737,271,200
434099364,434097092,434111857,14765,272,200
434118389,434115899,434133435,17536,273,200
434139967,434137477,434155330,17853,274,200
434161711,434159438,434175175,15737,275,200
434181707,434179217,434196775,17558,276,200
434203308,434200817,434216139,15322,277,200
434222670,434220180,434236113,15933,278,200
434242644,434240154,434256741,16587,279,200
434263272,434260783,434278022,17239,280,200
434284553,434282064,434298650,16586,281,200
434305015,434302742,434320716,17974,282,200
434327141,434324868,434342524,17656,283,200
434349055,434346566,434363152,16586,284,200
434369589,434367316,434384657,17341,285,200
434391099,434388825,434406167,17342,286,200
434412698,434410209,434426182,15973,287,200
434432716,434430224,434446180,15956,288,200
434452604,434450331,434467986,17655,289,200
434474518,434472028,434488298,16270,290,200
434494716,434492443,434507207,14764,291,200
434513738,434511248,434527202,15954,292,200
434533577,434531304,434546724,15420,293,200
434553092,434550819,434567189,16370,294,200
434573721,434571231,434587818,16587,295,200
434594246,434591973,434608048,16075,296,200
434614580,434612090,434628043,15953,297,200
434634574,434632084,434650590,18506,298,200
434657121,434654632,434669952,15320,299,200
434676484,434673994,434692185,18191,300,200
434698718,434696227,434712814,16587,301,200
434719211,434716938,434733624,16686,302,200
434740156,434737666,434752987,15321,303,200
434759413,434757139,434774163,17024,304,200
434780696,434778206,434794160,15954,305,200
434800691,434798202,434815442,17240,306,200
434821973,434819484,434838307,18823,307,200
434844838,434842349,434858322,15973,308,200
434864697,434862424,434880397,17973,309,200
434886816,434884543,434901566,17023,310,200
434908098,434905608,434923481,17873,311,200
434930014,434927524,434946030,18506,312,200
434952469,434950197,434965617,15420,313,200
434972149,434969659,434984661,15002,314,200
434991193,434988703,435006578,17875,315,200
435013110,435010621,435026235,15614,316,200
435032661,435030387,435046104,15717,317,200
435052635,435050146,435067047,16901,318,200
435073580,435071090,435087993,16903,319,200
435094527,435092036,435108623,16587,320,200
435115155,435112665,435129251,16586,321,200
435135782,435133293,435150216,16923,322,200
435156749,435154259,435173083,18824,323,200
435179615,435177126,435195315,18189,324,200
435201847,435199357,435217229,17872,325,200
435223628,435221355,435238378,17023,326,200
435244909,435242420,435258056,15636,327,200
435264453,435262181,435278570,16389,328,200
435285102,435282612,435298882,16270,329,200
435305414,435302924,435319531,16607,330,200
435325964,435323692,435341326,17634,331,200
435347692,435345419,435362106,16687,332,200
435368536,435366262,435382948,16686,333,200
435389481,435386990,435403260,16270,334,200
435409792,435407302,435425175,17873,335,200
435431590,435429317,435446002,16685,336,200
435452534,435450044,435466630,16586,337,200
435473162,435470672,435488546,17874,338,200
435495079,435492588,435508543,15955,339,200
435515073,435512584,435527883,15299,340,200
435534413,435531924,435547855,15931,341,200
435554292,435552020,435568071,16051,342,200
435574439,435572167,435588853,16686,343,200
435595385,435592895,435609481,16586,344,200
435616012,435613523,435629790,16267,345,200
435636322,435633832,435650101,16269,346,200
435656543,435654270,435671294,17024,347,200
435677691,435675418,435689888,14470,348,200
435696333,435694060,435710429,16369,349,200
435716961,435714471,435732029,17558,350,200
435738562,435736071,435753312,17241,351,200
435759755,435757482,435772268,14786,352,200
435778712,435776439,435794413,17974,353,200
435800853,435798580,435814316,15736,354,200
435820847,435818358,435834963,16605,355,200
435841335,435839062,435854776,15714,356,200
435861307,435858817,435875424,16607,357,200
435881955,435879466,435893835,14369,358,200
435900217,435897943,435913659,15716,359,200
435920191,435917700,435934625,16925,360,200
435941157,435938667,435953966,15299,361,200
435960497,435958007,435972989,14982,362,200
435979519,435977030,435993932,16902,363,200
436000463,435997974,436014875,16901,364,200
436021249,436018975,436034080,15105,365,200
436040611,436038121,436054392,16271,366,200
436060794,436058520,436075543,17023,367,200
436081959,436079686,436096392,16706,368,200
436102821,436100548,436116284,15736,369,200
436122815,436120326,436137882,17556,370,200
436144325,436142052,436158105,16053,371,200
436164484,436162212,436179234,17022,372,200
436185676,436183403,436200089,16686,373,200
436206621,436204131,436219135,15004,374,200
436225667,436223177,436239130,15953,375,200
436245660,436243172,436259441,16269,376,200
436265973,436263483,436281673,18190,377,200
436288205,436285715,436302301,16586,378,200
436308706,436306433,436320587,14154,379,200
436327119,436324629,436341215,16586,380,200
436347615,436345341,436362365,17024,381,200
436368896,436366407,436384912,18505,382,200
436391444,436388954,436405540,16586,383,200
436411967,436409694,436426063,16369,384,200
436432595,436430105,436446395,16290,385,200
436452927,436450437,436466708,16271,386,200
436473240,436470750,436487989,17239,387,200
436494521,436492031,436507667,15636,388,200
436514198,436511708,436528611,16903,389,200
436535033,436532760,436547863,15103,390,200
436554394,436551904,436569462,17558,391,200
436575993,436573504,436590722,17218,392,200
436597152,436594879,436611249,16370,393,200
436617780,436615291,436631244,15953,394,200
436637776,436635286,436650606,15320,395,200
436657137,436654647,436672500,17853,396,200
436679032,436676542,436693127,16585,397,200
436699659,436697169,436715042,17873,398,200
436721574,436719084,436734405,15321,399,200
436740938,436738447,436754084,15637,400,200
436760616,436758126,436775050,16924,401,200
436781581,436779092,436796310,17218,402,200
436802842,436800352,436817255,16903,403,200
436823787,436821297,436838537,17240,404,200
436844953,436842680,436858731,16051,405,200
436865262,436862773,436879991,17218,406,200
436886422,436884149,436902438,18289,407,200
436908833,436906560,436923583,17023,408,200
436930114,436927625,436945477,17852,409,200
436951892,436949619,436966304,16685,410,200
436972835,436970346,436987565,17219,411,200
436994096,436991607,437007875,16268,412,200
437014408,437011918,437028843,16925,413,200
437035250,437032978,437048398,15420,414,200
437054930,437052440,437069027,16587,415,200
437075397,437073123,437088860,15737,416,200
437095255,437092982,437111588,18606,417,200
437118003,437115731,437132734,17003,418,200
437139117,437136844,437155134,18290,419,200
437161666,437159176,437175425,16249,420,200
437181957,437179467,437198290,18823,421,200
437204822,437202332,437220184,17852,422,200
437226578,437224306,437240675,16369,423,200
437247112,437244839,437261208,16369,424,200
437267739,437265250,437281835,16585,425,200
437288237,437285964,437301066,15102,426,200
437307597,437305108,437322327,17219,427,200
437328858,437326369,437343293,16924,428,200
437349824,437347335,437364237,16902,429,200
437370769,437368279,437384548,16269,430,200
437391079,437388590,437405493,16903,431,200
437412024,437409535,437427090,17555,432,200
437433624,437431133,437447721,16588,433,200
437454119,437451847,437466948,15101,434,200
437473313,437471040,437487726,16686,435,200
437494258,437491768,437508039,16271,436,200
437514570,437512081,437529300,17219,437,200
437535832,437533342,437552166,18824,438,200
437558698,437556208,437573427,17219,439,200
437579958,437577469,437595343,17874,440,200
437601875,437599385,437616943,17558,441,200
437623475,437620985,437636917,15932,442,200
437643448,437640959,437656932,15973,443,200
437663463,437660974,437677559,16585,444,200
437684090,437681601,437695970,14369,445,200
437702503,437700012,437717253,17241,446,200
437723785,437721295,437738852,17557,447,200
437745384,437742894,437759164,16270,448,200
437765695,437763206,437779496,16290,449,200
437786027,437783538,437799174,15636,450,200
437805705,437803215,437821068,17853,451,200
437827600,437825110,437841042,15932,452,200
437847422,437845149,437861519,16370,453,200
437868052,437865561,437880227,14666,454,200
437886758,437884268,437903092,18824,455,200
437909624,437907134,437924669,17535,456,200
437931108,437928836,437947124,18288,457,200
437953499,437951226,437966625,15399,458,200
437973059,437970785,437987175,16390,459,200
437993707,437991217,438007149,15932,460,200
438013681,438011191,438027143,15952,461,200
438033674,438031185,438046483,15298,462,200
438053015,438050525,438066775,16250,463,200
438073218,438070946,438088917,17971,464,200
438095450,438092960,438108912,15952,465,200
438115271,438112999,438131287,18288,466,200
438137653,438135380,438153352,17972,467,200
438159729,438157456,438173211,15755,468,200
438179743,438177253,438193840,16587,469,200
438200373,438197883,438212887,15004,470,200
438219317,438217044,438234047,17003,471,200
438240578,438238089,438254020,15931,472,200
438260552,438258062,438273677,15615,473,200
438280208,438277719,438294622,16903,474,200
438301153,438298664,438313962,15298,475,200
438320494,438318004,438336194,18190,476,200
438342726,438340236,438357476,17240,477,200
438364008,438361518,438376839,15321,478,200
438383199,438380926,438396642,15716,479,200
438403014,438400741,438415528,14787,480,200
438422059,438419569,438435185,15616,481,200
438441619,438439346,438455399,16053,482,200
438461832,438459559,438477849,18290,483,200
438484379,438481891,438498792,16901,484,200
438505325,438502834,438519419,16585,485,200
438525846,438523573,438539606,16033,486,200
438546137,438543648,438560867,17219,487,200
438567399,438564909,438581813,16904,488,200
438588245,438585972,438600442,14470,489,200
438606973,438604483,438622018,17535,490,200
438628550,438626060,438643302,17242,491,200
438649833,438647344,438663276,15932,492,200
438669807,438667317,438685190,17873,493,200
438691722,438689232,438705185,15953,494,200
438711717,438709227,438724863,15636,495,200
438731395,438728904,438745807,16903,496,200
438752248,438749976,438766345,16369,497,200
438772877,438770387,438787945,17558,498,200
438794477,438791987,438807307,15320,499,200
438813839,438811349,438828569,17220,500,200
438835100,438832611,438849831,17220,501,200
438856363,438853873,438872697,18824,502,200
438879123,438876850,438893220,16370,503,200
438899753,438897263,438914482,17219,504,200
438921014,438918525,438934478,15953,505,200
438940898,438938626,438954994,16368,506,200
438961526,438959036,438976256,17220,507,200
438982788,438980298,438997202,16904,508,200
439003625,439001352,439015505,14153,509,200
439021872,439019598,439034387,14789,510,200
439040787,439038514,439054883,16369,511,200
439061416,439058926,439074879,15953,512,200
439081412,439078921,439096142,17221,513,200
439102555,439100281,439116314,16033,514,200
439122845,439120356,439136308,15952,515,200
439142841,439140350,439158203,17853,516,200
439164635,439162362,439177148,14786,517,200
439183680,439181190,439200012,18822,518,200
439206543,439204054,439219055,15001,519,200
439225589,439223097,439239686,16589,520,200
439246217,439243728,439259996,16268,521,200
439266527,439264038,439279673,15635,522,200
439286203,439283715,439299646,15931,523,200
439306176,439303687,439321559,17872,524,200
439328091,439325601,439343138,17537,525,200
439349579,439347307,439361775,14468,526,200
439368306,439365816,439381136,15320,527,200
439387546,439385273,439402908,17635,528,200
439409315,439407042,439422461,15419,529,200
439428881,439426607,439442659,16052,530,200
439449022,439446749,439463455,16706,531,200
439469987,439467497,439482480,14983,532,200
439489011,439486522,439503424,16902,533,200
439509867,439507594,439524617,17023,534,200
439531149,439528660,439545266,16606,535,200
439551643,439549370,439565105,15735,536,200
439571636,439569146,439586704,17558,537,200
439593236,439590746,439608283,17537,538,200
439614715,439612441,439631049,18608,539,200
439637469,439635196,439651565,16369,540,200
439658098,439655608,439670273,14665,541,200
439676805,439674315,439691555,17240,542,200
439698088,439695597,439711867,16270,543,200
439718398,439715909,439732832,16923,544,200
439739365,439736874,439753144,16270,545,200
439759677,439757187,439771853,14666,546,200
439778267,439775994,439792384,16390,547,200
439798825,439796552,439814525,17973,548,200
439821057,439818567,439835153,16586,549,200
439841573,439839301,439855057,15756,550,200
439861588,439859099,439875685,16586,551,200
439882217,439879728,439897263,17535,552,200
439903639,439901366,439915837,14471,553,200
439922244,439919970,439934122,14152,554,200
439940653,439938164,439954138,15974,555,200
439960556,439958284,439974040,15756,556,200
439980571,439978082,439994985,16903,557,200
440001517,439999027,440016584,17557,558,200
440023116,440020627,440036263,15636,559,200
440042662,440040389,440056124,15735,560,200
440062657,440060166,440076417,16251,561,200
440082949,440080459,440098650,18191,562,200
440105182,440102692,440119911,17219,563,200
440126443,440123953,440139251,15298,564,200
440145782,440143292,440159224,15932,565,200
440165755,440163266,440179239,15973,566,200
440185771,440183281,440198917,15636,567,200
440205449,440202959,440218912,15953,568,200
440225444,440222954,440241143,18189,569,200
440247548,440245274,440260694,15420,570,200
440267227,440264736,440280373,15637,571,200
440286905,440284415,440303239,18824,572,200
440309685,440307412,440323781,16369,573,200
440330312,440327823,440345380,17557,574,200
440351759,440349486,440363936,14450,575,200
440370363,440368090,440386380,18290,576,200
440392913,440390423,440407346,16923,577,200
440413878,440411388,440426054,14666,578,200
440432585,440430095,440446049,15954,579,200
440452478,440450206,440465309,15103,580,200
440471839,440469350,440484036,14686,581,200
440490567,440488077,440504980,16903,582,200
440511512,440509022,440525946,16924,583,200
440532478,440529988,440546575,16587,584,200
440553108,440550617,440566232,15615,585,200
440572611,440570337,440585440,15103,586,200
440591972,440589482,440604802,15320,587,200
440611336,440608844,440626066,17222,588,200
440632443,440630170,440646560,16390,589,200
440653091,440650602,440665267,14665,590,200
440671799,440669309,440684925,15616,591,200
440691456,440688966,440705553,16587,592,200
440712085,440709595,440724894,15299,593,200
440731337,440729064,440744483,15419,594,200
440751014,440748524,440764139,15615,595,200
440770669,440768180,440783161,14981,596,200
440789692,440787202,440803789,16587,597,200
440810186,440807914,440824935,17021,598,200
440831468,440828978,440845879,16901,599,200
440852251,440849978,440864131,14153,600,200
440870662,440868172,440884105,15933,601,200
440890637,440888146,440904101,15955,602,200
440910633,440908143,440926334,18191,603,200
440932865,440930376,440945695,15319,604,200
440952089,440949816,440967789,17973,605,200
440974195,440971923,440988608,16685,606,200
440995140,440992650,441009258,16608,607,200
441015791,441013300,441028939,15639,608,200
441035470,441032981,441048912,15931,609,200
441055347,441053073,441070711,17638,610,200
441077243,441074753,441089757,15004,611,200
441096187,441093914,441110600,16686,612,200
441117133,441114642,441131884,17242,613,200
441138299,441136026,441153029,17003,614,200
441159561,441157071,441173003,15932,615,200
441179417,441177145,441191615,14470,616,200
441198035,441195761,441210866,15105,617,200
441217397,441214908,441230523,15615,618,200
441237054,441234565,441251783,17218,619,200
441258315,441255825,441273699,17874,620,200
441280076,441277803,441295775,17972,621,200
441302306,441299817,441317668,17851,622,200
441324084,441321811,441339447,17636,623,200
441345978,441343489,441361995,18506,624,200
441368527,441366038,441382308,16270,625,200
441388840,441386350,441402935,16585,626,200
441409304,441407030,441425320,18290,627,200
441431852,441429362,441445947,16585,628,200
441452479,441449989,441465943,15954,629,200
441472305,441470032,441487690,17658,630,200
441494066,441491792,441508479,16687,631,200
441515010,441512521,441528473,15952,632,200
441534890,441532617,441548669,16052,633,200
441555201,441552712,441569614,16902,634,200
441576146,441573656,441591824,18168,635,200
441598356,441595866,441613739,17873,636,200
441620271,441617781,441636604,18823,637,200
441643136,441640646,441656577,15931,638,200
441663107,441660618,441678174,17556,639,200
441684606,441682334,441699019,16685,640,200
441705381,441703108,441721715,18607,641,200
441728247,441725757,441741732,15975,642,200
441748262,441745773,441763308,17535,643,200
441769839,441767350,441784273,16923,644,200
441790805,441788315,441803951,15636,645,200
441810482,441807992,441824261,16269,646,200
441830629,441828356,441843121,14765,647,200
441849651,441847162,441862797,15635,648,200
441869240,441866967,441882703,15736,649,200
441889148,441886875,441902274,15399,650,200
441908806,441906316,441923219,16903,651,200
441929751,441927261,441941927,14666,652,200
441948459,441945968,441961288,15320,653,200
441967819,441965330,441981576,16246,654,200
441987995,441985722,442002092,16370,655,200
442008470,442006197,442024486,18289,656,200
442031018,442028528,442044461,15933,657,200
442050993,442048503,442065723,17220,658,200
442072256,442069765,442086669,16904,659,200
442093201,442090711,442108247,17536,660,200
442114778,442112289,442128536,16247,661,200
442134951,442132678,442147782,15104,662,200
442154225,442151952,442168954,17002,663,200
442175487,442172997,442188001,15004,664,200
442194533,442192043,442208967,16924,665,200
442215500,442213010,442228330,15320,666,200
442234861,442232372,442250246,17874,667,200
442256607,442254334,442271675,17341,668,200
442278209,442275718,442291357,15639,669,200
442297888,442295399,442312617,17218,670,200
442319150,442316660,442332908,16248,671,200
442339290,442337017,442353387,16370,672,200
442359918,442357429,442372411,14982,673,200
442378944,442376453,442392070,15617,674,200
442398600,442396111,442414618,18507,675,200
442421150,442418660,442436218,17558,676,200
442442749,442440260,442457479,17219,677,200
442464011,442461521,442477136,15615,678,200
442483667,442481177,442498079,16902,679,200
442504611,442502121,442517124,15003,680,200
442523654,442521165,442538700,17535,681,200
442545233,442542743,442559329,16586,682,200
442565860,442563371,442579006,15635,683,200
442585411,442583138,442597903,14765,684,200
442604270,442601997,442619633,17636,685,200
442626164,442623675,442639922,16247,686,200
442646282,442644009,442658796,14787,687,200
442665327,442662838,442680373,17535,688,200
442686905,442684415,442701318,16903,689,200
442707752,442705480,442723451,17971,690,200
442729982,442727493,442742496,15003,691,200
442749027,442746538,442762491,15953,692,200
442769023,442766533,442782802,16269,693,200
442789334,442786844,442803746,16902,694,200
442810161,442807889,442823962,16073,695,200
442830494,442828004,442844612,16608,696,200
442851145,442848654,442863320,14666,697,200
442869852,442867362,442882682,15320,698,200
442889213,442886723,442902992,16269,699,200
442909524,442907034,442924254,17220,700,200
442930627,442928354,442943436,15082,701,200
442949841,442947569,442962987,15418,702,200
442969517,442967028,442983276,16248,703,200
442989808,442987318,443003568,16250,704,200
443009941,443007668,443025641,17973,705,200
443032054,443029781,443045180,15399,706,200
443051711,443049221,443067074,17853,707,200
443073606,443071116,443087703,16587,708,200
443094234,443091745,443108351,16606,709,200
443114797,443112524,443128239,15715,710,200
443134612,443132340,443148074,15734,711,200
443154466,443152193,443167275,15082,712,200
443173806,443171316,443187608,16292,713,200
443194021,443191748,443209088,17340,714,200
443215620,443213130,443230350,17220,715,200
443236881,443234392,443250978,16586,716,200
443257509,443255020,443269685,14665,717,200
443276126,443273853,443290539,16686,718,200
443297070,443294581,443310828,16247,719,200
443317361,443314870,443331773,16903,720,200
443338304,443335815,443352398,16583,721,200
443358930,443356440,443374630,18190,722,200
443381162,443378672,443396841,18169,723,200
443403373,443400883,443419074,18191,724,200
443425606,443423116,443441305,18189,725,200
443447744,443445471,443461840,16369,726,200
443468371,443465882,443482783,16901,727,200
443489315,443486825,443505015,18190,728,200
443511547,443509057,443524061,15004,729,200
443530592,443528102,443544351,16249,730,200
443550769,443548496,443566153,17657,731,200
443572571,443570298,443587639,17341,732,200
443594061,443591788,443608158,16370,733,200
443614569,443612296,443626766,14470,734,200
443633298,443630807,443648366,17559,735,200
443654784,443652510,443670462,17952,736,200
443676995,443674504,443689804,15300,737,200
443696335,443693845,443709798,15953,738,200
443716329,443713839,443730763,16924,739,200
443737295,443734805,443751708,16903,740,200
443758108,443755835,443772203,16368,741,200
443778619,443776346,443793348,17002,742,200
443799880,443797390,443813027,15637,743,200
443819559,443817069,443834627,17558,744,200
443841159,443838669,443855889,17220,745,200
443862301,443860029,443875110,15081,746,200
443881642,443879152,443894768,15616,747,200
443901145,443898873,443916212,17339,748,200
443922745,443920255,443936526,16271,749,200
443943058,443940568,443955551,14983,750,200
443961978,443959705,443976708,17003,751,200
443983241,443980751,443995734,14983,752,200
444002111,443999838,444015258,15420,753,200
444021790,444019300,444034916,15616,754,200
444041328,444039055,444054474,15419,755,200
444061006,444058516,444075736,17220,756,200
444082268,444079778,444094148,14370,757,200
444100680,444098190,444114777,16587,758,200
444121309,444118819,444134772,15953,759,200
444141169,444138897,444157185,18288,760,200
444163627,444161354,444175825,14471,761,200
444182357,444179867,444197404,17537,762,200
444203935,444201446,444218348,16902,763,200
444224881,444222390,444237690,15300,764,200
444244222,444241732,444258636,16904,765,200
444265047,444262774,444281379,18605,766,200
444287912,444285421,444300741,15320,767,200
444307143,444304870,444320945,16075,768,200
444327309,444325036,444342037,17001,769,200
444348570,444346079,444364903,18824,770,200
444371435,444368945,444386165,17220,771,200
444392602,444390330,444405749,15419,772,200
444412175,444409902,444427243,17341,773,200
444433776,444431285,444448823,17538,774,200
444455355,444452865,444468818,15953,775,200
444475350,444472860,444487547,14687,776,200
444493966,444491693,444507430,15737,777,200
444513962,444511472,444526159,14687,778,200
444532592,444530320,444545084,14764,779,200
444551616,444549126,444565397,16271,780,200
444571929,444569439,444586026,16587,781,200
444592395,444590122,444607125,17003,782,200
444613657,444611168,444625833,14665,783,200
444632213,444629939,444646310,16371,784,200
444652842,444650352,444667256,16904,785,200
444673786,444671298,444687587,16289,786,200
444694120,444691630,444709188,17558,787,200
444715719,444713230,444730470,17240,788,200
444736914,444734641,444750039,15398,789,200
444756571,444754081,444771933,17852,790,200
444778466,444775976,444791612,15636,791,200
444798143,444795654,444813211,17557,792,200
444819742,444817253,444836076,18823,793,200
444842447,444840174,444855889,15715,794,200
444862307,444860035,444877352,17317,795,200
444883883,444881394,444896692,15298,796,200
444903223,444900733,444919556,18823,797,200
444926088,444923599,444941134,17535,798,200
444947555,444945283,444961019,15736,799,200
444967551,444965061,444981330,16269,800,200
444987861,444985372,445000671,15299,801,200
445007202,445004712,445020031,15319,802,200
445026562,445024073,445039053,14980,803,200
445045586,445043095,445058712,15617,804,200
445065244,445062754,445078390,15636,805,200
445084789,445082515,445100489,17974,806,200
445107021,445104531,445122721,18190,807,200
445129163,445126889,445144210,17321,808,200
445150651,445148378,445165380,17002,809,200
445171912,445169422,445184721,15299,810,200
445191253,445188763,445206003,17240,811,200
445212536,445210046,445226633,16587,812,200
445233165,445230676,445247894,17218,813,200
445254427,445251937,445268207,16270,814,200
445274739,445272249,445288203,15954,815,200
445294734,445292245,445309147,16902,816,200
445315679,445313189,445329775,16586,817,200
445336307,445333817,445351036,17219,818,200
445357570,445355079,445369746,14667,819,200
445376146,445373873,445390243,16370,820,200
445396665,445394393,445409496,15103,821,200
445416027,445413538,445430776,17238,822,200
445437309,445434819,445452039,17220,823,200
445458482,445456208,445472599,16391,824,200
445479130,445476641,445492278,15637,825,200
445498716,445496443,445513129,16686,826,200
445519660,445517171,445533123,15952,827,200
445539527,445537254,445554911,17657,828,200
445561443,445558953,445575540,16587,829,200
445582072,445579583,445596169,16586,830,200
445602702,445600212,445615849,15637,831,200
445622285,445620012,445634777,14765,832,200
445641180,445638908,445655594,16686,833,200
445661965,445659692,445675428,15736,834,200
445681822,445679549,445697206,17657,835,200
445703582,445701308,445717382,16074,836,200
445723809,445721537,445738223,16686,837,200
445744755,445742265,445757564,15299,838,200
445764095,445761605,445778191,16586,839,200
445784723,445782233,445799452,17219,840,200
445805868,445803594,445819627,16033,841,200
445826002,445823729,445839782,16053,842,200
445846314,445843824,445860410,16586,843,200
445866851,445864578,445880610,16032,844,200
445887142,445884652,445902504,17852,845,200
445909035,445906546,445924102,17556,846,200
445930634,445928144,445944414,16270,847,200
445950946,445948456,445963755,15299,848,200
445970171,445967897,445982981,15084,849,200
445989513,445987023,446002956,15933,850,200
446009370,446007097,446022833,15736,851,200
446029366,446026875,446041859,14984,852,200
446048391,446045901,446063775,17874,853,200
446070308,446067818,446083116,15298,854,200
446089547,446087274,446102060,14786,855,200
446108472,446106199,446123202,17003,856,200
446129733,446127244,446144168,16924,857,200
446150614,446148341,446164415,16074,858,200
446170842,446168569,446184938,16369,859,200
446191470,446188980,446205881,16901,860,200
446212413,446209923,446224905,14982,861,200
446231338,446229066,446243830,14764,862,200
446250361,446247872,446265407,17535,863,200
446271824,446269551,446284949,15398,864,200
446291480,446288991,446306210,17219,865,200
446312744,446310253,446327474,17221,866,200
446333919,446331645,446348965,17320,867,200
446355497,446353007,446367990,14983,868,200
446374414,446372141,446389144,17003,869,200
446395568,446393296,446408060,14764,870,200
446414593,446412102,446430272,18170,871,200
446436805,446434315,446450901,16586,872,200
446457344,446455071,446472075,17004,873,200
446478607,446476117,446493337,17220,874,200
446499870,446497379,446512361,14982,875,200
446518891,446516402,446534275,17873,876,200
446540806,446538317,446554586,16269,877,200
446561118,446558628,446573927,15299,878,200
446580459,446577969,446592972,15003,879,200
446599506,446597014,446613285,16271,880,200
446619817,446617327,446633280,15953,881,200
446639812,446637322,446653907,16585,882,200
446660439,446657949,446672952,15003,883,200
446679483,446676993,446694551,17558,884,200
446701082,446698593,446716465,17872,885,200
446722863,446720590,446736960,16370,886,200
446743491,446741002,446758220,17218,887,200
446764753,446762263,446778849,16586,888,200
446785220,446782947,446800287,17340,889,200
446806819,446804329,446819967,15638,890,200
446826498,446824009,446841248,17239,891,200
446847659,446845386,446862072,16686,892,200
446868605,446866115,446882385,16270,893,200
446888918,446886427,446902065,15638,894,200
446908480,446906207,446923547,17340,895,200
446929977,446927704,446945995,18291,896,200
446952527,446950037,446966307,16270,897,200
446972838,446970349,446987567,17218,898,200
446994001,446991728,447006493,14765,899,200
447013023,447010534,447025831,15297,900,200
447032363,447029873,447045488,15615,901,200
447052019,447049529,447066749,17220,902,200
447073281,447070792,447087377,16585,903,200
447093908,447091419,447107687,16268,904,200
447114218,447111729,447127366,15637,905,200
447133783,447131511,447146929,15418,906,200
447153461,447150971,447167240,16269,907,200
447173647,447171374,447188714,17340,908,200
447195245,447192756,447207760,15004,909,200
447214155,447211881,447226035,14154,910,200
447232567,447230077,447245081,15004,911,200
447251613,447249123,447266027,16904,912,200
447272559,447270070,447286656,16586,913,200
447293031,447290758,447307759,17001,914,200
447314291,447311801,447329357,17556,915,200
447335891,447333400,447348067,14667,916,200
447354437,447352163,447367246,15083,917,200
447373778,447371288,447387241,15953,918,200
447393673,447391401,447406819,15418,919,200
447413351,447410861,447428714,17853,920,200
447435247,447432757,447449659,16902,921,200
447456051,447453779,447470147,16368,922,200
447476678,447474189,447488875,14686,923,200
447495407,447492917,447510136,17219,924,200
447516667,447514178,447530764,16586,925,200
447537296,447534806,447551731,16925,926,200
447558130,447555857,447572565,16708,927,200
447579097,447576607,447593848,17241,928,200
447600275,447598002,447614709,16707,929,200
447621241,447618752,447634684,15932,930,200
447641216,447638726,447654995,16269,931,200
447661528,447659037,447675330,16293,932,200
447681734,447679461,447696483,17022,933,200
447703016,447700526,447718063,17537,934,200
447724596,447722106,447739348,17242,935,200
447745758,447743485,447759222,15737,936,200
447765753,447763264,447778880,15616,937,200
447785413,447782922,447798243,15321,938,200
447804775,447802285,447818238,15953,939,200
447824769,447822280,447837261,14981,940,200
447843793,447841303,447856919,15616,941,200
447863450,447860961,447876575,15614,942,200
447883107,447880617,447897521,16904,943,200
447904054,447901564,447916229,14665,944,200
447922761,447920271,447936858,16587,945,200
447943280,447941006,447956427,15421,946,200
447962959,447960469,447978660,18191,947,200
447985191,447982702,448000576,17874,948,200
448007108,448004618,448020887,16269,949,200
448027294,448025021,448042657,17636,950,200
448049021,448046748,448064383,17635,951,200
448070914,448068425,448085644,17219,952,200
448092176,448089686,448106590,16904,953,200
448113122,448110632,448127218,16586,954,200
448133750,448131260,448147847,16587,955,200
448154282,448152010,448168061,16051,956,200
448174593,448172103,448188394,16291,957,200
448194926,448192436,448210625,18189,958,200
448217156,448214667,448232203,17536,959,200
448238584,448236313,448253968,17655,960,200
448260502,448258011,448273944,15933,961,200
448280353,448278081,448294765,16684,962,200
448301297,448298807,448315731,16924,963,200
448322263,448319773,448335409,15636,964,200
448341802,448339529,448355266,15737,965,200
448361796,448359307,448375576,16269,966,200
448382108,448379618,448394937,15319,967,200
448401468,448398978,448416218,17240,968,200
448422750,448420260,448436531,16271,969,200
448443064,448440573,448456844,16271,970,200
448463376,448460886,448475890,15004,971,200
448482420,448479931,448494912,14981,972,200
448501444,448498954,448516807,17853,973,200
448523339,448520849,448538722,17873,974,200
448545254,448542764,448559667,16903,975,200
448566198,448563709,448581244,17535,976,200
448587775,448585286,448600268,14982,977,200
448606665,448604391,448620762,16371,978,200
448627295,448624805,448641075,16270,979,200
448647479,448645206,448662842,17636,980,200
448669373,448666884,448683470,16586,981,200
448690001,448687512,448703443,15931,982,200
448709974,448707485,448723734,16249,983,200
448730150,448727876,448744563,16687,984,200
448750972,448748699,448764753,16054,985,200
448771284,448768795,448783777,14982,986,200
448790309,448787819,448804742,16923,987,200
448811274,448808784,448824082,15298,988,200
448830612,448828123,448845995,17872,989,200
448852527,448850037,448867911,17874,990,200
448874333,448872061,448887797,15736,991,200
448894329,448891839,448906504,14665,992,200
448913036,448910546,448927786,17240,993,200
448934318,448931828,448949386,17558,994,200
448955829,448953556,448970580,17024,995,200
448977111,448974622,448991841,17219,996,200
448998373,448995883,449011182,15299,997,200
449017713,449015224,449030839,15615,998,200
449037370,449034880,449057333,22453,999,200
449063707,449061434,449077486,16052,1000,200
449084106,449081617,449098520,16903,1001,200
449105141,449102651,449118267,15616,1002,200
449124748,449122475,449138189,15714,1003,200
449144642,449142369,449158401,16032,1004,200
449165021,449162532,449177831,15299,1005,200
449184345,449182071,449197154,15083,1006,200
449203667,449201394,449216477,15083,1007,200
449223098,449220607,449238144,17537,1008,200
449244646,449242373,449258424,16051,1009,200
449264948,449262675,449279697,17022,1010,200
449286156,449283883,449301202,17319,1011,200
449307728,449305455,449323112,17657,1012,200
449329733,449327243,449343829,16586,1013,200
449350450,449347960,449363597,15637,1014,200
449370101,449367829,449383248,15419,1015,200
449389868,449387378,449404281,16903,1016,200
449410865,449408591,449424350,15759,1017,200
449430970,449428480,449444412,15932,1018,200
449450984,449448711,449465713,17002,1019,200
449472167,449469895,449485948,16053,1020,200
449492456,449490183,449508790,18607,1021,200
449515411,449512921,449529212,16291,1022,200
449535774,449533501,449551157,17656,1023,200
449557727,449555454,449572794,17340,1024,200
449579415,449576925,449594483,17558,1025,200
449601046,449598774,449614509,15735,1026,200
449620993,449618720,449633191,14471,1027,200
449639810,449637321,449652324,15003,1028,200
449658946,449656454,449673359,16905,1029,200
449679809,449677536,449694223,16687,1030,200
449700844,449698354,449716207,17853,1031,200
449722735,449720462,449735881,15419,1032,200
449742384,449740111,449757452,17341,1033,200
449764073,449761583,449778486,16903,1034,200
449785106,449782617,449798549,15932,1035,200
449805169,449802679,449818970,16291,1036,200
449825591,449823101,449840004,16903,1037,200
449846532,449844259,449860629,16370,1038,200
449867250,449864760,449881031,16271,1039,200
449887484,449885211,449901581,16370,1040,200
449908202,449905712,449923585,17873,1041,200
449930206,449927716,449944620,16904,1042,200
449951121,449948848,449966801,17953,1043,200
449973422,449970932,449988152,17220,1044,200
449994666,449992393,450009713,17320,1045,200
450016334,450013844,450029818,15974,1046,200
450036267,450033994,450049413,15419,1047,200
450055865,450053592,450069011,15419,1048,200
450075540,450073267,450090586,17319,1049,200
450097207,450094717,450111620,16903,1050,200
450118130,450115857,450132565,16708,1051,200
450139021,450136748,450155039,18291,1052,200
450161659,450159170,450175121,15951,1053,200
450181628,450179356,450195408,16052,1054,200
450201898,450199625,450218232,18607,1055,200
450224697,450222424,450238793,16369,1056,200
450245317,450243045,450260680,17635,1057,200
450267184,450264912,450280667,15755,1058,200
450287287,450284797,450300750,15953,1059,200
450307370,450304881,450320201,15320,1060,200
450326707,450324434,450339855,15421,1061,200
450346475,450343986,450361205,17219,1062,200
450367825,450365336,450380634,15298,1063,200
450387255,450384765,450402302,17537,1064,200
450408872,450406599,450423602,17003,1065,200
450430223,450427733,450444636,16903,1066,200
450451148,450448875,450466215,17340,1067,200
450472836,450470346,450486932,16586,1068,200
450493387,450491114,450506850,15736,1069,200
450513317,450511045,450527077,16032,1070,200
450533596,450531323,450547059,15736,1071,200
450553515,450551243,450567948,16705,1072,200
450574569,450572079,450590267,18188,1073,200
450596888,450594398,450612904,18506,1074,200
450619525,450617035,450632986,15951,1075,200
450639440,450637168,450651953,14785,1076,200
450658572,450656083,450671380,15297,1077,200
450677859,450675586,450689740,14154,1078,200
450696359,450693870,450710138,16268,1079,200
450716758,450714269,450730539,16270,1080,200
450737160,450734670,450750622,15952,1081,200
450757131,450754858,450770930,16072,1082,200
450777436,450775163,450791849,16686,1083,200
450798469,450795980,450812882,16902,1084,200
450819502,450817013,450834865,17852,1085,200
450841330,450839058,450856059,17001,1086,200
450862523,450860250,450877907,17657,1087,200
450884395,450882121,450899759,17638,1088,200
450906380,450903890,450920794,16904,1089,200
450927243,450924970,450941339,16369,1090,200
450947834,450945560,450960664,15104,1091,200
450967118,450964845,450979315,14470,1092,200
450985934,450983445,451000347,16902,1093,200
451006856,451004582,451020952,16370,1094,200
451027468,451025196,451039960,14764,1095,200
451046580,451044090,451060993,16903,1096,200
451067571,451065299,451081034,15735,1097,200
451087520,451085247,451101321,16074,1098,200
451107941,451105451,451122037,16586,1099,200
451128561,451126288,451141687,15399,1100,200
451148191,451145918,451162287,16369,1101,200
451168768,451166496,451182231,15735,1102,200
451188850,451186361,451201976,15615,1103,200
451208503,451206231,451221946,15715,1104,200
451228566,451226076,451244267,18191,1105,200
451250888,451248398,451264985,16587,1106,200
451271551,451269279,451285332,16053,1107,200
451291952,451289463,451305098,15635,1108,200
451311669,451309396,451326715,17319,1109,200
451333248,451330974,451348611,17637,1110,200
451355231,451352742,451368357,15615,1111,200
451374977,451372487,451390024,17537,1112,200
451396644,451394155,451412660,18505,1113,200
451419281,451416791,451432745,15954,1114,200
451439265,451436992,451451779,14787,1115,200
451458291,451456018,451470172,14154,1116,200
451476792,451474302,451489285,14983,1117,200
451495904,451493415,451508713,15298,1118,200
451515333,451512843,451529113,16270,1119,200
451535733,451533244,451551433,18189,1120,200
451558014,451555742,451571478,15736,1121,200
451577928,451575655,451591685,16030,1122,200
451598090,451595816,451616464,20648,1123,200
451622993,451620720,451635802,15082,1124,200
451642422,451639932,451655568,15636,1125,200
451662187,451659698,451675651,15953,1126,200
451682240,451679967,451696653,16686,1127,200
451703273,451700784,451718339,17555,1128,200
451724959,451722470,451739056,16586,1129,200
451745677,451743187,451761378,18191,1130,200
451767999,451765509,451782095,16586,1131,200
451788677,451786404,451801825,15421,1132,200
451808324,451806051,451823392,17341,1133,200
451829962,451827689,451843763,16074,1134,200
451850383,451847894,451864500,16606,1135,200
451871122,451868631,451883635,15004,1136,200
451890256,451887765,451902135,14370,1137,200
451908634,451906362,451923364,17002,1138,200
451929944,451927671,451943091,15420,1139,200
451949673,451947400,451964719,17319,1140,200
451971291,451969018,451985070,16052,1141,200
451991691,451989201,452005788,16587,1142,200
452012409,452009919,452025238,15319,1143,200
452031858,452029369,452046292,16923,1144,200
452052912,452050423,452067324,16901,1145,200
452073944,452071455,452088674,17219,1146,200
452095256,452092983,452108720,15737,1147,200
452115342,452112851,452128490,15639,1148,200
452135109,452132620,452149227,16607,1149,200
452155696,452153422,452168842,15420,1150,200
452175463,452172973,452189243,16270,1151,200
452195825,452193552,452210575,17023,1152,200
452217105,452214831,452231201,16370,1153,200
452237822,452235332,452250948,15616,1154,200
452257461,452255188,452270606,15418,1155,200
452277176,452274903,452290322,15419,1156,200
452296825,452294552,452311554,17002,1157,200
452318088,452315815,452332185,16370,1158,200
452338805,452336316,452351318,15002,1159,200
452357841,452355567,452370334,14767,1160,200
452376955,452374464,452390713,16249,1161,200
452397235,452394961,452410065,15104,1162,200
452416684,452414195,452429831,15636,1163,200
452436450,452433961,452450862,16901,1164,200
452457371,452455097,452470834,15737,1165,200
452477423,452475149,452490908,15759,1166,200
452497528,452495038,452510992,15954,1167,200
452517498,452515225,452530328,15103,1168,200
452536910,452534637,452551661,17024,1169,200
452558281,452555792,452573349,17557,1170,200
452579867,452577593,452594596,17003,1171,200
452601216,452598727,452615334,16607,1172,200
452621908,452619636,452636954,17318,1173,200
452643455,452641182,452657235,16053,1174,200
452663857,452661366,452676370,15004,1175,200
452682930,452680657,452696710,16053,1176,200
452703331,452700841,452717110,16269,1177,200
452723731,452721241,452739747,18506,1178,200
452746316,452744042,452760117,16075,1179,200
452766606,452764333,452781019,16686,1180,200
452787485,452785212,452802532,17320,1181,200
452809103,452806830,452824487,17657,1182,200
452831054,452828781,452845467,16686,1183,200
452851955,452849683,452865419,15736,1184,200
452871922,452869649,452886017,16368,1185,200
452892638,452890148,452906439,16291,1186,200
452913059,452910570,452926206,15636,1187,200
452932827,452930336,452947873,17537,1188,200
452954361,452952088,452968457,16369,1189,200
452975078,452972588,452988858,16270,1190,200
452995388,452993115,453008851,15736,1191,200
453015471,453012982,453030856,17874,1192,200
453037362,453035089,453051796,16707,1193,200
453058416,453055927,453072513,16586,1194,200
453079020,453076747,453093455,16708,1195,200
453100076,453097586,453114805,17219,1196,200
453121317,453119043,453134778,15735,1197,200
453141397,453138908,453156147,17239,1198,200
453162631,453160358,453177044,16686,1199,200
453183510,453181236,453196320,15084,1200,200
453202898,453200624,453215411,14787,1201,200
453222031,453219541,453236443,16902,1202,200
453242952,453240680,453257680,17000,1203,200
453264301,453261811,453278080,16269,1204,200
453284701,453282211,453299115,16904,1205,200
453305616,453303342,453319396,16054,1206,200
453325855,453323582,453340268,16686,1207,200
453346888,453344399,453362588,18189,1208,200
453369117,453366844,453384818,17974,1209,200
453391438,453388949,453404901,15952,1210,200
453411521,453409031,453425617,16586,1211,200
453432203,453429929,453445984,16055,1212,200
453452604,453450115,453467672,17557,1213,200
453474293,453471803,453488707,16904,1214,200
453495328,453492838,453510394,17556,1215,200
453516895,453514622,453531624,17002,1216,200
453538126,453535854,453552244,16390,1217,200
453558865,453556375,453573595,17220,1218,200
453580216,453577726,453596234,18508,1219,200
453602856,453600365,453616636,16271,1220,200
453623257,453620767,453637354,16587,1221,200
453643974,453641485,453656487,15002,1222,200
453662947,453660674,453676749,16075,1223,200
453683369,453680880,453697782,16902,1224,200
453704403,453701913,453718817,16904,1225,200
453725437,453722948,453740504,17556,1226,200
453747124,453744635,453760588,15953,1227,200
453767209,453764719,453780988,16269,1228,200
453787559,453785286,453803574,18288,1229,200
453810195,453807705,453823341,15636,1230,200
453829961,453827472,453843742,16270,1231,200
453850321,453848048,453865387,17339,1232,200
453872008,453869518,453887076,17558,1233,200
453893696,453891207,453905894,14687,1234,200
453912513,453910024,453926926,16902,1235,200
453933547,453931057,453949247,18190,1236,200
453955867,453953378,453970300,16922,1237,200
453976803,453974530,453989296,14766,1238,200
453995746,453993473,454010476,17003,1239,200
454017096,454014607,454030222,15615,1240,200
454036807,454034534,454051218,16684,1241,200
454057734,454055461,454072781,17320,1242,200
454079279,454077007,454093081,16074,1243,200
454099662,454097389,454113779,16390,1244,200
454120399,454117910,454132596,14686,1245,200
454139049,454136776,454153799,17023,1246,200
454160420,454157930,454174200,16270,1247,200
454180821,454178331,454193651,15320,1248,200
454200155,454197882,454212964,15082,1249,200
454219585,454217095,454235919,18824,1250,200
454242389,454240116,454256508,16392,1251,200
454263078,454260806,454275276,14470,1252,200
454281847,454279574,454294678,15104,1253,200
454301299,454298809,454316029,17220,1254,200
454322498,454320225,454336911,16686,1255,200
454343440,454341166,454357536,16370,1256,200
454364156,454361667,454377916,16249,1257,200
454384537,454382047,454397684,15637,1258,200
454404255,454401981,454418350,16369,1259,200
454424841,454422568,454438599,16031,1260,200
454445068,454442795,454459164,16369,1261,200
454465784,454463295,454477980,14685,1262,200
454484568,454482295,454498347,16052,1263,200
454504807,454502534,454517300,14766,1264,200
454523759,454521486,454538172,16686,1265,200
454544638,454542365,454560972,18607,1266,200
454567593,454565103,454582638,17535,1267,200
454589151,454586878,454604831,17953,1268,200
454611451,454608962,454623943,14981,1269,200
454630564,454628074,454644028,15954,1270,200
454650650,454648159,454663164,15005,1271,200
454669783,454667294,454685167,17873,1272,200
454691749,454689476,454705528,16052,1273,200
454712034,454709760,454726763,17003,1274,200
454733325,454731052,454748710,17658,1275,200
454755331,454752841,454770399,17558,1276,200
454776896,454774623,454790338,15715,1277,200
454796960,454794469,454811372,16903,1278,200
454817993,454815503,454832068,16565,1279,200
454838689,454836199,454852806,16607,1280,200
454859266,454856993,454874651,17658,1281,200
454881272,454878782,454895369,16587,1282,200
454901855,454899582,454917217,17635,1283,200
454923837,454921348,454936983,15635,1284,200
454943603,454941113,454957046,15933,1285,200
454963634,454961361,454976127,14766,1286,200
454982605,454980333,454998283,17950,1287,200
455004764,455002491,455017277,14786,1288,200
455023780,455021506,455038194,16688,1289,200
455044648,455042375,455059694,17319,1290,200
455066315,455063825,455081360,17535,1291,200
455087936,455085663,455099817,14154,1292,200
455106438,455103948,455119585,15637,1293,200
455126119,455123846,455140532,16686,1294,200
455147153,455144663,455159350,14687,1295,200
455165970,455163481,455178484,15003,1296,200
455185104,455182614,455199221,16607,1297,200
455205842,455203352,455219938,16586,1298,200
455226397,455224123,455241444,17321,1299,200
455247961,455245688,455262375,16687,1300,200
455268996,455266506,455282798,16292,1301,200
455289364,455287091,455304432,17341,1302,200
455311052,455308563,455327067,18504,1303,200
455333688,455331198,455346202,15004,1304,200
455352822,455350333,455365019,14686,1305,200
455371639,455369150,455387340,18190,1306,200
455393871,455391597,455408284,16687,1307,200
455414905,455412415,455429318,16903,1308,200
455435939,455433449,455450015,16566,1309,200
455456525,455454253,455469355,15102,1310,200
455475975,455473486,455490705,17219,1311,200
455497284,455495012,455511360,16348,1312,200
455517918,455515646,455532330,16684,1313,200
455538890,455536618,455552038,15420,1314,200
455558530,455556257,455572311,16054,1315,200
455578792,455576520,455593205,16685,1316,200
455599667,455597394,455612792,15398,1317,200
455619413,455616923,455635093,18170,1318,200
455641546,455639273,455655304,16031,1319,200
455661791,455659517,455675572,16055,1320,200
455682136,455679863,455696866,17003,1321,200
455703486,455700997,455716296,15299,1322,200
455722917,455720426,455735112,14686,1323,200
455741731,455739242,455757094,17852,1324,200
455763716,455761225,455778763,17538,1325,200
455785244,455782971,455799341,16370,1326,200
455805870,455803597,455818680,15083,1327,200
455825178,455822905,455841194,18289,1328,200
455847815,455845325,455860625,15300,1329,200
455867128,455864855,455880276,15421,1330,200
455886895,455884406,455901625,17219,1331,200
455908246,455905756,455926923,21167,1332,200
455933546,455931055,455955726,24671,1333,200
455962299,455960025,455976395,16370,1334,200
455983016,455980526,455997111,16585,1335,200
456003672,456001399,456019351,17952,1336,200
456025972,456023482,456040067,16585,1337,200
456046687,456044198,456060783,16585,1338,200
456067232,456064960,456081011,16051,1339,200
456087632,456085142,456101434,16292,1340,200
456108055,456105565,456122785,17220,1341,200
456129240,456126967,456144919,17952,1342,200
456151492,456149219,456165904,16685,1343,200
456172525,456170035,456187887,17852,1344,200
456194369,456192095,456209753,17658,1345,200
456216256,456213982,456230984,17002,1346,200
456237605,456235115,456251386,16271,1347,200
456257972,456255699,456273650,17951,1348,200
456280176,456277904,456294273,16369,1349,200
456300893,456298404,456314673,16269,1350,200
456321295,456318804,456334442,15638,1351,200
456340944,456338671,456356328,17657,1352,200
456362836,456360563,456377881,17318,1353,200
456384503,456382012,456398282,16270,1354,200
456404903,456402413,456420921,18508,1355,200
456427506,456425232,456441603,16371,1356,200
456448225,456445734,456462004,16270,1357,200
456468536,456466263,456482949,16686,1358,200
456489569,456487080,456504298,17218,1359,200
456510799,456508526,456525866,17340,1360,200
456532431,456530158,456546212,16054,1361,200
456552833,456550343,456567245,16902,1362,200
456573865,456571376,456586991,15615,1363,200
456593457,456591184,456606582,15398,1364,200
456613202,456610713,456626666,15953,1365,200
456633286,456630796,456648353,17557,1366,200
456654852,456652579,456669581,17002,1367,200
456676201,456673712,456690298,16586,1368,200
456696795,456694522,456710237,15715,1369,200
456716690,456714417,456731418,17001,1370,200
456738039,456735549,456751503,15954,1371,200
456758123,456755633,456773169,17536,1372,200
456779648,456777375,456795010,17635,1373,200
456801583,456799310,456815363,16053,1374,200
456821868,456819595,456834678,15083,1375,200
456841195,456838923,456854954,16031,1376,200
456861574,456859085,456876303,17218,1377,200
456882883,456880610,456896367,15757,1378,200
456902826,456900553,456918211,17658,1379,200
456924694,456922421,456939424,17003,1380,200
456946046,456943555,456958876,15321,1381,200
456965497,456963007,456978305,15298,1382,200
456984925,456982435,456998705,16270,1383,200
457005326,457002836,457019740,16904,1384,200
457026361,457023871,457041724,17853,1385,200
457048176,457045902,457061619,15717,1386,200
457068240,457065749,457082315,16566,1387,200
457088896,457086623,457102675,16052,1388,200
457109295,457106806,457121470,14664,1389,200
457128090,457125600,457142504,16904,1390,200
457149125,457146635,457164488,17853,1391,200
457171110,457168619,457185839,17220,1392,200
457192414,457190141,457206827,16686,1393,200
457213409,457211137,457228159,17022,1394,200
457234669,457232397,457248132,15735,1395,200
457254752,457252262,457270769,18507,1396,200
457277390,457274900,457289566,14666,1397,200
457296047,457293774,457309171,15397,1398,200
457315680,457313408,457328490,15082,1399,200
457334996,457332723,457349409,16686,1400,200
457355909,457353635,457370005,16370,1401,200
457376625,457374136,457392009,17873,1402,200
457398497,457396225,457413860,17635,1403,200
457420482,457417992,457433945,15953,1404,200
457440399,457438125,457455784,17659,1405,200
457462345,457460072,457476758,16686,1406,200
457483380,457480889,457497138,16249,1407,200
457503599,457501326,457518013,16687,1408,200
457524573,457522299,457539303,17004,1409,200
457545923,457543434,457560674,17240,1410,200
457567295,457564805,457580442,15637,1411,200
457587063,457584572,457601475,16903,1412,200
457608097,457605606,457622194,16588,1413,200
457628814,457626325,457644830,18505,1414,200
457651297,457649024,457664423,15399,1415,200
457670994,457668721,457684120,15399,1416,200
457690640,457688367,457705370,17003,1417,200
457711991,457709501,457725116,15615,1418,200
457731678,457729404,457744825,15421,1419,200
457751446,457748955,457766492,17537,1420,200
457773076,457770803,457788123,17320,1421,200
457794642,457792369,457809393,17024,1422,200
457815842,457813570,457828671,15101,1423,200
457835291,457832801,457849703,16902,1424,200
457856293,457854020,457870390,16370,1425,200
457877009,457874521,457891106,16585,1426,200
457897727,457895237,457913745,18508,1427,200
457920366,457917876,457934126,16250,1428,200
457940747,457938257,457953893,15636,1429,200
457960358,457958085,457974771,16686,1430,200
457981283,457979010,457995359,16349,1431,200
458001980,457999490,458014811,15321,1432,200
458021372,458019099,458036100,17001,1433,200
458042597,458040325,458058615,18290,1434,200
458065124,458062851,458079536,16685,1435,200
458086157,458083667,458100908,17241,1436,200
458107528,458105039,458121624,16585,1437,200
458128244,458125755,458142004,16249,1438,200
458148491,458146218,458161322,15104,1439,200
458167811,458165538,458181907,16369,1440,200
458188413,458186140,458202826,16686,1441,200
458209448,458206958,458222912,15954,1442,200
458229405,458227132,458242869,15737,1443,200
458249490,458247000,458264854,17854,1444,200
458271474,458268985,458284305,15320,1445,200
458290925,458288436,458304049,15613,1446,200
458310669,458308179,458323816,15637,1447,200
458330281,458328009,458343745,15736,1448,200
458350211,458347938,458363359,15421,1449,200
458369882,458367610,458383979,16369,1450,200
458390480,458388207,458404281,16074,1451,200
458410901,458408412,458424998,16586,1452,200
458431619,458429129,458446033,16904,1453,200
458452654,458450164,458468354,18190,1454,200
458474974,458472485,458490338,17853,1455,200
458496959,458494469,458511371,16902,1456,200
458517992,458515502,458534010,18508,1457,200
458540471,458538197,458555835,17638,1458,200
458562300,458560026,458577684,17658,1459,200
458584197,458581925,458598609,16684,1460,200
458605230,458602740,458620275,17535,1461,200
458626897,458624407,458642598,18191,1462,200
458649219,458646729,458662366,15637,1463,200
458668845,458666572,458682941,16369,1464,200
458689454,458687180,458705471,18291,1465,200
458711938,458709665,458727322,17657,1466,200
458733905,458731633,458747981,16348,1467,200
458754603,458752113,458768381,16268,1468,200
458775000,458772511,458790680,18169,1469,200
458797250,458794976,458811980,17004,1470,200
458818513,458816240,458831343,15103,1471,200
458837963,458835473,458854296,18823,1472,200
458860885,458858612,458876248,17636,1473,200
458882751,458880478,458896214,15736,1474,200
458902835,458900344,458916932,16588,1475,200
458923393,458921120,458936835,15715,1476,200
458943455,458940965,458958500,17535,1477,200
458965032,458962759,458979129,16370,1478,200
458985749,458983260,458998896,15636,1479,200
459005455,459003182,459020185,17003,1480,200
459026806,459024316,459039932,15616,1481,200
459046552,459044062,459060332,16270,1482,200
459066953,459064463,459081050,16587,1483,200
459087671,459085181,459101113,15932,1484,200
459107733,459105243,459121217,15974,1485,200
459127836,459125348,459141933,16585,1486,200
459148495,459146221,459162928,16707,1487,200
459169385,459167112,459183482,16370,1488,200
459189942,459187668,459202772,15104,1489,200
459209392,459206902,459223193,16291,1490,200
459229814,459227324,459244227,16903,1491,200
459250847,459248358,459264311,15953,1492,200
459270817,459268544,459284914,16370,1493,200
459291535,459289045,459304682,15637,1494,200
459311191,459308918,459325943,17025,1495,200
459332565,459330074,459345058,14984,1496,200
459351561,459349288,459365046,15758,1497,200
459371560,459369287,459385319,16032,1498,200
459391939,459389450,459406985,17535,1499,200
459413555,459411281,459426048,14767,1500,200
459432528,459430255,459446307,16052,1501,200
459452928,459450438,459466729,16291,1502,200
459473307,459471035,459485820,14785,1503,200
459492270,459489998,459506366,16368,1504,200
459512987,459510497,459526744,16247,1505,200
459533364,459530875,459547460,16585,1506,200
459554080,459551591,459569442,17851,1507,200
459576062,459573573,459589842,16269,1508,200
459596416,459594143,459609541,15398,1509,200
459616069,459613796,459629194,15398,1510,200
459635716,459633443,459651079,17636,1511,200
459657700,459655210,459671480,16270,1512,200
459677930,459675658,459691709,16051,1513,200
459698330,459695840,459713377,17537,1514,200
459719998,459717508,459735699,18191,1515,200
459742287,459740014,459757987,17973,1516,200
459764458,459762185,459778239,16054,1517,200
459784860,459782370,459798639,16269,1518,200
459805164,459802891,459819261,16370,1519,200
459825724,459823451,459842057,18606,1520,200
459848678,459846188,459863090,16902,1521,200
459869710,459867221,459884439,17218,1522,200
459891059,459888570,459905470,16900,1523,200
459912091,459909601,459927159,17558,1524,200
459933780,459931290,459949481,18191,1525,200
459956008,459953735,459970105,16370,1526,200
459976689,459974416,459988570,14154,1527,200
459995038,459992766,460008185,15419,1528,200
460014716,460012445,460029130,16685,1529,200
460035751,460033261,460049214,15953,1530,200
460055833,460053344,460072166,18822,1531,200
460078787,460076297,460091913,15616,1532,200
460098533,460096044,460112627,16583,1533,200
460119218,460116944,460131416,14472,1534,200
460138036,460135547,460150845,15298,1535,200
460157466,460154976,460172534,17558,1536,200
460179037,460176764,460194104,17340,1537,200
460200724,460198235,460213849,15614,1538,200
460220470,460217980,460233933,15953,1539,200
460240554,460238064,460254332,16268,1540,200
460260953,460258463,460275050,16587,1541,200
460281635,460279362,460294466,15104,1542,200
460301025,460298752,460314467,15715,1543,200
460321086,460318597,460336154,17557,1544,200
460342775,460340285,460357822,17537,1545,200
460364349,460362077,460379417,17340,1546,200
460386004,460383731,460399129,15398,1547,200
460405596,460403323,460421929,18606,1548,200
460428446,460426173,460441572,15399,1549,200
460448077,460445805,460463777,17972,1550,200
460470398,460467908,460484179,16271,1551,200
460490799,460488310,460503630,15320,1552,200
460510249,460507760,460525296,17536,1553,200
460531762,460529490,460544592,15102,1554,200
460551052,460548779,460564495,15716,1555,200
460571114,460568625,460587448,18823,1556,200
460593901,460591627,460609602,17975,1557,200
460616066,460613793,460628896,15103,1558,200
460635401,460633128,460648548,15420,1559,200
460655079,460652806,460670126,17320,1560,200
460676747,460674257,460692111,17854,1561,200
460698733,460696243,460714434,18191,1562,200
460721057,460718566,460733888,15322,1563,200
460740466,460738193,460754224,16031,1564,200
460760845,460758356,460773042,14686,1565,200
460779525,460777252,460793306,16054,1566,200
460799927,460797437,460814678,17241,1567,200
460821299,460818809,460835713,16904,1568,200
460842333,460839844,460857400,17556,1569,200
460863921,460861648,460878335,16687,1570,200
460884859,460882587,460899589,17002,1571,200
460906123,460903849,460918615,14766,1572,200
460925234,460922745,460937725,14980,1573,200
460944181,460941908,460958278,16370,1574,200
460964813,460962540,460978889,16349,1575,200
460985509,460983020,460999308,16288,1576,200
461005876,461003603,461021239,17636,1577,200
461027860,461025370,461042590,17220,1578,200
461049211,461046721,461063308,16587,1579,200
461069928,461067439,461085312,17873,1580,200
461091932,461089443,461105374,15931,1581,200
461111993,461109504,461124190,14686,1582,200
461130757,461128484,461145804,17320,1583,200
461152255,461149982,461166034,16052,1584,200
461172498,461170225,461186593,16368,1585,200
461193214,461190724,461206995,16271,1586,200
461213565,461211292,461227345,16053,1587,200
461233807,461231534,461250139,18605,1588,200
461256760,461254270,461270855,16585,1589,200
461277476,461274986,461293494,18508,1590,200
461300115,461297625,461315477,17852,1591,200
461321989,461319717,461334482,14765,1592,200
461341051,461338778,461354830,16052,1593,200
461361451,461358961,461376201,17240,1594,200
461382822,461380332,461396601,16269,1595,200
461403222,461400732,461416665,15933,1596,200
461423225,461420952,461436055,15103,1597,200
461442644,461440371,461458324,17953,1598,200
461464945,461462455,461479041,16586,1599,200
461485616,461483344,461500028,16684,1600,200
461506650,461504160,461520113,15953,1601,200
461526733,461524243,461538910,14667,1602,200
461545530,461543041,461559942,16901,1603,200
461566471,461564197,461584831,20634,1604,200
461591353,461589079,461606083,17004,1605,200
461612706,461610215,461625831,15616,1606,200
461632453,461629962,461647182,17220,1607,200
461653804,461651314,461668217,16903,1608,200
461674737,461672464,461686934,14470,1609,200
461693465,461691192,461709480,18288,1610,200
461716102,461713612,461730537,16925,1611,200
461737045,461734771,461749559,14788,1612,200
461756180,461753690,461769328,15638,1613,200
461775949,461773459,461789707,16248,1614,200
461796328,461793839,461812661,18822,1615,200
461819282,461816793,461833378,16585,1616,200
461839864,461837590,461854932,17342,1617,200
461861553,461859063,461875354,16291,1618,200
461881974,461879485,461896070,16585,1619,200
461902691,461900201,461916787,16586,1620,200
461923367,461921094,461937463,16369,1621,200
461944084,461941594,461959447,17853,1622,200
461966068,461963578,461979532,15954,1623,200
461986153,461983663,461999280,15617,1624,200
462005802,462003530,462017682,14152,1625,200
462024302,462021813,462038082,16269,1626,200
462044607,462042333,462058386,16053,1627,200
462065008,462062518,462077839,15321,1628,200
462084460,462081970,462099844,17874,1629,200
462106464,462103975,462120561,16586,1630,200
462127143,462124870,462142210,17340,1631,200
462148831,462146342,462162590,16248,1632,200
462169211,462166721,462183940,17219,1633,200
462190561,462188072,462205290,17218,1634,200
462211780,462209507,462225222,15715,1635,200
462231794,462229521,462244287,14766,1636,200
462250907,462248418,462264666,16248,1637,200
462271287,462268797,462286334,17537,1638,200
462292956,462290466,462306103,15637,1639,200
462312634,462310361,462327047,16686,1640,200
462333669,462331179,462348399,17220,1641,200
462354904,462352631,462369634,17003,1642,200
462376154,462373882,462389954,16072,1643,200
462396575,462394086,462412276,18190,1644,200
462418862,462416589,462431038,14449,1645,200
462437659,462435169,462452387,17218,1646,200
462459008,462456519,462474075,17556,1647,200
462480696,462478207,462492893,14686,1648,200
462499513,462497024,462514580,17556,1649,200
462521202,462518712,462536565,17853,1650,200
462543187,462540697,462558571,17874,1651,200
462565132,462562860,462579861,17001,1652,200
462586483,462583993,462598974,14981,1653,200
462605435,462603162,462619194,16032,1654,200
462625815,462623326,462639575,16249,1655,200
462646197,462643707,462661265,17558,1656,200
462667839,462665566,462682253,16687,1657,200
462688765,462686492,462703179,16687,1658,200
462709669,462707396,462722815,15419,1659,200
462729286,462727013,462744670,17657,1660,200
462751232,462748959,462764696,15737,1661,200
462771317,462768827,462784148,15321,1662,200
462790674,462788400,462802872,14472,1663,200
462809492,462807003,462824222,17219,1664,200
462830845,462828354,462843021,14667,1665,200
462849555,462847281,462863968,16687,1666,200
462870590,462868100,462883400,15300,1667,200
462890021,462887531,462903485,15954,1668,200
462909952,462907679,462924365,16686,1669,200
462930925,462928653,462944050,15397,1670,200
462950573,462948299,462964035,15736,1671,200
462970655,462968166,462984435,16269,1672,200
462990885,462988613,463004665,16052,1673,200
463011167,463008893,463024293,15400,1674,200
463030757,463028484,463045486,17002,1675,200
463052064,463049791,463066161,16370,1676,200
463072656,463070383,463086437,16054,1677,200
463093059,463090569,463107472,16903,1678,200
463114047,463111774,463127826,16052,1679,200
463134448,463131958,463146329,14371,1680,200
463152950,463150460,463166096,15636,1681,200
463172583,463170310,463187335,17025,1682,200
463193834,463191561,463209216,17655,1683,200
463215837,463213348,463228647,15299,1684,200
463235221,463232948,463250267,17319,1685,200
463256889,463254399,463270331,15932,1686,200
463276951,463274462,463291364,16902,1687,200
463297986,463295496,463310500,15004,1688,200
463316999,463314725,463330462,15737,1689,200
463336965,463334692,463352666,17974,1690,200
463359165,463356893,463372945,16052,1691,200
463379521,463377247,463393005,15758,1692,200
463399579,463397306,463412092,14786,1693,200
463418615,463416342,463430812,14470,1694,200
463437433,463434943,463452817,17874,1695,200
463459387,463457115,463474431,17316,1696,200
463481052,463478563,463495149,16586,1697,200
463501770,463499281,463513946,14665,1698,200
463520567,463518077,463534663,16586,1699,200
463541188,463538915,463554017,15102,1700,200
463560637,463558148,463574079,15931,1701,200
463580611,463578338,463595657,17319,1702,200
463602230,463599958,463617298,17340,1703,200
463623802,463621530,463636611,15081,1704,200
463643231,463640742,463657645,16903,1705,200
463664267,463661777,463677075,15298,1706,200
463683537,463681264,463697295,16031,1707,200
463703864,463701591,463717011,15420,1708,200
463723471,463721197,463737884,16687,1709,200
463744505,463742016,463757335,15319,1710,200
463763956,463761466,463777737,16271,1711,200
463784359,463781869,463798139,16270,1712,200
463804761,463802271,463817274,15003,1713,200
463823895,463821405,463838624,17219,1714,200
463845246,463842756,463858710,15954,1715,200
463865234,463862961,463879012,16051,1716,200
463885634,463883144,463901651,18507,1717,200
463908273,463905783,463923320,17537,1718,200
463929841,463927568,463943303,15735,1719,200
463949886,463947613,463962695,15082,1720,200
463969317,463966826,463984047,17221,1721,200
463990502,463988229,464005887,17658,1722,200
464012377,464010105,464028077,17972,1723,200
464034699,464032208,464049112,16904,1724,200
464055732,464053243,464068245,15002,1725,200
464074867,464072376,464087358,14982,1726,200
464093822,464091549,464109523,17974,1727,200
464116143,464113654,464131189,17535,1728,200
464137811,464135321,464153828,18507,1729,200
464160449,464157960,464173257,15297,1730,200
464179878,464177388,464194608,17220,1731,200
464201178,464198905,464216561,17656,1732,200
464223183,464220693,464236626,15933,1733,200
464243149,464240876,464257562,16686,1734,200
464264092,464261819,464276923,15104,1735,200
464283446,464281173,464298175,17002,1736,200
464304624,464302351,464317771,15420,1737,200
464324392,464321902,464336904,15002,1738,200
464343409,464341137,464357506,16369,1739,200
464363988,464361715,464376501,14786,1740,200
464383121,464380632,464397871,17239,1741,200
464404456,464402183,464418870,16687,1742,200
464425392,464423119,464439171,16052,1743,200
464445792,464443302,464458918,15616,1744,200
464465454,464463180,464477946,14766,1745,200
464484476,464482203,464500176,17973,1746,200
464506766,464504493,464520525,16032,1747,200
464527147,464524657,464540611,15954,1748,200
464547232,464544742,464559725,14983,1749,200
464566344,464563856,464581074,17218,1750,200
464587696,464585206,464601476,16270,1751,200
464608098,464605608,464621877,16269,1752,200
464628402,464626129,464642815,16686,1753,200
464649437,464646947,464663533,16586,1754,200
464670155,464667665,464684885,17220,1755,200
464691507,464689017,464706870,17853,1756,200
464713492,464711002,464728222,17220,1757,200
464734709,464732437,464749755,17318,1758,200
464756377,464753887,464770495,16608,1759,200
464777117,464774627,464788997,14370,1760,200
464795617,464793128,464809060,15932,1761,200
464815525,464813253,464829939,16686,1762,200
464836449,464834177,464851832,17655,1763,200
464858454,464855964,464872572,16608,1764,200
464879193,464876704,464893606,16902,1765,200
464900071,464897798,464913556,15758,1766,200
464920082,464917809,464934831,17022,1767,200
464941453,464938963,464956499,17536,1768,200
464963120,464960630,464976584,15954,1769,200
464983173,464980900,464996952,16052,1770,200
465003512,465001239,465017609,16370,1771,200
465024062,465021790,465040078,18288,1772,200
465046700,465044210,465060796,16586,1773,200
465067385,465065112,465080512,15400,1774,200
465087133,465084643,465102496,17853,1775,200
465109117,465106627,465123214,16587,1776,200
465129781,465127508,465145481,17973,1777,200
465151988,465149715,465164501,14786,1778,200
465171012,465168739,465185424,16685,1779,200
465192002,465189728,465205150,15422,1780,200
465211641,465209367,465227340,17973,1781,200
465233961,465231472,465249662,18190,1782,200
465256283,465253794,465269409,15615,1783,200
465275909,465273636,465291292,17656,1784,200
465297913,465295424,465311039,15615,1785,200
465317556,465315283,465332284,17001,1786,200
465338774,465336501,465354474,17973,1787,200
465361095,465358605,465375508,16903,1788,200
465382130,465379640,465395593,15953,1789,200
465402051,465399778,465416780,17002,1790,200
465423284,465421011,465438014,17003,1791,200
465444504,465442231,465458599,16368,1792,200
465465064,465462791,465478866,16075,1793,200
465485332,465483059,465497530,14471,1794,200
465504104,465501831,465518200,16369,1795,200
465524768,465522495,465540786,18291,1796,200
465547288,465545015,465559779,14764,1797,200
465566399,465563910,465579546,15636,1798,200
465586016,465583743,465600745,17002,1799,200
465607247,465604974,465622314,17340,1800,200
465628803,465626530,465641929,15399,1801,200
465648549,465646060,465662329,16269,1802,200
465668952,465666461,465682394,15933,1803,200
465689014,465686525,465704399,17874,1804,200
465711021,465708531,465725434,16903,1805,200
465732055,465729566,465747438,17872,1806,200
465754059,465751570,465767522,15952,1807,200
465774142,465771653,465788893,17240,1808,200
465795421,465793149,465807934,14785,1809,200
465814555,465812065,465828968,16903,1810,200
465835589,465833100,465849685,16585,1811,200
465856265,465853991,465869729,15738,1812,200
465876197,465873924,465889661,15737,1813,200
465896282,465893792,465909428,15636,1814,200
465915932,465913659,465928447,14788,1815,200
465935068,465932578,465948553,15975,1816,200
465955173,465952684,465968615,15931,1817,200
465975133,465972860,465988596,15736,1818,200
465995099,465992826,466010798,17972,1819,200
466017327,466015055,466031740,16685,1820,200
466038317,466036045,466050198,14153,1821,200
466056819,466054329,466068699,14370,1822,200
466075284,466073011,466088115,15104,1823,200
466094736,466092246,466109466,17220,1824,200
466116088,466113598,466132106,18508,1825,200
466138729,466136238,466152824,16586,1826,200
466159393,466157120,466175409,18289,1827,200
466182030,466179541,466196443,16902,1828,200
466203065,466200575,466218766,18191,1829,200
466225388,466222898,466237901,15003,1830,200
466244522,466242032,466258616,16584,1831,200
466265148,466262875,466279877,17002,1832,200
466286498,466284009,466300616,16607,1833,200
466307117,466304845,466319630,14785,1834,200
466326216,466323944,466338708,14764,1835,200
466345240,466342967,466359990,17023,1836,200
466366508,466364235,466381239,17004,1837,200
466387860,466385371,466403539,18168,1838,200
466410069,466407796,466424481,16685,1839,200
466431104,466428613,466445518,16905,1840,200
466452140,466449650,466464633,14983,1841,200
466471197,466468924,466484955,16031,1842,200
466491454,466489182,466507155,17973,1843,200
466513725,466511452,466527188,15736,1844,200
466533809,466531319,466547927,16608,1845,200
466554549,466552059,466569615,17556,1846,200
466576237,466573747,466588118,14371,1847,200
466594620,466592347,466609982,17635,1848,200
466616604,466614114,466630046,15932,1849,200
466636514,466634241,466650611,16370,1850,200
466657232,466654743,466671012,16269,1851,200
466677532,466675259,466690679,15420,1852,200
466697165,466694892,466710945,16053,1853,200
466717443,466715170,466731540,16370,1854,200
466738022,466735750,466750535,14785,1855,200
466757156,466754666,466769986,15320,1856,200
466776452,466774179,466791181,17002,1857,200
466797802,466795313,466812214,16901,1858,200
466818836,466816346,466831984,15638,1859,200
466838605,466836115,466852089,15974,1860,200
466858585,466856312,466873969,17657,1861,200
466880436,466878162,466894236,16074,1862,200
466900858,466898368,466916242,17874,1863,200
466922864,466920374,466935991,15617,1864,200
466942612,466940123,466955422,15299,1865,200
466962007,466959734,466975153,15419,1866,200
466981656,466979382,466997356,17974,1867,200
467003846,467001574,467018259,16685,1868,200
467024881,467022391,467038323,15932,1869,200
467044822,467042549,467059234,16685,1870,200
467065857,467063366,467080608,17242,1871,200
467087069,467084796,467102433,17637,1872,200
467108946,467106673,467123064,16391,1873,200
467129595,467127321,467143395,16074,1874,200
467149977,467147704,467164706,17002,1875,200
467171328,467168838,467183209,14371,1876,200
467189829,467187340,467204243,16903,1877,200
467210804,467208531,467226188,17657,1878,200
467232750,467230477,467246213,15736,1879,200
467252786,467250513,467267832,17319,1880,200
467274362,467272088,467288164,16076,1881,200
467294786,467292295,467308546,16251,1882,200
467315014,467312742,467329427,16685,1883,200
467336049,467333558,467350779,17221,1884,200
467357400,467354911,467371496,16585,1885,200
467378118,467375628,467393818,18190,1886,200
467400440,467397950,467415506,17556,1887,200
467421957,467419683,467435420,15737,1888,200
467441951,467439678,467456702,17024,1889,200
467463232,467460960,467478933,17973,1890,200
467485554,467483065,467500620,17555,1891,200
467507242,467504752,467521655,16903,1892,200
467528148,467525877,467540028,14151,1893,200
467546482,467544208,467562162,17954,1894,200
467568784,467566294,467584485,18191,1895,200
467591106,467588617,467602986,14369,1896,200
467609606,467607117,467624968,17851,1897,200
467631590,467629100,467645032,15932,1898,200
467651530,467649256,467665627,16371,1899,200
467672211,467669937,467688227,18290,1900,200
467694799,467692526,467708896,16370,1901,200
467715349,467713076,467729446,16370,1902,200
467736067,467733578,467750797,17219,1903,200
467757307,467755035,467769798,14763,1904,200
467776418,467773929,467790199,16270,1905,200
467796821,467794331,467809313,14982,1906,200
467815898,467813625,467829361,15736,1907,200
467835981,467833492,467851344,17852,1908,200
467857848,467855576,467873232,17656,1909,200
467879854,467877364,467894584,17220,1910,200
467901206,467898716,467915958,17242,1911,200
467922536,467920263,467937265,17002,1912,200
467943761,467941488,467959124,17636,1913,200
467965745,467963256,467979188,15932,1914,200
467985722,467983448,468000136,16688,1915,200
468006602,468004330,468019432,15102,1916,200
468026052,468023563,468040466,16903,1917,200
468047087,468044598,468060844,16246,1918,200
468067466,468064976,468080928,15952,1919,200
468087433,468085158,468100876,15718,1920,200
468107358,468105085,468122108,17023,1921,200
468128730,468126240,468141243,15003,1922,200
468147745,468145472,468161524,16052,1923,200
468168057,468165784,468180887,15103,1924,200
468187395,468185121,468202778,17657,1925,200
468209284,468207011,468222748,15737,1926,200
468229247,468226972,468243344,16372,1927,200
468249966,468247476,468262776,15300,1928,200
468269340,468267068,468284091,17023,1929,200
468290713,468288223,468304513,16290,1930,200
468311135,468308645,468324261,15616,1931,200
468330793,468328521,468347126,18605,1932,200
468353748,468351258,468367843,16585,1933,200
468374333,468372060,468387481,15421,1934,200
468394101,468391612,468409146,17534,1935,200
468415728,468413455,468427926,14471,1936,200
468434547,468432057,468447062,15005,1937,200
468453682,468451193,468467757,16564,1938,200
468474379,468471889,468487842,15953,1939,200
468494410,468492136,468510109,17973,1940,200
468516730,468514241,468529223,14982,1941,200
468535793,468533520,468549256,15736,1942,200
468555822,468553548,468567999,14451,1943,200
468574620,468572130,468590954,18824,1944,200
468597442,468595169,468611854,16685,1945,200
468618310,468616037,468632407,16370,1946,200
468638892,468636619,468651700,15081,1947,200
468658212,468655939,468671358,15419,1948,200
468677863,468675590,468693542,17952,1949,200
468700164,468697674,468714578,16904,1950,200
468721199,468718710,468735613,16903,1951,200
468742234,468739745,468754726,14981,1952,200
468761303,468759030,468775717,16687,1953,200
468782338,468779849,468797700,17851,1954,200
468804322,468801832,468818735,16903,1955,200
468825356,468822867,468840086,17219,1956,200
468846590,468844318,468859737,15419,1957,200
468866270,468863997,468880069,16072,1958,200
468886691,468884201,468899521,15320,1959,200
468906083,468903810,468918892,15082,1960,200
468925397,468923125,468938522,15397,1961,200
468945022,468942749,468959117,16368,1962,200
468965604,468963332,468978118,14786,1963,200
468984738,468982249,468999173,16924,1964,200
469005795,469003305,469020524,17219,1965,200
469027108,469024835,469041520,16685,1966,200
469048142,469045652,469063506,17854,1967,200
469069975,469067702,469084388,16686,1968,200
469090856,469088583,469102737,14154,1969,200
469109358,469106868,469121871,15003,1970,200
469128492,469126002,469141955,15953,1971,200
469148411,469146138,469162824,16686,1972,200
469169445,469166956,469182909,15953,1973,200
469189421,469187148,469203835,16687,1974,200
469210457,469207967,469224870,16903,1975,200
469231361,469229088,469245458,16370,1976,200
469252044,469249771,469265824,16053,1977,200
469272446,469269956,469287809,17853,1978,200
469294307,469292034,469307771,15737,1979,200
469314392,469311902,469328488,16586,1980,200
469335110,469332620,469350811,18191,1981,200
469357399,469355126,469373733,18607,1982,200
469380354,469377865,469394767,16902,1983,200
469401297,469399023,469414759,15736,1984,200
469421329,469419056,469433506,14450,1985,200
469440127,469437637,469454541,16904,1986,200
469461107,469458834,469473600,14766,1987,200
469480187,469477914,469493966,16052,1988,200
469500587,469498098,469514050,15952,1989,200
469520670,469518181,469534451,16270,1990,200
469541023,469538750,469554804,16054,1991,200
469561426,469558936,469575839,16903,1992,200
469582347,469580074,469596761,16687,1993,200
469603263,469600989,469617675,16686,1994,200
469624296,469621806,469638709,16903,1995,200
469645331,469642841,469660061,17220,1996,200
469666557,469664284,469679071,14787,1997,200
469685692,469683202,469700760,17558,1998,200
469707382,469704892,469719558,14666,1999,200
469726178,469723689,469741561,17872,2000,200
469748183,469745694,469761310,15616,2001,200
469767814,469765541,469780961,15420,2002,200
469787582,469785092,469801025,15933,2003,200
469807483,469805210,469822845,17635,2004,200
469829467,469826977,469842909,15932,2005,200
469849530,469847041,469863625,16584,2006,200
469870246,469867757,469882421,14664,2007,200
469888946,469886673,469904331,17658,2008,200
469910833,469908561,469923348,14787,2009,200
469929803,469927530,469944215,16685,2010,200
469950837,469948348,469965884,17536,2011,200
469972505,469970016,469987868,17852,2012,200
469994489,469992000,470007953,15953,2013,200
470014574,470012085,470028987,16902,2014,200
470035610,470033119,470049390,16271,2015,200
470056012,470053522,470071374,17852,2016,200
470077997,470075507,470091776,16269,2017,200
470098397,470095908,470114097,18189,2018,200
470120633,470118359,470133126,14767,2019,200
470139748,470137258,470153823,16565,2020,200
470160445,470157956,470174858,16902,2021,200
470181480,470178990,470195576,16586,2022,200
470202199,470199709,470216296,16587,2023,200
470222919,470220429,470237648,17219,2024,200
470244145,470241872,470258873,17001,2025,200
470265325,470263052,470278472,15420,2026,200
470285052,470282779,470300752,17973,2027,200
470307373,470304884,470322419,17535,2028,200
470329041,470326552,470341217,14665,2029,200
470347783,470345510,470363165,17655,2030,200
470369653,470367381,470383433,16052,2031,200
470389916,470387643,470405280,17637,2032,200
470411775,470409502,470425871,16369,2033,200
470432493,470430003,470444986,14983,2034,200
470451608,470449118,470465705,16587,2035,200
470472215,470469943,470485362,15419,2036,200
470491868,470489595,470507232,17637,2037,200
470513855,470511365,470527635,16270,2038,200
470534222,470531949,470548636,16687,2039,200
470555195,470552922,470568341,15419,2040,200
470574917,470572644,470588042,15398,2041,200
470594573,470592300,470608986,16686,2042,200
470615465,470613192,470629562,16370,2043,200
470636184,470633695,470650914,17219,2044,200
470657536,470655046,470671947,16901,2045,200
470678569,470676079,470693299,17220,2046,200
470699922,470697431,470715284,17853,2047,200
470721792,470719520,470734940,15420,2048,200
470741561,470739072,470755658,16586,2049,200
470762221,470759948,470776317,16369,2050,200
470782940,470780449,470797016,16567,2051,200
470803639,470801149,470818052,16903,2052,200
470824673,470822184,470837503,15319,2053,200
470844124,470841635,470857251,15616,2054,200
470863871,470861382,470878622,17240,2055,200
470885243,470882754,470898051,15297,2056,200
470904673,470902183,470919718,17535,2057,200
470926252,470923979,470940665,16686,2058,200
470947287,470944798,470962354,17556,2059,200
470968976,470966486,470985308,18822,2060,200
470991776,470989504,471007476,17972,2061,200
471013980,471011707,471027445,15738,2062,200
471034067,471031577,471047530,15953,2063,200
471053994,471051721,471066508,14787,2064,200
471073031,471070758,471084912,14154,2065,200
471091411,471089137,471104241,15104,2066,200
471110863,471108372,471123356,14984,2067,200
471129929,471127657,471144004,16347,2068,200
471150627,471148137,471163458,15321,2069,200
471169927,471167653,471183074,15421,2070,200
471189595,471187322,471205295,17973,2071,200
471211917,471209427,471225696,16269,2072,200
471232224,471229952,471246975,17023,2073,200
471253597,471251107,471267398,16291,2074,200
471274020,471271530,471287147,15617,2075,200
471293766,471291278,471308180,16902,2076,200
471314802,471312312,471328582,16270,2077,200
471335157,471332885,471350857,17972,2078,200
471357478,471354989,471373811,18822,2079,200
471380434,471377943,471396135,18192,2080,200
471402614,471400341,471415127,14786,2081,200
471421748,471419259,471435528,16269,2082,200
471442054,471439781,471455813,16032,2083,200
471462392,471460119,471475834,15715,2084,200
471482456,471479966,471496553,16587,2085,200
471503175,471500686,471517905,17219,2086,200
471524489,471522216,471538584,16368,2087,200
471545037,471542764,471559451,16687,2088,200
471566012,471563739,471585027,21288,2089,200
471591592,471589320,471614595,25275,2090,200
471621099,471618826,471635196,16370,2091,200
471641818,471639328,471656548,17220,2092,200
471663117,471660844,471678795,17951,2093,200
471685303,471683030,471698451,15421,2094,200
471704958,471702686,471720003,17317,2095,200
471726626,471724135,471740722,16587,2096,200
471747343,471744854,471762074,17220,2097,200
471768696,471766206,471781527,15321,2098,200
471788149,471785659,471801295,15636,2099,200
471807917,471805427,471820748,15321,2100,200
471827253,471824981,471841982,17001,2101,200
471848606,471846115,471862702,16587,2102,200
471869323,471866834,471884391,17557,2103,200
471891012,471888523,471906375,17852,2104,200
471912894,471910620,471926019,15399,2105,200
471932640,471930150,471947686,17536,2106,200
471954270,471951996,471969970,17974,2107,200
471976592,471974102,471990055,15953,2108,200
471996519,471994245,472011566,17321,2109,200
472018134,472015861,472031259,15398,2110,200
472037881,472035390,472050076,14686,2111,200
472056543,472054270,472071611,17341,2112,200
472078187,472075914,472093254,17340,2113,200
472099713,472097440,472114760,17320,2114,200
472121326,472119053,472133819,14766,2115,200
472140405,472138131,472153869,15738,2116,200
472160490,472158000,472175874,17874,2117,200
472182496,472180006,472196256,16250,2118,200
472202717,472200445,472216180,15735,2119,200
472222713,472220440,472237779,17339,2120,200
472244401,472241911,472258812,16901,2121,200
472265317,472263044,472279414,16370,2122,200
472286036,472283546,472300132,16586,2123,200
472306754,472304264,472322455,18191,2124,200
472329077,472326587,472342202,15615,2125,200
472348823,472346334,472362582,16248,2126,200
472369203,472366714,472382644,15930,2127,200
472389152,472386878,472402299,15421,2128,200
472408919,472406430,472423016,16586,2129,200
472429584,472427311,472443342,16031,2130,200
472449964,472447474,472463427,15953,2131,200
472469930,472467657,472483076,15419,2132,200
472489547,472487273,472501427,14154,2133,200
472508048,472505559,472521194,15635,2134,200
472527816,472525326,472541616,16290,2135,200
472548070,472545797,472560562,14765,2136,200
472567149,472564876,472579326,14450,2137,200
472585895,472583622,472599358,15736,2138,200
472605979,472603489,472619442,15953,2139,200
472626017,472623744,472640093,16349,2140,200
472646715,472644225,472662732,18507,2141,200
472669186,472666913,472682986,16073,2142,200
472689606,472687118,472703703,16585,2143,200
472710325,472707835,472724422,16587,2144,200
472730932,472728658,472745345,16687,2145,200
472751967,472749477,472766062,16585,2146,200
472772542,472770269,472786638,16369,2147,200
472793260,472790770,472807041,16271,2148,200
472813547,472811274,472829880,18606,2149,200
472836503,472834012,472851233,17221,2150,200
472857854,472855365,472870683,15318,2151,200
472877304,472874814,472889502,14688,2152,200
472896082,472893808,472912415,18607,2153,200
472918979,472916707,472933393,16686,2154,200
472940014,472937525,472952822,15297,2155,200
472959444,472956954,472972908,15954,2156,200
472979432,472977158,472994162,17004,2157,200
473000783,472998294,473015197,16903,2158,200
473021755,473019483,473037773,18290,2159,200
473044394,473041905,473059145,17240,2160,200
473065678,473063406,473080745,17339,2161,200
473087253,473084980,473100084,15104,2162,200
473106568,473104295,473119377,15082,2163,200
473125965,473123693,473140041,16348,2164,200
473146663,473144173,473161391,17218,2165,200
473167966,473165693,473183981,18288,2166,200
473190603,473188113,473204700,16587,2167,200
473211322,473208832,473225734,16902,2168,200
473232220,473229947,473248554,18607,2169,200
473255139,473252866,473269869,17003,2170,200
473276490,473274001,473289954,15953,2171,200
473296541,473294268,473310322,16054,2172,200
473316826,473314553,473331873,17320,2173,200
473338332,473336059,473351456,15397,2174,200
473357988,473355715,473372064,16349,2175,200
473378687,473376196,473391833,15637,2176,200
473398453,473395964,473413815,17851,2177,200
473420437,473417947,473434196,16249,2178,200
473440818,473438328,473455232,16904,2179,200
473461729,473459456,473475531,16075,2180,200
473482031,473479759,473495176,15417,2181,200
473501798,473499308,473517161,17853,2182,200
473523743,473521470,473538156,16686,2183,200
473544718,473542445,473558497,16052,2184,200
473564963,473562691,473578110,15419,2185,200
473584680,473582406,473599409,17003,2186,200
473605991,473603718,473617870,14152,2187,200
473624491,473622001,473638905,16904,2188,200
473645483,473643210,473658946,15736,2189,200
473665427,473663153,473678235,15082,2190,200
473684856,473682366,473699923,17557,2191,200
473706382,473704110,473721766,17656,2192,200
473728285,473726011,473742698,16687,2193,200
473749265,473746993,473763045,16052,2194,200
473769504,473767232,473784550,17318,2195,200
473791171,473788682,473804614,15932,2196,200
473811236,473808746,473825333,16587,2197,200
473831797,473829524,473845239,15715,2198,200
473851859,473849370,473865935,16565,2199,200
473872557,473870067,473884437,14370,2200,200
473891057,473888568,473904859,16291,2201,200
473911312,473909038,473925069,16031,2202,200
473931690,473929201,473945449,16248,2203,200
473952071,473949581,473965851,16270,2204,200
473972418,473970146,473987148,17002,2205,200
473993769,473991280,474007211,15931,2206,200
474013689,474011417,474027152,15735,2207,200
474033773,474031284,474047869,16585,2208,200
474054491,474052001,474068270,16269,2209,200
474074724,474072451,474090107,17656,2210,200
474096694,474094422,474108575,14153,2211,200
474115090,474112817,474128551,15734,2212,200
474135172,474132682,474147665,14983,2213,200
474154242,474151969,474167072,15103,2214,200
474173656,474171382,474187119,15737,2215,200
474193586,474191312,474207388,16076,2216,200
474214010,474211520,474228424,16904,2217,200
474235047,474232557,474248849,16292,2218,200
474255472,474252981,474268914,15933,2219,200
474275414,474273140,474288223,15083,2220,200
474294788,474292515,474310805,18290,2221,200
474317428,474314938,474332177,17239,2222,200
474338801,474336310,474351927,15617,2223,200
474358457,474356184,474372259,16075,2224,200
474378881,474376391,474392999,16608,2225,200
474399620,474397131,474414982,17851,2226,200
474421604,474419115,474434434,15319,2227,200
474441056,474438566,474454519,15953,2228,200
474461140,474458650,474477473,18823,2229,200
474483954,474481681,474496783,15102,2230,200
474503285,474501012,474518964,17952,2231,200
474525475,474523202,474537988,14786,2232,200
474544452,474542179,474558864,16685,2233,200
474565487,474562997,474581188,18191,2234,200
474587809,474585320,474602540,17220,2235,200
474609033,474606760,474623447,16687,2236,200
474630070,474627579,474644484,16905,2237,200
474651105,474648616,474665200,16584,2238,200
474671707,474669434,474683903,14469,2239,200
474690525,474688035,474703968,15933,2240,200
474710437,474708164,474722930,14766,2241,200
474729552,474727062,474742045,14983,2242,200
474748552,474746279,474769804,23525,2243,200
474776308,474774035,474790087,16052,2244,200
474796606,474794333,474811336,17003,2245,200
474817957,474815468,474831738,16270,2246,200
474838360,474835870,474853091,17221,2247,200
474859713,474857223,474874780,17557,2248,200
474881403,474878913,474896786,17873,2249,200
474903348,474901074,474916495,15421,2250,200
474923117,474920626,474936897,16271,2251,200
474943457,474941185,474955654,14469,2252,200
474962276,474959786,474976689,16903,2253,200
474983311,474980821,474997406,16585,2254,200
475004029,475001539,475018126,16587,2255,200
475024747,475022258,475037240,14982,2256,200
475043862,475041372,475058592,17220,2257,200
475065101,475062828,475079198,16370,2258,200
475085708,475083435,475098835,15400,2259,200
475105457,475102967,475119217,16250,2260,200
475125723,475123450,475139165,15715,2261,200
475145658,475143385,475160705,17320,2262,200
475167292,475165019,475181050,16031,2263,200
475187671,475185182,475203033,17851,2264,200
475209654,475207165,475222464,15299,2265,200
475229024,475226751,475244387,17636,2266,200
475251008,475248519,475264472,15953,2267,200
475271093,475268604,475284239,15635,2268,200
475290859,475288370,475305589,17219,2269,200
475312165,475309892,475324657,14765,2270,200
475331279,475328789,475345376,16587,2271,200
475351901,475349628,475366314,16686,2272,200
475372936,475370446,475387053,16607,2273,200
475393674,475391185,475408404,17219,2274,200
475415024,475412536,475427538,15002,2275,200
475433988,475431715,475447473,15758,2276,200
475454094,475451605,475468823,17218,2277,200
475475446,475472955,475489859,16904,2278,200
475496481,475493991,475509607,15616,2279,200
475516230,475513739,475530010,16271,2280,200
475536631,475534142,475551381,17239,2281,200
475558003,475555513,475572754,17241,2282,200
475579378,475576887,475593158,16271,2283,200
475599627,475597353,475613089,15736,2284,200
475619653,475617380,475633455,16075,2285,200
475640077,475637587,475653858,16271,2286,200
475660418,475658146,475673227,15081,2287,200
475679728,475677454,475694773,17319,2288,200
475701354,475699082,475714797,15715,2289,200
475721418,475718929,475735830,16901,2290,200
475742348,475740075,475756444,16369,2291,200
475762950,475760677,475774831,14154,2292,200
475781415,475779142,475796778,17636,2293,200
475803310,475801037,475816435,15398,2294,200
475823056,475820567,475836837,16270,2295,200
475843358,475841085,475858425,17340,2296,200
475865047,475862557,475879776,17219,2297,200
475886398,475883908,475900809,16901,2298,200
475907430,475904941,475922814,17873,2299,200
475929436,475926946,475945137,18191,2300,200
475951703,475949430,475966432,17002,2301,200
475973054,475970565,475984935,14370,2302,200
475991557,475989067,476005336,16269,2303,200
476011959,476009468,476027343,17875,2304,200
476033825,476031553,476047921,16368,2305,200
476054451,476052177,476068548,16371,2306,200
476075170,476072680,476089267,16587,2307,200
476095889,476093399,476109015,15616,2308,200
476115497,476113224,476130226,17002,2309,200
476136848,476134358,476150312,15954,2310,200
476156933,476154444,476168813,14369,2311,200
476175387,476173114,476190749,17635,2312,200
476197255,476194982,476210085,15103,2313,200
476216707,476214217,476231121,16904,2314,200
476237744,476235253,476249624,14371,2315,200
476256244,476253755,476271942,18187,2316,200
476278456,476276183,476291919,15736,2317,200
476298539,476296050,476311369,15319,2318,200
476317865,476315593,476333544,17951,2319,200
476340033,476337760,476355080,17320,2320,200
476361541,476359268,476376905,17637,2321,200
476383370,476381096,476395863,14767,2322,200
476402371,476400098,476416150,16052,2323,200
476422636,476420363,476437704,17341,2324,200
476444240,476441966,476458970,17004,2325,200
476465484,476463211,476481817,18606,2326,200
476488315,476486042,476502728,16686,2327,200
476509227,476506954,476522373,15419,2328,200
476528996,476526505,476544696,18191,2329,200
476551318,476548828,476566680,17852,2330,200
476573146,476570873,476589161,18288,2331,200
476595783,476593293,476608275,14982,2332,200
476614795,476612522,476628892,16370,2333,200
476635357,476633084,476648482,15398,2334,200
476655104,476652614,476669516,16902,2335,200
476676032,476673759,476689157,15398,2336,200
476695734,476693461,476709851,16390,2337,200
476716474,476713984,476731520,17536,2338,200
476738049,476735776,476753117,17341,2339,200
476759740,476757250,476773518,16268,2340,200
476780089,476777816,476793235,15419,2341,200
476799740,476797467,476812549,15082,2342,200
476819067,476816795,476831558,14763,2343,200
476838012,476835739,476851158,15419,2344,200
476857779,476855290,476872825,17535,2345,200
476879447,476876957,476893859,16902,2346,200
476900480,476897991,476913310,15319,2347,200
476919932,476917442,476935612,18170,2348,200
476942173,476939900,476957239,17339,2349,200
476963861,476961371,476978929,17558,2350,200
476985550,476983061,476999963,16902,2351,200
477006479,477004206,477021526,17320,2352,200
477028031,477025759,477043098,17339,2353,200
477049679,477047406,477065062,17656,2354,200
477071684,477069195,477086098,16903,2355,200
477092626,477090354,477106384,16030,2356,200
477112879,477110605,477126321,15716,2357,200
477132838,477130565,477149171,18606,2358,200
477155794,477153303,477171179,17876,2359,200
477177754,477175482,477193139,17657,2360,200
477199672,477197399,477212798,15399,2361,200
477219419,477216929,477233200,16271,2362,200
477239821,477237332,477253262,15930,2363,200
477259883,477257393,477275582,18189,2364,200
477282039,477279766,477297423,17657,2365,200
477304045,477301555,477316242,14687,2366,200
477322863,477320373,477336960,16587,2367,200
477343472,477341198,477356303,15105,2368,200
477362832,477360559,477376633,16074,2369,200
477383134,477380861,477398517,17656,2370,200
477405138,477402649,477417948,15299,2371,200
477424468,477422194,477440168,17974,2372,200
477446789,477444300,477461519,17219,2373,200
477468141,477465651,477482237,16586,2374,200
477488798,477486524,477502892,16368,2375,200
477509424,477507151,477523521,16370,2376,200
477530143,477527653,477543268,15615,2377,200
477549763,477547490,477563859,16369,2378,200
477570483,477567992,477584895,16903,2379,200
477591481,477589208,477607161,17953,2380,200
477613783,477611293,477625981,14688,2381,200
477632450,477630177,477646547,16370,2382,200
477653170,477650680,477665662,14982,2383,200
477672283,477669793,477685113,15320,2384,200
477691577,477689305,477705990,16685,2385,200
477712613,477710122,477726709,16587,2386,200
477733238,477730967,477745731,14764,2387,200
477752352,477749863,477768686,18823,2388,200
477775246,477772972,477788394,15422,2389,200
477794919,477792646,477808699,16053,2390,200
477815322,477812831,477828786,15955,2391,200
477835408,477832918,477850474,17556,2392,200
477857055,477854782,477871784,17002,2393,200
477878239,477875964,477892653,16689,2394,200
477899274,477896785,477912737,15952,2395,200
477919298,477917025,477933079,16054,2396,200
477939702,477937212,477955065,17853,2397,200
477961688,477959197,477975150,15953,2398,200
477981733,477979460,477995512,16052,2399,200
478002021,477999747,478015167,15420,2400,200
478021695,478019422,478036761,17339,2401,200
478043384,478040894,478056848,15954,2402,200
478063471,478060980,478075986,15006,2403,200
478082497,478080225,478096910,16685,2404,200
478103532,478101042,478116678,15636,2405,200
478123300,478120810,478139317,18507,2406,200
478145940,478143450,478160670,17220,2407,200
478167291,478164802,478182970,18168,2408,200
478189430,478187157,478203190,16033,2409,200
478209813,478207323,478222621,15298,2410,200
478229243,478226753,478244627,17874,2411,200
478251107,478248834,478264888,16054,2412,200
478271421,478269148,478284252,15104,2413,200
478290735,478288462,478305464,17002,2414,200
478312086,478309596,478324896,15300,2415,200
478331427,478329153,478344890,15737,2416,200
478351340,478349067,478364487,15420,2417,200
478371109,478368619,478385837,17218,2418,200
478392459,478389970,478406871,16901,2419,200
478413333,478411060,478425213,14153,2420,200
478431835,478429345,478444961,15616,2421,200
478451522,478449249,478466590,17341,2422,200
478473095,478470823,478486876,16053,2423,200
478493407,478491134,478507841,16707,2424,200
478514368,478512095,478526860,14765,2425,200
478533481,478530991,478547259,16268,2426,200
478553711,478551438,478568123,16685,2427,200
478574683,478572410,478589413,17003,2428,200
478596035,478593546,478609183,15637,2429,200
478615803,478613314,478631504,18190,2430,200
478637987,478635714,478652082,16368,2431,200
478658705,478656214,478671830,15616,2432,200
478678453,478675962,478694153,18191,2433,200
478700776,478698286,478715507,17221,2434,200
478721960,478719687,478736036,16349,2435,200
478742556,478740283,478755703,15420,2436,200
478762325,478759835,478775155,15320,2437,200
478781777,478779287,478797457,18170,2438,200
478804080,478801589,478817226,15637,2439,200
478823728,478821455,478836537,15082,2440,200
478843020,478840747,478856166,15419,2441,200
478862788,478860298,478875281,14983,2442,200
478881901,478879412,478897284,17872,2443,200
478903853,478901580,478916367,14787,2444,200
478922892,478920619,478936040,15421,2445,200
478942518,478940244,478955011,14767,2446,200
478961585,478959312,478975682,16370,2447,200
478982305,478979815,478998323,18508,2448,200
479004821,479002548,479017968,15420,2449,200
479024474,479022200,479038253,16053,2450,200
479044737,479042463,479058201,15738,2451,200
479064706,479062432,479078465,16033,2452,200
479085087,479082597,479101104,18507,2453,200
479107727,479105237,479120557,15320,2454,200
479127019,479124746,479141771,17025,2455,200
479148393,479145903,479160591,14688,2456,200
479167213,479164723,479180697,15974,2457,200
479187264,479184991,479200094,15103,2458,200
479206578,479204305,479221308,17003,2459,200
479227804,479225531,479240614,15083,2460,200
479247236,479244746,479259117,14371,2461,200
479265568,479263295,479278398,15103,2462,200
479285021,479282530,479300384,17854,2463,200
479306913,479304640,479321009,16369,2464,200
479327630,479325141,479341411,16270,2465,200
479347910,479345638,479362006,16368,2466,200
479368628,479366138,479383042,16904,2467,200
479389526,479387253,479402356,15103,2468,200
479408849,479406578,479421362,14784,2469,200
479427983,479425494,479439863,14369,2470,200
479446484,479443995,479461531,17536,2471,200
479468153,479465663,479483833,18170,2472,200
479490415,479488142,479503879,15737,2473,200
479510502,479508011,479524937,16926,2474,200
479531395,479529122,479544205,15083,2475,200
479550826,479548337,479563636,15299,2476,200
479570257,479567768,479584352,16584,2477,200
479590856,479588583,479604953,16370,2478,200
479611576,479609086,479624723,15637,2479,200
479631345,479628855,479646096,17241,2480,200
479652719,479650229,479665529,15300,2481,200
479672151,479669661,479685298,15637,2482,200
479691920,479689430,479706016,16586,2483,200
479712499,479710226,479725962,15736,2484,200
479732470,479730197,479748487,18290,2485,200
479755109,479752619,479767624,15005,2486,200
479774197,479771924,479787977,16053,2487,200
479794599,479792109,479806480,14371,2488,200
479813102,479810612,479828803,18191,2489,200
479835424,479832935,479850807,17872,2490,200
479857332,479855059,479870457,15398,2491,200
479877078,479874589,479893094,18505,2492,200
479899715,479897226,479914127,16901,2493,200
479920633,479918361,479934074,15713,2494,200
479940649,479938376,479954112,15736,2495,200
479960735,479958244,479972933,14689,2496,200
479979555,479977065,479994622,17557,2497,200
480001245,479998755,480015025,16270,2498,200
480021587,480019315,480035999,16684,2499,200
480042621,480040131,480056400,16269,2500,200
480062926,480060654,480076074,15420,2501,200
480082581,480080308,480097311,17003,2502,200
480103825,480101552,480119187,17635,2503,200
480125810,480123319,480139883,16564,2504,200
480146504,480144015,480162838,18823,2505,200
480169460,480166970,480183555,16585,2506,200
480190062,480187789,480206396,18607,2507,200
480213019,480210529,480225849,15320,2508,200
480232376,480230103,480245502,15399,2509,200
480252124,480249634,480266537,16903,2510,200
480272997,480270724,480289015,18291,2511,200
480295580,480293307,480309677,16370,2512,200
480316211,480313938,480330013,16075,2513,200
480336635,480334145,480350753,16608,2514,200
480357375,480354885,480371154,16269,2515,200
480377737,480375463,480391496,16033,2516,200
480397988,480395715,480412402,16687,2517,200
480418897,480416624,480434598,17974,2518,200
480441173,480438900,480456241,17341,2519,200
480462862,480460373,480476304,15931,2520,200
480482831,480480559,480496926,16367,2521,200
480503548,480501058,480517307,16249,2522,200
480523891,480521618,480536721,15103,2523,200
480543343,480540853,480558072,17219,2524,200
480564694,480562205,480578496,16291,2525,200
480585117,480582628,480599845,17217,2526,200
480606468,480603977,480618961,14984,2527,200
480625532,480623258,480641549,18291,2528,200
480648071,480645797,480662168,16371,2529,200
480668790,480666301,480682907,16606,2530,200
480689470,480687197,480702301,15104,2531,200
480708764,480706492,480722524,16032,2532,200
480729038,480726766,480742479,15713,2533,200
480749100,480746611,480762226,15615,2534,200
480768849,480766358,480783261,16903,2535,200
480789884,480787394,480803981,16587,2536,200
480810602,480808113,480824381,16268,2537,200
480831003,480828513,480842884,14371,2538,200
480849459,480847186,480862922,15736,2539,200
480869545,480867054,480883664,16610,2540,200
480890286,480887797,480904067,16270,2541,200
480910690,480908200,480923520,15320,2542,200
480930140,480927651,480944552,16901,2543,200
480951174,480948684,480971286,22602,2544,200
480977766,480975494,480993466,17972,2545,200
481000088,480997598,481014818,17220,2546,200
481021312,481019039,481036359,17320,2547,200
481042981,481040491,481057711,17220,2548,200
481064280,481062008,481077765,15757,2549,200
481084385,481081896,481096899,15003,2550,200
481103359,481101087,481118111,17024,2551,200
481124697,481122424,481137844,15420,2552,200
481144466,481141976,481156347,14371,2553,200
481162968,481160479,481177698,17219,2554,200
481184321,481181831,481198418,16587,2555,200
481205039,481202550,481217216,14666,2556,200
481223838,481221348,481237301,15953,2557,200
481243923,481241433,481258653,17220,2558,200
481265110,481262836,481277307,14471,2559,200
481283929,481281439,481298341,16902,2560,200
481304795,481302522,481317603,15081,2561,200
481324225,481321735,481338027,16292,2562,200
481344562,481342288,481357370,15082,2563,200
481363992,481361502,481378089,16587,2564,200
481384711,481382222,481397541,15319,2565,200
481404019,481401746,481419719,17973,2566,200
481426342,481423852,481441388,17536,2567,200
481447971,481445698,481462385,16687,2568,200
481469008,481466518,481483738,17220,2569,200
481490361,481487871,481505090,17219,2570,200
481511608,481509335,481526992,17657,2571,200
481533615,481531125,481546129,15004,2572,200
481552751,481550261,481566531,16270,2573,200
481573153,481570664,481585350,14686,2574,200
481591913,481589639,481605356,15717,2575,200
481611855,481609583,481628189,18606,2576,200
481634811,481632322,481647304,14982,2577,200
481653798,481651525,481667261,15736,2578,200
481673757,481671484,481685934,14450,2579,200
481692517,481690244,481707880,17636,2580,200
481714503,481712012,481728261,16249,2581,200
481734825,481732552,481748605,16053,2582,200
481755109,481752836,481769838,17002,2583,200
481776357,481774084,481789188,15104,2584,200
481795755,481793483,481809219,15736,2585,200
481815841,481813351,481829619,16268,2586,200
481836242,481833752,481849706,15954,2587,200
481856221,481853948,481871583,17635,2588,200
481878072,481875799,481891536,15737,2589,200
481898158,481895668,481912572,16904,2590,200
481919073,481916799,481931248,14449,2591,200
481937712,481935439,481951154,15715,2592,200
481957663,481955390,481973364,17974,2593,200
481979937,481977664,481994033,16369,2594,200
482000607,481998334,482014704,16370,2595,200
482021194,482018921,482037526,18605,2596,200
482044032,482041759,482057179,15420,2597,200
482063709,482061436,482080042,18606,2598,200
482086664,482084175,482100424,16249,2599,200
482107047,482104557,482121144,16587,2600,200
482127768,482125277,482143151,17874,2601,200
482149773,482147284,482163236,15952,2602,200
482169757,482167484,482183516,16032,2603,200
482190076,482187802,482205144,17342,2604,200
482211767,482209277,482226180,16903,2605,200
482232802,482230313,482246898,16585,2606,200
482253481,482251207,482266608,15401,2607,200
482273231,482270740,482286674,15934,2608,200
482293252,482290980,482307033,16053,2609,200
482313612,482311339,482326758,15419,2610,200
482333380,482330890,482349398,18508,2611,200
482356020,482353531,482370138,16607,2612,200
482376655,482374382,482390751,16369,2613,200
482397253,482394980,482413270,18290,2614,200
482419892,482417403,482434938,17535,2615,200
482441560,482439071,482457893,18822,2616,200
482464516,482462026,482478929,16903,2617,200
482485551,482483062,482499331,16269,2618,200
482505954,482503464,482521001,17537,2619,200
482527624,482525134,482540116,14982,2620,200
482546650,482544377,482560747,16370,2621,200
482567273,482564999,482583289,18290,2622,200
482589798,482587524,482603261,15737,2623,200
482609790,482607518,482622283,14765,2624,200
482628905,482626415,482644605,18190,2625,200
482651191,482648919,482666892,17973,2626,200
482673403,482671129,482689736,18607,2627,200
482696234,482693961,482711301,17340,2628,200
482717924,482715434,482732336,16902,2629,200
482738958,482736469,482752738,16269,2630,200
482759361,482756871,482775061,18190,2631,200
482781573,482779300,482796303,17003,2632,200
482802785,482800512,482816269,15757,2633,200
482822754,482820481,482839087,18606,2634,200
482845710,482843220,482858203,14983,2635,200
482864779,482862506,482878243,15737,2636,200
482884865,482882375,482897379,15004,2637,200
482904002,482901511,482919364,17853,2638,200
482925986,482923497,482939429,15932,2639,200
482945955,482943683,482959734,16051,2640,200
482966245,482963972,482981945,17973,2641,200
482988398,482986125,483004731,18606,2642,200
483011250,483008977,483024079,15102,2643,200
483030701,483028211,483046063,17852,2644,200
483052517,483050244,483068217,17973,2645,200
483074682,483072408,483088461,16053,2646,200
483094921,483092649,483109968,17319,2647,200
483116503,483114230,483129966,15736,2648,200
483136588,483134098,483150031,15933,2649,200
483156596,483154323,483170692,16369,2650,200
483177188,483174915,483190016,15101,2651,200
483196638,483194148,483212021,17873,2652,200
483218530,483216257,483233576,17319,2653,200
483240092,483237818,483255138,17320,2654,200
483261593,483259320,483276324,17004,2655,200
483282947,483280457,483296727,16270,2656,200
483303349,483300860,483317446,16586,2657,200
483324069,483321579,483337532,15953,2658,200
483344040,483341768,483356532,14764,2659,200
483363033,483360760,483375526,14766,2660,200
483382028,483379755,483395175,15420,2661,200
483401797,483399307,483416864,17557,2662,200
483423487,483420997,483438217,17220,2663,200
483444706,483442433,483458466,16033,2664,200
483465090,483462599,483477898,15299,2665,200
483484356,483482082,483499400,17318,2666,200
483505923,483503650,483520989,17339,2667,200
483527551,483525278,483540382,15104,2668,200
483546847,483544574,483562863,18289,2669,200
483569485,483566996,483582631,15635,2670,200
483589253,483586763,483602716,15953,2671,200
483609338,483606848,483623139,16291,2672,200
483629761,483627272,483643224,15952,2673,200
483649846,483647356,483664914,17558,2674,200
483671434,483669162,483684560,15398,2675,200
483691182,483688692,483703063,14371,2676,200
483709647,483707375,483725030,17655,2677,200
483731652,483729163,483744798,15635,2678,200
483751420,483748930,483765200,16270,2679,200
483771775,483769502,483785577,16075,2680,200
483792164,483789891,483804994,15103,2681,200
483811503,483809230,483826233,17003,2682,200
483832760,483830488,483845274,14786,2683,200
483851801,483849529,483864948,15419,2684,200
483871570,483869080,483887270,18190,2685,200
483893893,483891403,483908939,17536,2686,200
483915475,483913202,483930522,17320,2687,200
483937145,483934655,483950925,16270,2688,200
483957386,483955113,483970511,15398,2689,200
483977028,483974755,483989521,14766,2690,200
483996142,483993653,484010871,17218,2691,200
484017336,484015063,484033353,18290,2692,200
484039880,484037607,484054293,16686,2693,200
484060789,484058516,484074886,16370,2694,200
484081365,484079092,484096748,17656,2695,200
484103371,484100881,484118734,17853,2696,200
484125356,484122867,484138503,15636,2697,200
484145125,484142635,484159876,17241,2698,200
484166498,484164009,484181227,17218,2699,200
484187851,484185360,484203552,18192,2700,200
484210174,484207685,484223005,15320,2701,200
484229628,484227138,484242436,15298,2702,200
484248897,484246624,484261389,14765,2703,200
484268011,484265521,484281791,16270,2704,200
484288413,484285924,484312006,26082,2705,200
484318466,484316193,484331929,15736,2706,200
484338551,484336061,484354569,18508,2707,200
484361150,484358876,484373980,15104,2708,200
484380486,484378213,484394898,16685,2709,200
484401520,484399031,484415617,16586,2710,200
484422239,484419750,484436970,17220,2711,200
484443458,484441185,484457239,16054,2712,200
484463723,484461450,484479423,17973,2713,200
484485991,484483718,484501038,17320,2714,200
484507529,484505256,484519410,14154,2715,200
484525913,484523640,484540959,17319,2716,200
484547422,484545150,484560253,15103,2717,200
484566758,484564486,484581488,17002,2718,200
484588110,484585621,484603156,17535,2719,200
484609779,484607289,484622905,15616,2720,200
484629482,484627209,484643577,16368,2721,200
484650079,484647806,484664809,17003,2722,200
484671296,484669022,484684739,15717,2723,200
484691228,484688956,484704375,15419,2724,200
484710938,484708664,484725668,17004,2725,200
484732167,484729895,484744996,15101,2726,200
484751618,484749128,484767003,17875,2727,200
484773585,484771312,484787681,16369,2728,200
484794304,484791814,484807768,15954,2729,200
484814343,484812070,484830360,18290,2730,200
484836812,484834539,484851880,17341,2731,200
484858502,484856013,484872599,16586,2732,200
484879221,484876732,484893971,17239,2733,200
484900594,484898104,484915640,17536,2734,200
484922262,484919773,484935726,15953,2735,200
484942262,484939989,484956043,16054,2736,200
484962607,484960334,484977021,16687,2737,200
484983539,484981266,484999556,18290,2738,200
485006179,485003689,485020593,16904,2739,200
485027077,485024803,485041174,16371,2740,200
485047796,485045307,485062209,16902,2741,200
485068832,485066342,485081663,15321,2742,200
485088192,485085919,485100684,14765,2743,200
485107272,485104999,485120735,15736,2744,200
485127267,485124994,485140392,15398,2745,200
485146842,485144569,485160599,16030,2746,200
485167053,485164780,485180200,15420,2747,200
485186821,485184332,485199313,14981,2748,200
485205812,485203539,485220226,16687,2749,200
485226678,485224404,485240119,15715,2750,200
485246701,485244429,485261114,16685,2751,200
485267643,485265370,485281422,16052,2752,200
485288045,485285555,485302775,17220,2753,200
485309240,485306966,485322704,15738,2754,200
485329325,485326836,485345025,18189,2755,200
485351512,485349239,485365925,16686,2756,200
485372508,485370234,485385972,15738,2757,200
485392595,485390104,485405720,15616,2758,200
485412242,485409969,485425368,15399,2759,200
485431870,485429597,485448203,18606,2760,200
485454709,485452435,485469439,17004,2761,200
485475926,485473653,485491310,17657,2762,200
485497822,485495549,485509702,14153,2763,200
485516274,485514000,485530371,16371,2764,200
485536994,485534504,485551724,17220,2765,200
485558232,485555960,485572327,16367,2766,200
485578950,485576460,485592097,15637,2767,200
485598559,485596285,485612656,16371,2768,200
485619178,485616905,485633592,16687,2769,200
485640161,485637888,485655840,17952,2770,200
485662462,485659973,485677846,17873,2771,200
485684469,485681979,485697912,15933,2772,200
485704535,485702044,485718949,16905,2773,200
485725524,485723251,485739303,16052,2774,200
485745809,485743535,485760222,16687,2775,200
485766844,485764355,485781890,17535,2776,200
485788392,485786119,485803438,17319,2777,200
485809907,485807634,485824321,16687,2778,200
485830944,485828454,485845674,17220,2779,200
485852139,485849866,485867839,17973,2780,200
485874368,485872095,485888149,16054,2781,200
485894771,485892281,485908868,16587,2782,200
485915490,485913001,485928953,15952,2783,200
485935454,485933181,485950815,17634,2784,200
485957275,485955002,485970106,15104,2785,200
485976619,485974347,485989112,14765,2786,200
485995638,485993365,486010052,16687,2787,200
486016555,486014282,486030652,16370,2788,200
486037170,486034896,486052869,17973,2789,200
486059492,486057002,486074560,17558,2790,200
486081183,486078693,486095280,16587,2791,200
486101794,486099521,486115890,16369,2792,200
486122512,486120023,486137243,17220,2793,200
486143777,486141504,486157260,15756,2794,200
486163882,486161392,486179900,18508,2795,200
486186421,486184148,486201804,17656,2796,200
486208427,486205937,486223156,17219,2797,200
486229736,486227463,486242546,15083,2798,200
486249009,486246736,486263739,17003,2799,200
486270202,486267928,486283666,15738,2800,200
486290288,486287798,486304702,16904,2801,200
486311325,486308835,486325106,16271,2802,200
486331729,486329239,486345172,15933,2803,200
486351687,486349415,486365150,15735,2804,200
486371772,486369282,486385553,16271,2805,200
486392175,486389686,486406587,16901,2806,200
486413095,486410822,486427507,16685,2807,200
486434130,486431640,486448860,17220,2808,200
486455430,486453157,486470496,17339,2809,200
486476954,486474682,486491367,16685,2810,200
486497849,486495577,486511290,15713,2811,200
486517911,486515422,486532007,16585,2812,200
486538628,486536139,486553042,16903,2813,200
486559533,486557260,486575550,18290,2814,200
486582071,486579798,486595535,15737,2815,200
486602157,486599667,486616907,17240,2816,200
486623530,486621040,486635727,14687,2817,200
486642350,486639859,486655792,15933,2818,200
486662325,486660052,486677076,17024,2819,200
486683571,486681298,486697984,16686,2820,200
486704561,486702288,486717392,15104,2821,200
486724013,486721524,486738110,16586,2822,200
486744639,486742366,486757785,15419,2823,200
486764408,486761917,486779454,17537,2824,200
486786029,486783756,486798839,15083,2825,200
486805461,486802972,486821161,18189,2826,200
486827695,486825422,486841454,16032,2827,200
486848076,486845587,486863775,18188,2828,200
486870305,486868032,486885689,17657,2829,200
486892151,486889877,486907195,17318,2830,200
486913817,486911328,486930150,18822,2831,200
486936676,486934403,486950455,16052,2832,200
486957077,486954588,486969569,14981,2833,200
486976191,486973701,486991552,17851,2834,200
486998175,486995685,487011618,15933,2835,200
487018239,487015750,487032651,16901,2836,200
487039136,487036864,487054183,17319,2837,200
487060806,487058316,487076507,18191,2838,200
487082968,487080695,487096728,16033,2839,200
487103351,487100861,487117764,16903,2840,200
487124291,487122018,487138705,16687,2841,200
487145328,487142838,487159446,16608,2842,200
487166070,487163579,487180820,17241,2843,200
487187442,487184953,487199640,14687,2844,200
487206228,487203954,487220325,16371,2845,200
487226812,487224539,487242828,18289,2846,200
487249418,487247144,487263515,16371,2847,200
487270138,487267648,487284551,16903,2848,200
487291174,487288684,487305269,16585,2849,200
487311771,487309498,487324917,15419,2850,200
487331433,487329160,487346500,17340,2851,200
487353124,487350633,487365299,14666,2852,200
487371792,487369519,487386203,16684,2853,200
487392826,487390336,487407557,17221,2854,200
487414088,487411816,487428185,16369,2855,200
487434715,487432442,487449761,17319,2856,200
487456225,487453951,487471925,17974,2857,200
487478547,487476058,487492959,16901,2858,200
487499581,487497092,487513995,16903,2859,200
487520617,487518128,487533427,15299,2860,200
487540048,487537559,487554144,16585,2861,200
487560768,487558277,487573894,15617,2862,200
487580516,487578026,487595899,17873,2863,200
487602363,487600090,487617092,17002,2864,200
487623716,487621225,487637179,15954,2865,200
487643802,487641311,487657581,16270,2866,200
487664204,487661714,487677646,15932,2867,200
487684225,487681952,487696422,14470,2868,200
487703044,487700554,487718428,17874,2869,200
487725015,487722742,487739449,16707,2870,200
487745942,487743670,487761960,18290,2871,200
487768446,487766174,487780938,14764,2872,200
487787440,487785167,487802486,17319,2873,200
487809002,487806729,487825335,18606,2874,200
487831836,487829562,487845932,16370,2875,200
487852454,487850181,487866867,16686,2876,200
487873489,487871000,487886931,15931,2877,200
487893420,487891146,487907517,16371,2878,200
487914140,487911650,487926968,15318,2879,200
487933556,487931283,487947335,16052,2880,200
487953958,487951468,487969341,17873,2881,200
487975964,487973474,487989428,15954,2882,200
487996050,487993560,488011434,17874,2883,200
488018057,488015567,488032174,16607,2884,200
488038657,488036384,488052436,16052,2885,200
488059007,488056735,488072787,16052,2886,200
488079293,488077020,488091806,14786,2887,200
488098318,488096046,488111445,15399,2888,200
488118023,488115751,488132118,16367,2889,200
488138742,488136251,488152185,15934,2890,200
488158670,488156396,488173105,16709,2891,200
488179620,488177346,488191795,14449,2892,200
488198376,488196103,488210572,14469,2893,200
488217194,488214704,488231268,16564,2894,200
488237891,488235401,488251987,16586,2895,200
488258609,488256120,488273021,16901,2896,200
488279643,488277154,488293106,15952,2897,200
488299597,488297324,488314011,16687,2898,200
488320507,488318234,488332999,14765,2899,200
488339497,488337225,488351989,14764,2900,200
488358485,488356212,488372899,16687,2901,200
488379522,488377032,488394907,17875,2902,200
488401528,488399040,488417861,18821,2903,200
488424484,488421994,488437927,15933,2904,200
488444548,488442059,488459615,17556,2905,200
488466238,488463748,488479700,15952,2906,200
488486321,488483832,488502020,18188,2907,200
488508555,488506282,488521068,14786,2908,200
488527690,488525200,488541448,16248,2909,200
488548071,488545581,488560268,14687,2910,200
488566890,488564400,488582907,18507,2911,200
488589531,488587040,488603945,16905,2912,200
488610452,488608179,488623915,15736,2913,200
488630443,488628169,488644540,16371,2914,200
488651046,488648772,488665460,16688,2915,200
488671946,488669673,488686677,17004,2916,200
488693208,488690935,488709224,18289,2917,200
488715730,488713458,488729173,15715,2918,200
488735703,488733430,488749145,15715,2919,200
488755766,488753277,488769862,16585,2920,200
488776485,488773995,488791869,17874,2921,200
488798371,488796098,488810884,14786,2922,200
488817506,488815016,488829703,14687,2923,200
488836203,488833931,488848696,14765,2924,200
488855145,488852873,488867026,14153,2925,200
488873647,488871158,488887131,15973,2926,200
488893753,488891263,488908166,16903,2927,200
488914788,488912299,488930487,18188,2928,200
488937111,488934620,488952177,17557,2929,200
488958799,488956310,488971925,15615,2930,200
488978425,488976151,488994124,17973,2931,200
489000579,488998305,489015012,16707,2932,200
489021535,489019263,489037869,18606,2933,200
489044491,489042002,489060508,18506,2934,200
489067132,489064641,489081227,16586,2935,200
489087850,489085360,489100680,15320,2936,200
489107302,489104812,489121397,16585,2937,200
489128020,489125530,489142117,16587,2938,200
489148648,489146375,489161457,15082,2939,200
489167972,489165698,489180463,14765,2940,200
489186918,489184645,489201331,16686,2941,200
489207856,489205583,489221952,16369,2942,200
489228575,489226085,489244593,18508,2943,200
489251174,489248901,489265587,16686,2944,200
489272209,489269720,489284702,14982,2945,200
489291192,489288919,489303368,14449,2946,200
489309990,489307500,489323116,15616,2947,200
489329631,489327358,489343410,16052,2948,200
489350032,489347543,489365394,17851,2949,200
489371919,489369647,489386965,17318,2950,200
489393499,489391225,489407300,16075,2951,200
489413786,489411513,489426934,15421,2952,200
489433418,489431145,489447177,16032,2953,200
489453799,489451310,489469499,18189,2954,200
489476087,489473814,489489213,15399,2955,200
489495834,489493345,489510901,17556,2956,200
489517524,489515034,489532569,17535,2957,200
489539192,489536702,489552635,15933,2958,200
489559257,489556768,489573353,16585,2959,200
489579976,489577486,489595677,18191,2960,200
489602211,489599938,489616327,16389,2961,200
489622806,489620533,489635002,14469,2962,200
489641495,489639222,489654324,15102,2963,200
489660778,489658505,489675846,17341,2964,200
489682469,489679979,489696248,16269,2965,200
489702807,489700534,489717853,17319,2966,200
489724476,489721986,489739523,17537,2967,200
489746145,489743656,489759609,15953,2968,200
489766102,489763828,489779249,15421,2969,200
489785718,489783445,489800132,16687,2970,200
489806647,489804374,489820428,16054,2971,200
489826948,489824675,489841994,17319,2972,200
489848496,489846222,489862591,16369,2973,200
489869072,489866800,489882536,15736,2974,200
489889159,489886668,489901968,15300,2975,200
489908590,489906100,489923636,17536,2976,200
489930259,489927769,489944038,16269,2977,200
489950528,489948255,489963336,15081,2978,200
489969873,489967599,489984940,17341,2979,200
489991563,489989073,490005977,16904,2980,200
490012600,490010110,490025093,14983,2981,200
490031715,490029225,490045474,16249,2982,200
490052097,490049607,490068431,18824,2983,200
490074990,490072717,490088137,15420,2984,200
490094713,490092440,490109442,17002,2985,200
490115944,490113671,490128119,14448,2986,200
490134741,490132251,490148522,16271,2987,200
490155144,490152655,490168945,16290,2988,200
490175442,490173169,490190825,17656,2989,200
490197447,490194958,490210594,15636,2990,200
490217215,490214726,490232915,18189,2991,200
490239423,490237151,490253836,16685,2992,200
490260459,490257969,490273605,15636,2993,200
490280226,490277737,490293351,15614,2994,200
490299973,490297483,490314385,16902,2995,200
490321007,490318518,490332888,14370,2996,200
490339341,490337068,490355357,18289,2997,200
490361980,490359490,490373861,14371,2998,200
490380482,490377993,490396498,18505,2999,200
490403080,490400808,490418464,17656,3000,200
490425086,490422597,490438844,16247,3001,200
490445466,490442977,490459880,16903,3002,200
490466502,490464013,490481569,17556,3003,200
490488192,490485702,490502289,16587,3004,200
490508911,490506422,490523008,16586,3005,200
490529592,490527318,490542421,15103,3006,200
490549042,490546553,490565375,18822,3007,200
490571998,490569508,490584195,14687,3008,200
490590654,490588381,490605406,17025,3009,200
490612029,490609539,490627076,17537,3010,200
490633698,490631209,490646191,14982,3011,200
490652813,490650324,490667226,16902,3012,200
490673804,490671530,490687900,16370,3013,200
490694419,490692147,490707545,15398,3014,200
490714166,490711677,490728263,16586,3015,200
490734772,490732498,490747899,15401,3016,200
490754354,490752080,490769084,17004,3017,200
490775540,490773267,490791219,17952,3018,200
490797842,490795352,490811602,16250,3019,200
490818225,490815735,490832974,17239,3020,200
490839596,490837107,490854960,17853,3021,200
490861583,490859093,490875362,16269,3022,200
490881860,490879587,490896273,16686,3023,200
490902850,490900577,490916946,16369,3024,200
490923569,490921079,490938320,17241,3025,200
490944943,490942453,490958386,15933,3026,200
490965008,490962519,490977522,15003,3027,200
490984050,490981778,490999118,17340,3028,200
491005626,491003353,491020040,16687,3029,200
491026540,491024266,491039687,15421,3030,200
491046309,491043820,491061040,17220,3031,200
491067504,491065231,491083522,18291,3032,200
491090145,491087655,491104875,17220,3033,200
491111388,491109115,491123901,14786,3034,200
491130396,491128123,491144493,16370,3035,200
491150999,491148726,491165115,16389,3036,200
491171738,491169249,491183915,14666,3037,200
491190536,491188048,491205898,17850,3038,200
491212520,491210031,491227566,17535,3039,200
491234138,491231865,491248235,16370,3040,200
491254858,491252368,491268637,16269,3041,200
491275259,491272770,491291276,18506,3042,200
491297899,491295409,491312313,16904,3043,200
491318800,491316527,491331948,15421,3044,200
491338569,491336080,491352349,16269,3045,200
491358971,491356482,491374672,18190,3046,200
491381242,491378969,491395973,17004,3047,200
491402596,491400106,491415721,15615,3048,200
491422298,491420025,491436712,16687,3049,200
491443273,491441000,491458656,17656,3050,200
491465279,491462789,491480031,17242,3051,200
491486654,491484164,491501384,17220,3052,200
491508007,491505517,491521134,15617,3053,200
491527721,491525448,491542133,16685,3054,200
491548755,491546265,491563820,17555,3055,200
491570334,491568061,491583796,15735,3056,200
491590419,491587928,491604514,16586,3057,200
491610996,491608723,491626041,17318,3058,200
491632663,491630173,491647393,17220,3059,200
491653899,491651626,491667342,15716,3060,200
491673876,491671603,491686369,14766,3061,200
491692935,491690661,491706082,15421,3062,200
491712537,491710264,491726950,16686,3063,200
491733512,491731240,491746025,14785,3064,200
491752595,491750322,491767325,17003,3065,200
491773835,491771562,491788246,16684,3066,200
491794869,491792379,491807993,15614,3067,200
491814555,491812281,491830256,17975,3068,200
491836843,491834570,491850939,16369,3069,200
491857436,491855163,491872819,17656,3070,200
491879408,491877135,491894138,17003,3071,200
491900717,491898443,491913527,15084,3072,200
491920149,491917659,491935195,17536,3073,200
491941819,491939328,491954626,15298,3074,200
491961079,491958805,491974225,15420,3075,200
491980847,491978357,491995915,17558,3076,200
492002382,492000109,492016161,16052,3077,200
492022748,492020474,492036845,16371,3078,200
492043468,492040978,492059802,18824,3079,200
492066332,492064058,492078825,14767,3080,200
492085385,492083112,492099481,16369,3081,200
492105970,492103697,492120382,16685,3082,200
492127004,492124515,492141416,16901,3083,200
492147916,492145643,492162328,16685,3084,200
492168950,492166461,492183680,17219,3085,200
492190303,492187813,492203134,15321,3086,200
492209613,492207341,492224025,16684,3087,200
492230648,492228158,492243140,14982,3088,200
492249761,492247272,492264173,16901,3089,200
492270795,492268306,492284237,15931,3090,200
492290810,492288537,492304590,16053,3091,200
492311101,492308829,492326483,17654,3092,200
492333068,492330795,492347797,17002,3093,200
492354420,492351930,492367250,15320,3094,200
492373872,492371382,492388284,16902,3095,200
492394819,492392546,492408599,16053,3096,200
492415222,492412732,492431239,18507,3097,200
492437738,492435465,492452151,16686,3098,200
492458655,492456381,492470852,14471,3099,200
492477473,492474984,492491570,16586,3100,200
492498147,492495872,492513848,17976,3101,200
492520315,492518042,492535383,17341,3102,200
492542006,492539516,492557389,17873,3103,200
492564011,492561522,492577475,15953,3104,200
492583937,492581664,492598033,16369,3105,200
492604656,492602166,492618099,15933,3106,200
492624671,492622398,492638767,16369,3107,200
492645267,492642994,492658708,15714,3108,200
492665198,492662926,492680560,17634,3109,200
492687133,492684861,492702834,17973,3110,200
492709396,492707122,492722205,15083,3111,200
492728828,492726338,492741342,15004,3112,200
492747849,492745577,492760341,14764,3113,200
492766963,492764473,492779793,15320,3114,200
492786415,492783925,492800533,16608,3115,200
492807069,492804796,492820216,15420,3116,200
492826838,492824348,492840934,16586,3117,200
492847556,492845067,492860049,14982,3118,200
492866570,492864297,492880350,16053,3119,200
492886840,492884567,492901568,17001,3120,200
492908062,492905790,492922813,17023,3121,200
492929436,492926946,492942899,15953,3122,200
492949521,492947031,492965222,18191,3123,200
492971804,492969531,492987820,18289,3124,200
492994276,492992004,493008371,16367,3125,200
493014944,493012671,493030329,17658,3126,200
493036952,493034462,493050415,15953,3127,200
493056904,493054630,493070347,15717,3128,200
493076969,493074479,493091383,16904,3129,200
493097911,493095638,493111691,16053,3130,200
493118262,493115989,493132064,16075,3131,200
493138582,493136308,493154916,18608,3132,200
493161539,493159049,493175024,15975,3133,200
493181646,493179156,493197030,17874,3134,200
493203653,493201163,493218065,16902,3135,200
493224688,493222198,493240072,17874,3136,200
493246555,493244282,493260967,16685,3137,200
493267475,493265201,493282204,17003,3138,200
493288778,493286505,493302262,15757,3139,200
493308884,493306394,493322009,15615,3140,200
493328630,493326141,493341755,15614,3141,200
493348237,493345964,493362018,16054,3142,200
493368504,493366231,493382622,16391,3143,200
493389245,493386755,493404630,17875,3144,200
493411252,493408763,493427269,18506,3145,200
493433891,493431402,493448938,17536,3146,200
493455561,493453071,493470629,17558,3147,200
493477252,493474762,493492320,17558,3148,200
493498943,493496453,493513356,16903,3149,200
493519845,493517572,493534257,16685,3150,200
493540721,493538448,493556737,18289,3151,200
493563190,493560918,493577603,16685,3152,200
493584108,493581835,493599807,17972,3153,200
493606429,493603939,493622446,18507,3154,200
493629067,493626578,493642847,16269,3155,200
493649376,493647103,493662185,15082,3156,200
493668665,493666392,493680546,14154,3157,200
493687167,493684678,493702234,17556,3158,200
493708689,493706416,493721520,15104,3159,200
493728050,493725777,493742779,17002,3160,200
493749402,493746912,493763520,16608,3161,200
493770142,493767653,493782318,14665,3162,200
493788941,493786450,493802087,15637,3163,200
493808708,493806219,493822149,15930,3164,200
493828772,493826281,493841580,15299,3165,200
493848202,493845712,493863269,17557,3166,200
493869851,493867578,493885233,17655,3167,200
493891855,493889366,493907239,17873,3168,200
493913862,493911372,493927641,16269,3169,200
493934264,493931774,493948994,17220,3170,200
493955506,493953233,493968652,15419,3171,200
493975273,493972784,493990637,17853,3172,200
493997127,493994854,494011224,16370,3173,200
494017737,494015464,494029913,14449,3174,200
494036428,494034155,494048603,14448,3175,200
494055225,494052735,494069638,16903,3176,200
494076174,494073900,494088983,15083,3177,200
494095486,494093213,494108927,15714,3178,200
494115427,494113155,494127919,14764,3179,200
494134420,494132147,494150121,17974,3180,200
494156744,494154254,494171812,17558,3181,200
494178336,494176064,494191779,15715,3182,200
494198402,494195911,494212816,16905,3183,200
494219270,494216998,494231467,14469,3184,200
494238089,494235599,494249970,14371,3185,200
494256476,494254202,494269918,15716,3186,200
494276540,494274050,494290637,16587,3187,200
494297259,494294770,494310385,15615,3188,200
494316918,494314645,494330064,15419,3189,200
494336685,494334196,494349199,15003,3190,200
494355821,494353331,494369939,16608,3191,200
494376428,494374154,494390546,16392,3192,200
494397001,494394728,494410464,15736,3193,200
494417085,494414596,494429599,15003,3194,200
494436064,494433790,494451763,17973,3195,200
494458243,494455970,494471391,15421,3196,200
494477883,494475610,494491346,15736,3197,200
494497967,494495478,494512697,17219,3198,200
494519152,494516880,494533565,16685,3199,200
494540188,494537698,494555235,17537,3200,200
494561728,494559454,494575213,15759,3201,200
494581721,494579449,494594531,15082,3202,200
494601049,494598776,494614511,15735,3203,200
494621132,494618643,494633646,15003,3204,200
494640268,494637778,494654364,16586,3205,200
494660987,494658497,494675420,16923,3206,200
494681942,494679669,494696039,16370,3207,200
494702661,494700172,494717074,16902,3208,200
494723638,494721365,494738367,17002,3209,200
494744989,494742499,494758768,16269,3210,200
494765390,494762901,494778537,15636,3211,200
494785160,494782670,494801176,18506,3212,200
494807670,494805397,494821766,16369,3213,200
494828388,494825898,494842166,16268,3214,200
494848788,494846298,494862252,15954,3215,200
494868774,494866501,494883525,17024,3216,200
494890018,494887745,494902849,15104,3217,200
494909304,494907030,494921797,14767,3218,200
494928418,494925929,494944434,18505,3219,200
494951057,494948567,494966420,17853,3220,200
494972926,494970654,494985418,14764,3221,200
494992040,494989550,495006453,16903,3222,200
495012959,495010686,495026402,15716,3223,200
495032976,495030703,495046102,15399,3224,200
495052723,495050234,495065870,15636,3225,200
495072492,495070002,495086251,16249,3226,200
495092874,495090384,495106338,15954,3227,200
495112960,495110470,495125769,15299,3228,200
495132391,495129901,495145221,15320,3229,200
495151842,495149353,495165938,16585,3230,200
495172419,495170146,495187148,17002,3231,200
495193637,495191364,495206466,15102,3232,200
495213043,495210771,495229061,18290,3233,200
495235562,495233290,495250291,17001,3234,200
495256777,495254504,495271823,17319,3235,200
495278290,495276017,495293021,17004,3236,200
495299644,495297154,495314058,16904,3237,200
495320516,495318242,495334297,16055,3238,200
495340921,495338430,495353751,15321,3239,200
495360242,495357969,495374022,16053,3240,200
495380645,495378155,495395375,17220,3241,200
495401962,495399688,495416376,16688,3242,200
495422998,495420509,495435491,14982,3243,200
495442075,495439802,495457121,17319,3244,200
495463639,495461366,495477398,16032,3245,200
495484021,495481531,495497148,15617,3246,200
495503629,495501355,495517430,16075,3247,200
495524052,495521563,495539752,18189,3248,200
495546284,495544011,495560380,16369,3249,200
495567002,495564513,495582387,17874,3250,200
495588841,495586568,495601967,15399,3251,200
495608532,495606259,495623262,17003,3252,200
495629768,495627495,495643864,16369,3253,200
495650486,495647997,495664583,16586,3254,200
495671206,495668716,495684037,15321,3255,200
495690531,495688257,495705260,17003,3256,200
495711883,495709393,495725980,16587,3257,200
495732443,495730169,495744935,14766,3258,200
495751556,495749067,495764999,15932,3259,200
495771500,495769228,495785301,16073,3260,200
495791887,495789614,495805983,16369,3261,200
495812475,495810203,495825938,15735,3262,200
495832560,495830070,495846318,16248,3263,200
495852806,495850533,495865299,14766,3264,200
495871921,495869431,495885702,16271,3265,200
495892204,495889931,495906301,16370,3266,200
495912813,495910540,495927543,17003,3267,200
495934166,495931676,495949549,17873,3268,200
495956047,495953774,495971747,17973,3269,200
495978369,495975880,495992781,16901,3270,200
495999240,495996967,496013337,16370,3271,200
496019866,496017593,496033646,16053,3272,200
496040271,496037779,496056288,18509,3273,200
496062819,496060546,496077548,17002,3274,200
496084171,496081681,496097655,15974,3275,200
496104277,496101787,496119028,17241,3276,200
496125531,496123258,496139628,16370,3277,200
496146252,496143761,496161953,18192,3278,200
496168576,496166086,496182061,15975,3279,200
496188565,496186292,496203950,17658,3280,200
496210573,496208083,496223087,15004,3281,200
496229709,496227219,496245094,17875,3282,200
496251623,496249350,496266352,17002,3283,200
496272975,496270485,496286437,15952,3284,200
496292944,496290671,496307039,16368,3285,200
496313526,496311252,496326990,15738,3286,200
496333459,496331185,496347261,16076,3287,200
496353883,496351394,496367325,15931,3288,200
496373890,496371616,496386087,14471,3289,200
496392664,496390392,496405157,14765,3290,200
496411685,496409412,496424812,15400,3291,200
496431380,496429108,496444843,15735,3292,200
496451466,496448975,496464274,15299,3293,200
496470836,496468563,496484617,16054,3294,200
496491203,496488930,496504666,15736,3295,200
496511152,496508878,496524279,15401,3296,200
496530901,496528411,496546284,17873,3297,200
496552907,496550417,496566350,15933,3298,200
496572886,496570613,496587616,17003,3299,200
496594205,496591931,496608302,16371,3300,200
496614925,496612435,496630625,18190,3301,200
496637247,496634758,496652631,17873,3302,200
496659253,496656764,496673665,16901,3303,200
496680288,496677798,496694067,16269,3304,200
496700572,496698298,496714669,16371,3305,200
496721147,496718874,496733027,14153,3306,200
496739649,496737159,496755011,17852,3307,200
496761633,496759144,496775412,16268,3308,200
496782035,496779545,496795520,15975,3309,200
496802142,496799652,496817842,18190,3310,200
496824327,496822055,496838740,16685,3311,200
496845363,496842873,496857854,14981,3312,200
496864430,496862157,496878842,16685,3313,200
496885368,496883095,496899147,16052,3314,200
496905770,496903280,496917649,14369,3315,200
496924270,496921781,496939316,17535,3316,200
496945939,496943449,496959719,16270,3317,200
496966249,496963976,496979691,15715,3318,200
496986313,496983823,496999440,15617,3319,200
497006062,497003572,497019526,15954,3320,200
497026149,497023658,497041196,17538,3321,200
497047819,497045329,497062886,17557,3322,200
497069393,497067119,497082202,15083,3323,200
497088824,497086334,497101971,15637,3324,200
497108428,497106155,497122842,16687,3325,200
497129465,497126975,497143266,16291,3326,200
497149888,497147399,497162717,15318,3327,200
497169338,497166849,497184067,17218,3328,200
497190689,497188200,497204784,16584,3329,200
497211407,497208917,497225187,16270,3330,200
497231686,497229414,497245485,16071,3331,200
497252069,497249796,497264879,15083,3332,200
497271501,497269011,497286231,17220,3333,200
497292854,497290364,497308554,18190,3334,200
497315177,497312687,497329273,16586,3335,200
497335778,497333505,497349896,16391,3336,200
497356520,497354029,497369983,15954,3337,200
497376435,497374162,497389560,15398,3338,200
497396095,497393822,497408925,15103,3339,200
497415547,497413058,497430593,17535,3340,200
497437215,497434726,497450362,15636,3341,200
497456985,497454495,497469816,15321,3342,200
497476438,497473948,497491821,17873,3343,200
497498346,497496072,497510227,14155,3344,200
497516848,497514359,497529974,15615,3345,200
497536559,497534286,497550655,16369,3346,200
497557150,497554877,497571247,16370,3347,200
497577730,497575458,497593431,17973,3348,200
497600014,497597742,497612506,14764,3349,200
497619071,497616798,497631585,14787,3350,200
497638120,497635847,497653166,17319,3351,200
497659788,497657299,497673569,16270,3352,200
497680025,497677752,497692834,15082,3353,200
497699456,497696966,497714819,17853,3354,200
497721345,497719072,497737046,17974,3355,200
497743547,497741274,497757326,16052,3356,200
497763949,497761459,497778046,16587,3357,200
497784668,497782179,497798111,15932,3358,200
497804732,497802243,497817859,15616,3359,200
497824385,497822112,497839137,17025,3360,200
497845620,497843348,497858767,15419,3361,200
497865389,497862899,497877270,14371,3362,200
497883803,497881530,497898216,16686,3363,200
497904670,497902396,497918767,16371,3364,200
497925389,497922900,497939803,16903,3365,200
497946426,497943936,497959257,15321,3366,200
497965878,497963389,497979005,15616,3367,200
497985520,497983247,498000587,17340,3368,200
498007210,498004720,498020990,16270,3369,200
498027511,498025238,498042578,17340,3370,200
498049101,498046827,498063831,17004,3371,200
498070354,498068081,498085400,17319,3372,200
498092023,498089533,498105170,15637,3373,200
498111695,498109421,498126762,17341,3374,200
498133385,498130895,498147797,16902,3375,200
498154420,498151930,498168199,16269,3376,200
498174667,498172394,498188110,15716,3377,200
498194692,498192420,498206889,14469,3378,200
498213511,498211021,498226657,15636,3379,200
498233146,498230872,498248509,17637,3380,200
498255132,498252642,498268596,15954,3381,200
498275096,498272823,498290143,17320,3382,200
498296766,498294276,498313098,18822,3383,200
498319667,498317393,498333762,16369,3384,200
498340384,498337895,498353194,15299,3385,200
498359759,498357487,498373856,16369,3386,200
498380357,498378084,498393821,15737,3387,200
498400443,498397953,498415172,17219,3388,200
498421632,498419359,498436045,16686,3389,200
498442568,498440294,498456053,15759,3390,200
498462674,498460185,498474871,14686,3391,200
498481492,498479003,498494617,15614,3392,200
498501206,498498933,498515936,17003,3393,200
498522517,498520244,498534398,14154,3394,200
498540866,498538592,498554013,15421,3395,200
498560634,498558145,498573780,15635,3396,200
498580402,498577912,498596419,18507,3397,200
498603042,498600552,498617455,16903,3398,200
498624078,498621588,498636254,14666,3399,200
498642814,498640540,498656278,15738,3400,200
498662901,498660410,498676998,16588,3401,200
498683450,498681178,498697209,16031,3402,200
498703832,498701342,498718878,17536,3403,200
498725327,498723055,498741344,18289,3404,200
498747966,498745477,498762696,17219,3405,200
498769149,498766877,498782612,15735,3406,200
498789095,498786822,498802853,16031,3407,200
498809476,498806986,498824860,17874,3408,200
498831382,498829109,498846111,17002,3409,200
498852733,498850244,498866196,15952,3410,200
498872650,498870376,498886746,16370,3411,200
498893369,498890879,498905861,14982,3412,200
498912482,498909993,498926895,16902,3413,200
498933518,498931028,498946645,15617,3414,200
498953098,498950826,498967195,16369,3415,200
498973769,498971495,498987211,15716,3416,200
498993721,498991449,499008450,17001,3417,200
499014972,499012699,499029068,16369,3418,200
499035691,499033201,499050758,17557,3419,200
499057381,499054891,499072765,17874,3420,200
499079263,499076990,499093043,16053,3421,200
499099496,499097223,499113593,16370,3422,200
499120087,499117814,499133235,15421,3423,200
499139755,499137482,499151932,14450,3424,200
499158518,499156244,499172615,16371,3425,200
499179067,499176794,499192868,16074,3426,200
499199350,499197077,499213764,16687,3427,200
499220387,499217897,499232268,14371,3428,200
499238890,499236400,499254591,18191,3429,200
499261213,499258724,499276598,17874,3430,200
499283221,499280731,499296050,15319,3431,200
499302618,499300344,499318634,18290,3432,200
499325257,499322767,499341274,18507,3433,200
499347782,499345509,499363166,17657,3434,200
499369752,499367478,499384798,17320,3435,200
499391421,499388931,499406488,17557,3436,200
499413111,499410621,499427524,16903,3437,200
499434147,499431657,499448243,16586,3438,200
499454865,499452376,499469617,17241,3439,200
499476241,499473750,499488438,14688,3440,200
499494937,499492664,499509033,16369,3441,200
499515657,499513166,499530703,17537,3442,200
499537325,499534836,499551422,16586,3443,200
499558045,499555555,499571508,15953,3444,200
499578129,499575640,499590305,14665,3445,200
499596789,499594516,499609619,15103,3446,200
499616074,499613801,499628882,15081,3447,200
499635503,499633014,499648312,15298,3448,200
499654872,499652600,499668969,16369,3449,200
499675462,499673188,499688607,15419,3450,200
499695125,499692851,499707617,14766,3451,200
499714189,499711916,499727630,15714,3452,200
499734252,499731762,499747716,15954,3453,200
499754224,499751949,499769923,17974,3454,200
499776546,499774056,499789672,15616,3455,200
499796294,499793804,499811361,17557,3456,200
499817885,499815612,499833270,17658,3457,200
499839893,499837403,499855910,18507,3458,200
499862533,499860043,499877895,17852,3459,200
499884382,499882109,499899427,17318,3460,200
499906015,499903742,499922032,18290,3461,200
499928654,499926165,499943383,17218,3462,200
499950005,499947516,499962815,15299,3463,200
499969437,499966947,499985137,18190,3464,200
499991600,499989327,500004748,15421,3465,200
500011204,500008931,500024964,16033,3466,200
500031587,500029097,500045051,15954,3467,200
500051551,500049278,500066280,17002,3468,200
500072903,500070413,500087633,17220,3469,200
500094257,500091766,500109006,17240,3470,200
500115629,500113139,500128755,15616,3471,200
500135331,500133057,500151009,17952,3472,200
500157632,500155142,500172045,16903,3473,200
500178667,500176178,500192763,16585,3474,200
500199384,500196896,500211264,14368,3475,200
500217886,500215396,500231033,15637,3476,200
500237535,500235262,500251949,16687,3477,200
500258572,500256082,500272985,16903,3478,200
500279607,500277118,500293724,16606,3479,200
500300240,500297968,500313703,15735,3480,200
500320278,500318005,500334692,16687,3481,200
500341314,500338825,500356044,17219,3482,200
500362564,500360291,500376977,16686,3483,200
500383601,500381110,500395778,14668,3484,200
500402305,500400031,500415431,15400,3485,200
500422054,500419563,500437438,17875,3486,200
500443938,500441665,500459322,17657,3487,200
500465946,500463455,500481310,17855,3488,200
500487835,500485562,500501931,16369,3489,200
500508488,500506216,500523217,17001,3490,200
500529725,500527452,500545743,18291,3491,200
500552224,500549951,500567290,17339,3492,200
500573913,500571423,500586744,15321,3493,200
500593367,500590877,500607780,16903,3494,200
500614285,500612012,500629015,17003,3495,200
500635638,500633148,500649419,16271,3496,200
500655874,500653602,500669971,16369,3497,200
500676457,500674183,500689921,15738,3498,200
500696543,500694053,500712244,18191,3499,200
500718713,500716440,500732494,16054,3500,200
500739117,500736627,500754185,17558,3501,200
500760808,500758318,500776509,18191,3502,200
500783007,500780734,500795816,15082,3503,200
500802439,500799949,500817190,17241,3504,200
500823646,500821374,500836794,15420,3505,200
500843364,500841091,500856827,15736,3506,200
500863449,500860959,500876892,15933,3507,200
500883514,500881024,500897274,16250,3508,200
500903897,500901407,500917340,15933,3509,200
500923962,500921473,500938692,17219,3510,200
500945279,500943006,500960958,17952,3511,200
500967581,500965091,500980729,15638,3512,200
500987351,500984861,501003030,18169,3513,200
501009532,501007259,501024261,17002,3514,200
501030884,501028394,501044981,16587,3515,200
501051507,501049235,501064970,15735,3516,200
501071591,501069102,501086657,17555,3517,200
501093226,501090953,501109242,18289,3518,200
501115864,501113375,501131564,18189,3519,200
501138050,501135777,501154384,18607,3520,200
501161007,501158517,501175104,16587,3521,200
501181669,501179394,501194183,14789,3522,200
501200804,501198315,501214287,15972,3523,200
501220788,501218515,501235855,17340,3524,200
501242335,501240062,501257697,17635,3525,200
501264197,501261924,501279875,17951,3526,200
501286438,501284165,501302139,17974,3527,200
501308699,501306426,501322796,16370,3528,200
501329285,501327012,501341778,14766,3529,200
501348401,501345911,501360598,14687,3530,200
501367219,501364730,501383237,18507,3531,200
501389859,501387370,501403302,15932,3532,200
501409924,501407434,501424654,17220,3533,200
501431213,501428940,501446577,17637,3534,200
501453199,501450710,501467928,17218,3535,200
501474382,501472109,501489449,17340,3536,200
501495943,501493671,501511623,17952,3537,200
501518246,501515756,501531075,15319,3538,200
501537698,501535208,501551478,16270,3539,200
501558101,501555611,501572514,16903,3540,200
501579007,501576734,501596122,19388,3541,200
501602745,501600255,501616547,16292,3542,200
501623170,501620680,501637900,17220,3543,200
501644522,501642033,501657331,15298,3544,200
501663856,501661583,501676033,14450,3545,200
501682655,501680166,501695782,15616,3546,200
501702290,501700016,501717335,17319,3547,200
501723957,501721468,501737737,16269,3548,200
501744360,501741870,501759723,17853,3549,200
501766219,501763946,501780315,16369,3550,200
501786835,501784562,501799961,15399,3551,200
501806582,501804093,501822916,18823,3552,200
501829419,501827145,501841596,14451,3553,200
501848104,501845830,501862221,16391,3554,200
501868705,501866432,501884385,17953,3555,200
501890969,501888696,501906016,17320,3556,200
501912639,501910149,501927369,17220,3557,200
501933877,501931605,501947656,16051,3558,200
501954183,501951909,501968912,17003,3559,200
501975440,501973167,501990168,17001,3560,200
501996637,501994363,502012338,17975,3561,200
502018844,502016571,502031674,15103,3562,200
502038297,502035806,502052077,16271,3563,200
502058699,502056210,502072479,16269,3564,200
502079102,502076612,502093198,16586,3565,200
502099661,502097387,502112491,15104,3566,200
502119113,502116623,502131944,15321,3567,200
502138566,502136076,502152684,16608,3568,200
502159306,502156817,502174036,17219,3569,200
502180659,502178169,502195409,17240,3570,200
502202032,502199542,502214524,14982,3571,200
502221090,502218817,502234870,16053,3572,200
502241376,502239103,502255155,16052,3573,200
502261778,502259288,502276507,17219,3574,200
502283022,502280749,502295853,15104,3575,200
502302476,502299986,502317543,17557,3576,200
502324054,502321781,502337539,15758,3577,200
502344055,502341783,502358805,17022,3578,200
502365376,502363103,502381392,18289,3579,200
502388014,502385525,502402425,16900,3580,200
502409047,502406558,502421877,15319,3581,200
502428443,502426171,502442243,16072,3582,200
502448805,502446532,502462585,16053,3583,200
502469208,502466718,502484591,17873,3584,200
502491057,502488784,502507074,18290,3585,200
502513697,502511207,502527477,16270,3586,200
502533941,502531668,502546750,15082,3587,200
502553372,502550882,502567784,16902,3588,200
502574278,502572005,502587403,15398,3589,200
502594024,502591535,502607784,16249,3590,200
502614372,502612099,502628468,16369,3591,200
502635090,502632601,502649504,16903,3592,200
502656126,502653637,502670223,16586,3593,200
502676679,502674406,502691408,17002,3594,200
502698031,502695541,502711176,15635,3595,200
502717799,502715309,502733161,17852,3596,200
502739693,502737420,502754106,16686,3597,200
502760728,502758239,502774191,15952,3598,200
502780670,502778398,502794113,15715,3599,200
502800733,502798245,502815145,16900,3600,200
502821767,502819278,502836181,16903,3601,200
502842763,502840490,502854939,14449,3602,200
502861560,502859071,502875974,16903,3603,200
502882597,502880107,502898298,18191,3604,200
502904920,502902431,502919987,17556,3605,200
502926609,502924120,502938805,14685,3606,200
502945309,502943035,502960693,17658,3607,200
502967201,502964927,502981614,16687,3608,200
502988069,502985796,503003453,17657,3609,200
503009939,503007667,503025640,17973,3610,200
503032263,503029773,503048280,18507,3611,200
503054902,503052413,503067731,15318,3612,200
503074255,503071983,503087719,15736,3613,200
503094341,503091851,503110674,18823,3614,200
503117131,503114858,503129939,15081,3615,200
503136562,503134072,503150680,16608,3616,200
503157252,503154980,503170715,15735,3617,200
503177207,503174934,503191959,17025,3618,200
503198545,503196272,503214245,17973,3619,200
503220867,503218378,503234963,16585,3620,200
503241424,503239151,503254254,15103,3621,200
503260786,503258513,503275517,17004,3622,200
503282108,503279835,503296541,16706,3623,200
503303040,503300766,503317475,16709,3624,200
503323983,503321710,503339367,17657,3625,200
503345988,503343499,503360401,16902,3626,200
503366871,503364598,503379048,14450,3627,200
503385670,503383180,503399112,15932,3628,200
503405641,503403369,503420370,17001,3629,200
503426993,503424503,503440772,16269,3630,200
503447396,503444905,503461810,16905,3631,200
503468434,503465943,503482531,16588,3632,200
503489099,503486826,503504483,17657,3633,200
503511105,503508616,503524886,16270,3634,200
503531337,503529064,503545117,16053,3635,200
503551621,503549348,503565083,15735,3636,200
503571562,503569289,503585343,16054,3637,200
503591966,503589476,503605746,16270,3638,200
503612369,503609879,503625178,15299,3639,200
503631637,503629365,503646071,16706,3640,200
503652694,503650204,503666474,16270,3641,200
503673097,503670607,503685610,15003,3642,200
503692146,503689872,503706242,16370,3643,200
503712746,503710474,503726843,16369,3644,200
503733308,503731036,503745800,14764,3645,200
503752422,503749932,503765568,15636,3646,200
503772150,503769877,503787534,17657,3647,200
503794157,503791667,503806967,15300,3648,200
503813458,503811185,503827555,16370,3649,200
503834120,503831847,503849188,17341,3650,200
503855652,503853380,503869116,15736,3651,200
503875646,503873373,503888791,15418,3652,200
503895359,503893086,503909794,16708,3653,200
503916417,503913927,503931168,17241,3654,200
503937674,503935402,503953692,18290,3655,200
503960315,503957825,503975065,17240,3656,200
503981688,503979198,503997071,17873,3657,200
504003576,504001303,504018326,17023,3658,200
504024832,504022558,504037642,15084,3659,200
504044151,504041879,504058269,16390,3660,200
504064891,504062401,504079938,17537,3661,200
504086560,504084071,504102576,18505,3662,200
504109141,504106868,504122584,15716,3663,200
504129205,504126716,504142985,16269,3664,200
504149447,504147174,504162593,15419,3665,200
504169098,504166824,504184482,17658,3666,200
504191105,504188615,504203913,15298,3667,200
504210497,504208224,504223306,15082,3668,200
504229928,504227438,504244340,16902,3669,200
504250963,504248473,504266030,17557,3670,200
504272522,504270249,504285352,15103,3671,200
504291851,504289578,504306602,17024,3672,200
504313226,504310735,504328272,17537,3673,200
504334895,504332405,504349625,17220,3674,200
504356130,504353857,504368009,14152,3675,200
504374464,504372191,504388264,16073,3676,200
504394886,504392397,504408982,16585,3677,200
504415473,504413199,504428303,15104,3678,200
504434799,504432526,504449867,17341,3679,200
504456490,504454000,504471219,17219,3680,200
504477725,504475451,504491822,16371,3681,200
504498445,504495955,504512205,16250,3682,200
504518827,504516338,504533895,17557,3683,200
504540409,504538136,504556089,17953,3684,200
504562713,504560222,504577760,17538,3685,200
504584241,504581968,504599624,17656,3686,200
504606135,504603862,504620886,17024,3687,200
504627457,504625183,504642187,17004,3688,200
504648645,504646372,504663691,17319,3689,200
504670314,504667824,504682512,14688,3690,200
504689134,504686644,504704180,17536,3691,200
504710644,504708370,504724446,16076,3692,200
504730909,504728637,504746294,17657,3693,200
504752916,504750427,504767963,17536,3694,200
504774540,504772266,504789270,17004,3695,200
504795735,504793462,504812069,18607,3696,200
504818691,504816202,504832472,16270,3697,200
504838937,504836664,504853984,17320,3698,200
504860607,504858117,504875337,17220,3699,200
504881867,504879595,504895645,16050,3700,200
504902126,504899853,504918144,18291,3701,200
504924767,504922277,504939813,17536,3702,200
504946436,504943946,504959266,15320,3703,200
504965888,504963398,504978402,15004,3704,200
504984870,504982597,504999283,16686,3705,200
505005906,505003416,505020635,17219,3706,200
505027258,505024768,505039749,14981,3707,200
505046370,505043881,505061100,17219,3708,200
505067553,505065280,505083254,17974,3709,200
505089877,505087386,505104289,16903,3710,200
505110912,505108422,505124692,16270,3711,200
505131275,505129001,505143768,14767,3712,200
505150276,505148003,505164077,16074,3713,200
505170538,505168264,505184634,16370,3714,200
505191256,505188767,505204698,15931,3715,200
505211319,505208830,505224128,15298,3716,200
505230750,505228260,505245183,16923,3717,200
505251643,505249369,505263524,14155,3718,200
505269993,505267719,505286011,18292,3719,200
505292633,505290144,505307363,17219,3720,200
505313985,505311496,505328399,16903,3721,200
505335022,505332532,505349119,16587,3722,200
505355741,505353252,505369521,16269,3723,200
505376025,505373752,505390436,16684,3724,200
505397059,505394569,505411789,17220,3725,200
505418297,505416023,505431127,15104,3726,200
505437749,505435260,505452795,17535,3727,200
505459418,505456928,505474781,17853,3728,200
505481281,505479009,505496348,17339,3729,200
505502881,505500608,505516661,16053,3730,200
505523144,505520870,505535024,14154,3731,200
505541646,505539157,505556081,16924,3732,200
505562704,505560214,505575535,15321,3733,200
505582052,505579779,505595812,16033,3734,200
505602434,505599945,505617500,17555,3735,200
505624083,505621810,505637864,16054,3736,200
505644326,505642053,505657135,15082,3737,200
505663756,505661267,505679140,17873,3738,200
505685763,505683273,505699860,16587,3739,200
505706483,505703993,505721550,17557,3740,200
505728130,505725857,505741910,16053,3741,200
505748498,505746225,505762256,16031,3742,200
505768878,505766389,505783291,16902,3743,200
505789786,505787513,505802596,15083,3744,200
505809218,505806729,505822365,15636,3745,200
505828831,505826558,505841007,14449,3746,200
505847533,505845261,505861313,16052,3747,200
505867849,505865576,505882917,17341,3748,200
505889502,505887230,505903598,16368,3749,200
505910171,505907898,505923635,15737,3750,200
505930257,505927767,505943088,15321,3751,200
505949538,505947265,505962981,15716,3752,200
505969603,505967113,505982750,15637,3753,200
505989274,505987001,506003392,16391,3754,200
506010015,506007525,506022527,15002,3755,200
506029148,506026659,506043244,16585,3756,200
506049867,506047377,506063964,16587,3757,200
506070587,506068097,506085021,16924,3758,200
506091644,506089154,506105423,16269,3759,200
506112046,506109556,506128064,18508,3760,200
506134687,506132197,506148468,16271,3761,200
506155090,506152601,506166970,14369,3762,200
506173471,506171198,506186301,15103,3763,200
506192923,506190433,506206703,16270,3764,200
506213326,506210836,506229026,18190,3765,200
506235498,506233224,506248329,15105,3766,200
506254952,506252462,506268437,15975,3767,200
506275058,506272569,506289154,16585,3768,200
506295778,506293287,506309558,16271,3769,200
506316066,506313793,506330163,16370,3770,200
506336679,506334407,506350460,16053,3771,200
506356982,506354709,506369812,15103,3772,200
506376434,506373945,506390213,16268,3773,200
506396836,506394346,506410319,15973,3774,200
506416941,506414451,506432323,17872,3775,200
506438789,506436516,506452591,16075,3776,200
506459214,506456724,506474577,17853,3777,200
506481139,506478866,506494603,15737,3778,200
506501225,506498735,506514371,15636,3779,200
506520876,506518604,506534317,15713,3780,200
506540938,506538449,506556639,18190,3781,200
506563155,506560882,506576301,15419,3782,200
506582923,506580433,506596069,15636,3783,200
506602692,506600201,506617443,17242,3784,200
506623907,506621634,506637666,16032,3785,200
506644117,506641843,506657265,15422,3786,200
506663886,506661397,506678616,17219,3787,200
506685239,506682749,506700939,18190,3788,200
506707562,506705072,506721975,16903,3789,200
506728487,506726213,506742247,16034,3790,200
506748716,506746443,506763445,17002,3791,200
506770029,506767756,506783493,15737,3792,200
506790021,506787748,506804118,16370,3793,200
506810624,506808350,506824721,16371,3794,200
506831344,506828854,506845102,16248,3795,200
506851725,506849235,506864534,15299,3796,200
506871156,506868667,506887173,18506,3797,200
506893678,506891405,506907140,15735,3798,200
506913762,506911272,506928492,17220,3799,200
506934999,506932726,506949096,16370,3800,200
506955719,506953229,506969500,16271,3801,200
506976079,506973806,506990175,16369,3802,200
506996797,506994308,507011210,16902,3803,200
507017834,507015343,507031275,15932,3804,200
507037896,507035407,507052331,16924,3805,200
507058815,507056542,507074515,17973,3806,200
507081009,507078736,507095760,17024,3807,200
507102382,507099893,507118083,18190,3808,200
507124707,507122216,507138486,16270,3809,200
507145109,507142619,507158890,16271,3810,200
507165512,507163023,507178996,15973,3811,200
507185465,507183191,507198613,15422,3812,200
507205105,507202832,507219855,17023,3813,200
507226478,507223988,507240257,16269,3814,200
507246880,507244390,507260028,15638,3815,200
507266649,507264160,507280112,15952,3816,200
507286601,507284328,507300381,16053,3817,200
507307003,507304514,507320149,15635,3818,200
507326771,507324281,507342450,18169,3819,200
507349073,507346583,507362536,15953,3820,200
507369005,507366732,507382764,16032,3821,200
507389386,507386897,507404115,17218,3822,200
507410737,507408248,507425467,17219,3823,200
507432032,507429758,507448049,18291,3824,200
507454509,507452236,507468626,16390,3825,200
507475093,507472819,507488872,16053,3826,200
507495456,507493184,507511157,17973,3827,200
507517667,507515393,507532734,17341,3828,200
507539357,507536867,507553452,16585,3829,200
507559912,507557640,507574345,16705,3830,200
507580967,507578478,507597301,18823,3831,200
507603924,507601434,507617366,15932,3832,200
507623988,507621498,507636819,15321,3833,200
507643442,507640952,507658171,17219,3834,200
507664794,507662304,507677308,15004,3835,200
507683932,507681441,507698028,16587,3836,200
507704521,507702247,507719588,17341,3837,200
507726211,507723721,507739652,15931,3838,200
507746188,507743914,507760601,16687,3839,200
507767121,507764849,507779317,14468,3840,200
507785938,507783450,507799063,15613,3841,200
507805644,507803371,507821007,17636,3842,200
507827630,507825140,507841727,16587,3843,200
507848300,507846027,507862059,16032,3844,200
507868681,507866192,507882777,16585,3845,200
507889401,507886911,507904131,17220,3846,200
507910754,507908264,507925166,16902,3847,200
507931789,507929299,507944620,15321,3848,200
507951241,507948752,507966604,17852,3849,200
507973083,507970811,507989101,18290,3850,200
507995626,507993353,508007507,14154,3851,200
508014129,508011639,508028542,16903,3852,200
508035002,508032729,508050070,17341,3853,200
508056645,508054372,508071056,16684,3854,200
508077540,508075266,508091637,16371,3855,200
508098260,508095770,508111070,15300,3856,200
508117691,508115202,508130817,15615,3857,200
508137438,508134949,508151555,16606,3858,200
508158178,508155688,508171937,16249,3859,200
508178559,508176069,508194892,18823,3860,200
508201516,508199025,508213714,14689,3861,200
508220335,508217846,508235064,17218,3862,200
508241564,508239291,508256611,17320,3863,200
508263233,508260744,508276993,16249,3864,200
508283486,508281213,508296294,15081,3865,200
508302813,508300539,508316910,16371,3866,200
508323533,508321043,508336364,15321,3867,200
508342985,508340496,508358369,17873,3868,200
508364992,508362502,508379742,17240,3869,200
508386227,508383954,508401273,17319,3870,200
508407896,508405406,508422962,17556,3871,200
508429552,508427278,508443333,16055,3872,200
508449913,508447640,508463038,15398,3873,200
508469660,508467170,508484389,17219,3874,200
508490897,508488625,508504656,16031,3875,200
508511278,508508789,508527294,18505,3876,200
508533783,508531510,508547246,15736,3877,200
508553868,508551378,508569232,17854,3878,200
508575855,508573365,508591872,18507,3879,200
508598353,508596080,508614033,17953,3880,200
508620656,508618166,508634099,15933,3881,200
508640722,508638231,508655450,17219,3882,200
508661952,508659679,508675099,15420,3883,200
508681620,508679346,508693817,14471,3884,200
508700283,508698010,508714042,16032,3885,200
508720665,508718175,508734446,16271,3886,200
508741068,508738579,508754193,15614,3887,200
508760647,508758373,508776347,17974,3888,200
508782853,508780580,508796929,16349,3889,200
508803551,508801062,508817330,16268,3890,200
508823863,508821590,508839247,17657,3891,200
508845870,508843380,508860916,17536,3892,200
508867538,508865049,508880348,15299,3893,200
508886970,508884480,508901066,16586,3894,200
508907524,508905251,508920037,14786,3895,200
508926657,508924169,508939150,14981,3896,200
508945680,508943407,508960113,16706,3897,200
508966564,508964291,508980638,16347,3898,200
508987260,508984771,509000091,15320,3899,200
509006713,509004223,509020492,16269,3900,200
509027114,509024625,509043132,18507,3901,200
509049645,509047372,509062455,15083,3902,200
509069077,509066587,509083174,16587,3903,200
509089796,509087307,509105497,18190,3904,200
509112120,509109630,509126851,17221,3905,200
509133307,509131034,509146771,15737,3906,200
509153335,509151062,509167116,16054,3907,200
509173739,509171249,509187836,16587,3908,200
509194459,509191969,509208872,16903,3909,200
509215338,509213065,509227831,14766,3910,200
509234299,509232025,509249346,17321,3911,200
509255836,509253563,509269953,16390,3912,200
509276575,509274086,509290989,16903,3913,200
509297612,509295122,509312995,17873,3914,200
509319617,509317128,509333059,15931,3915,200
509339584,509337312,509354313,17001,3916,200
509360797,509358524,509374892,16368,3917,200
509381360,509379087,509396090,17003,3918,200
509402665,509400392,509418028,17636,3919,200
509424652,509422161,509438749,16588,3920,200
509445373,509442882,509460418,17536,3921,200
509466902,509464629,509480028,15399,3922,200
509486613,509484341,509501997,17656,3923,200
509508619,509506130,509524635,18505,3924,200
509531257,509528768,509545354,16586,3925,200
509551921,509549649,509565700,16051,3926,200
509572323,509569833,509587074,17241,3927,200
509593534,509591261,509609550,18289,3928,200
509616045,509613772,509630774,17002,3929,200
509637397,509634907,509650521,15614,3930,200
509657024,509654751,509670781,16030,3931,200
509677403,509674914,509693420,18506,3932,200
509699916,509697643,509714963,17320,3933,200
509721586,509719096,509736316,17220,3934,200
509742881,509740607,509755078,14471,3935,200
509761701,509759211,509775164,15953,3936,200
509781694,509779420,509795137,15717,3937,200
509801758,509799269,509815243,15974,3938,200
509821864,509819375,509836298,16923,3939,200
509842921,509840431,509859254,18823,3940,200
509865783,509863510,509881167,17657,3941,200
509887745,509885471,509901525,16054,3942,200
509908024,509905751,509923071,17320,3943,200
509929694,509927204,509943494,16290,3944,200
509949959,509947686,509965638,17952,3945,200
509972138,509969865,509985919,16054,3946,200
509992443,509990170,510007807,17637,3947,200
510014382,510012109,510026875,14766,3948,200
510033465,510031191,510045958,14767,3949,200
510052473,510050200,510067201,17001,3950,200
510073823,510071334,510089207,17873,3951,200
510095662,510093389,510109124,15735,3952,200
510115746,510113256,510131445,18189,3953,200
510138067,510135578,510153767,18189,3954,200
510160266,510157993,510174680,16687,3955,200
510181302,510178813,510196053,17240,3956,200
510202676,510200186,510217089,16903,3957,200
510223595,510221322,510237692,16370,3958,200
510244314,510241825,510257777,15952,3959,200
510264289,510262016,510279989,17973,3960,200
510286561,510284287,510300656,16369,3961,200
510307278,510304789,510321690,16901,3962,200
510328265,510325992,510341411,15419,3963,200
510348034,510345544,510362786,17242,3964,200
510369315,510367042,510383727,16685,3965,200
510390350,510387860,510403476,15616,3966,200
510410097,510407608,510425164,17556,3967,200
510431787,510429297,510446201,16904,3968,200
510452824,510450334,510465316,14982,3969,200
510471939,510469448,510487302,17854,3970,200
510493926,510491435,510508972,17537,3971,200
510515594,510513105,510530007,16902,3972,200
510536596,510534323,510550038,15715,3973,200
510556539,510554266,510572557,18291,3974,200
510579179,510576690,510592009,15319,3975,200
510598535,510596261,510613919,17658,3976,200
510620427,510618154,510635178,17024,3977,200
510641671,510639398,510655113,15715,3978,200
510661685,510659412,510677047,17635,3979,200
510683669,510681180,510698398,17218,3980,200
510705021,510702531,510718485,15954,3981,200
510724979,510722706,510738738,16032,3982,200
510745361,510742871,510760724,17853,3983,200
510767347,510764858,510782394,17536,3984,200
510789019,510786528,510802799,16271,3985,200
510809293,510807020,510823705,16685,3986,200
510830281,510828008,510842774,14766,3987,200
510849397,510846907,510862543,15636,3988,200
510869166,510866676,510883263,16587,3989,200
510889886,510887396,510902399,15003,3990,200
510909022,510906532,510922823,16291,3991,200
510929334,510927060,510943115,16055,3992,200
510949737,510947248,510961913,14665,3993,200
510968403,510966130,510984104,17974,3994,200
510990598,510988324,511006299,17975,3995,200
511012922,511010433,511028622,18189,3996,200
511035245,511032755,511048392,15637,3997,200
511054884,511052612,511069950,17338,3998,200
511076440,511074167,511091824,17657,3999,200
511098331,511096058,511112745,16687,4000,200
511119368,511116878,511133128,16250,4001,200
511139707,511137435,511155091,17656,4002,200
511161580,511159307,511175042,15735,4003,200
511181540,511179267,511196586,17319,4004,200
511203209,511200719,511216652,15933,4005,200
511223175,511220901,511237588,16687,4006,200
511244163,511241890,511256971,15081,4007,200
511263593,511261103,511277669,16566,4008,200
511284291,511281802,511297417,15615,4009,200
511304038,511301549,511316215,14666,4010,200
511322838,511320348,511337252,16904,4011,200
511343770,511341496,511358181,16685,4012,200
511364803,511362314,511379216,16902,4013,200
511385745,511383471,511400496,17025,4014,200
511407119,511404629,511421235,16606,4015,200
511427719,511425446,511440529,15083,4016,200
511447151,511444661,511460299,15638,4017,200
511466875,511464602,511481289,16687,4018,200
511487912,511485422,511500742,15320,4019,200
511507247,511504974,511521660,16686,4020,200
511528282,511525793,511540162,14369,4021,200
511546784,511544294,511558982,14688,4022,200
511565511,511563238,511586781,23543,4023,200
511593188,511590915,511607130,16215,4024,200
511613637,511611364,511625835,14471,4025,200
511632457,511629968,511644950,14982,4026,200
511651571,511649082,511665035,15953,4027,200
511671656,511669167,511686090,16923,4028,200
511692713,511690223,511705544,15321,4029,200
511712166,511709677,511726577,16900,4030,200
511733199,511730710,511746661,15951,4031,200
511753283,511750793,511767696,16903,4032,200
511774318,511771829,511788415,16586,4033,200
511795037,511792548,511808480,15932,4034,200
511814998,511812725,511827829,15104,4035,200
511834451,511831962,511849835,17873,4036,200
511856458,511853968,511872475,18507,4037,200
511878935,511876662,511893349,16687,4038,200
511899973,511897482,511914703,17221,4039,200
511921326,511918837,511935127,16290,4040,200
511941664,511939391,511956711,17320,4041,200
511963334,511960844,511975214,14370,4042,200
511981785,511979511,511994279,14768,4043,200
512000901,511998412,512015631,17219,4044,200
512022158,512019885,512036572,16687,4045,200
512043193,512040704,512057288,16584,4046,200
512063693,512061420,512078226,16806,4047,200
512084754,512082482,512098196,15714,4048,200
512104712,512102439,512117837,15398,4049,200
512124458,512121968,512137922,15954,4050,200
512144543,512142054,512158006,15952,4051,200
512164627,512162138,512178724,16586,4052,200
512185203,512182930,512198982,16052,4053,200
512205511,512203238,512218025,14787,4054,200
512224530,512222256,512238331,16075,4055,200
512244839,512242567,512258935,16368,4056,200
512265414,512263141,512278243,15102,4057,200
512284696,512282423,512298456,16033,4058,200
512304981,512302707,512316862,14155,4059,200
512323435,512321162,512336582,15420,4060,200
512343204,512340714,512356666,15952,4061,200
512363174,512360902,512379506,18604,4062,200
512386005,512383731,512401704,17973,4063,200
512408326,512405837,512423076,17239,4064,200
512429699,512427209,512444111,16902,4065,200
512450734,512448244,512464493,16249,4066,200
512471075,512468802,512486776,17974,4067,200
512493398,512490909,512507199,16290,4068,200
512513714,512511441,512527810,16369,4069,200
512534317,512532043,512549047,17004,4070,200
512555669,512553179,512568795,15616,4071,200
512575417,512572927,512589196,16269,4072,200
512595818,512593329,512611519,18190,4073,200
512617987,512615713,512632081,16368,4074,200
512638567,512636294,512651377,15083,4075,200
512657966,512655693,512671746,16053,4076,200
512678248,512675975,512692976,17001,4077,200
512699462,512697190,512713221,16031,4078,200
512719844,512717354,512735524,18170,4079,200
512742061,512739787,512756157,16370,4080,200
512762686,512760413,512776782,16369,4081,200
512783404,512780914,512799422,18508,4082,200
512806044,512803554,512821090,17536,4083,200
512827713,512825223,512841155,15932,4084,200
512847653,512845381,512862067,16686,4085,200
512868689,512866199,512883103,16904,4086,200
512889680,512887408,512903797,16389,4087,200
512910261,512907989,512923702,15713,4088,200
512930208,512927935,512944621,16686,4089,200
512951244,512948754,512966945,18191,4090,200
512973513,512971239,512986660,15421,4091,200
512993164,512990891,513008865,17974,4092,200
513015486,513012997,513029897,16900,4093,200
513036519,513034030,513050615,16585,4094,200
513057098,513054825,513071510,16685,4095,200
513077971,513075697,513091432,15735,4096,200
513098053,513095564,513111179,15615,4097,200
513117800,513115311,513130926,15615,4098,200
513137377,513135104,513152740,17636,4099,200
513159362,513156873,513171852,14979,4100,200
513178474,513175984,513191620,15636,4101,200
513198242,513195752,513212338,16586,4102,200
513218821,513216549,513232621,16072,4103,200
513239079,513236806,513251889,15083,4104,200
513258511,513256021,513272607,16586,4105,200
513279060,513276788,513292840,16052,4106,200
513299464,513296973,513313876,16903,4107,200
513320441,513318169,513335170,17001,4108,200
513341791,513339302,513356521,17219,4109,200
513363144,513360654,513377895,17241,4110,200
513384517,513382027,513397348,15321,4111,200
513403969,513401480,513418699,17219,4112,200
513425159,513422885,513437966,15081,4113,200
513444588,513442098,513459001,16903,4114,200
513465623,513463134,513480689,17555,4115,200
513487312,513484822,513501093,16271,4116,200
513507715,513505226,513521516,16290,4117,200
513528139,513525649,513541602,15953,4118,200
513548179,513545906,513561305,15399,4119,200
513567828,513565555,513580025,14470,4120,200
513586614,513584341,513601681,17340,4121,200
513608260,513605986,513624278,18292,4122,200
513630900,513628411,513646264,17853,4123,200
513652841,513650568,513669174,18606,4124,200
513675795,513673306,513689258,15952,4125,200
513695833,513693561,513708030,14469,4126,200
513714652,513712162,513730035,17873,4127,200
513736521,513734249,513750956,16707,4128,200
513757579,513755089,513773279,18190,4129,200
513779902,513777412,513791783,14371,4130,200
513798297,513796024,513813027,17003,4131,200
513819517,513817244,513833317,16073,4132,200
513839819,513837546,513855519,17973,4133,200
513861969,513859697,513876066,16369,4134,200
513882688,513880199,513896785,16586,4135,200
513903365,513901092,513919065,17973,4136,200
513925656,513923382,513941357,17975,4137,200
513947865,513945591,513961961,16370,4138,200
513968583,513966094,513982384,16290,4139,200
513988892,513986619,514003327,16708,4140,200
514009806,514007533,514023902,16369,4141,200
514030524,514028035,514042700,14665,4142,200
514049203,514046930,514063932,17002,4143,200
514070555,514068065,514085623,17558,4144,200
514092197,514089923,514108214,18291,4145,200
514114705,514112431,514126586,14155,4146,200
514133113,514130840,514145606,14766,4147,200
514152135,514149862,514165598,15736,4148,200
514172175,514169902,514186271,16369,4149,200
514192790,514190516,514205600,15084,4150,200
514212222,514209732,514227922,18190,4151,200
514234433,514232160,514248845,16685,4152,200
514255468,514252978,514269564,16586,4153,200
514276092,514273820,514291793,17973,4154,200
514298416,514295926,514314749,18823,4155,200
514321372,514318882,514336101,17219,4156,200
514342724,514340234,514355533,15299,4157,200
514362155,514359665,514376250,16585,4158,200
514382699,514380427,514397112,16685,4159,200
514403735,514401245,514418781,17536,4160,200
514425247,514422974,514440948,17974,4161,200
514447571,514445081,514461985,16904,4162,200
514468483,514466210,514482895,16685,4163,200
514489421,514487148,514501912,14764,4164,200
514508534,514506044,514522630,16586,4165,200
514529131,514526857,514542912,16055,4166,200
514549438,514547165,514561931,14766,4167,200
514568553,514566063,514582649,16586,4168,200
514589178,514586905,514604225,17320,4169,200
514610846,514608357,514623360,15003,4170,200
514629981,514627492,514645049,17557,4171,200
514651637,514649364,514664130,14766,4172,200
514670691,514668418,514682550,14132,4173,200
514689048,514686774,514700928,14154,4174,200
514707549,514705060,514720358,15298,4175,200
514726921,514724647,514739750,15103,4176,200
514746373,514743882,514760469,16587,4177,200
514766962,514764689,514782978,18289,4178,200
514789494,514787221,514804224,17003,4179,200
514810788,514808515,514825833,17318,4180,200
514832354,514830082,514847083,17001,4181,200
514853603,514851330,514868333,17003,4182,200
514874954,514872465,514888101,15636,4183,200
514894724,514892233,514907871,15638,4184,200
514914377,514912104,514926870,14766,4185,200
514933492,514931002,514948560,17558,4186,200
514955061,514952789,514967890,15101,4187,200
514974511,514972022,514987637,15615,4188,200
514994139,514991867,515008236,16369,4189,200
515014858,515012369,515028322,15953,4190,200
515034944,515032454,515049039,16585,4191,200
515055572,515053299,515070955,17656,4192,200
515077528,515075255,515091623,16368,4193,200
515098245,515095756,515113608,17852,4194,200
515120231,515117741,515133695,15954,4195,200
515140271,515137998,515155634,17636,4196,200
515162257,515159767,515176987,17220,4197,200
515183557,515181283,515198624,17341,4198,200
515205247,515202757,515219342,16585,4199,200
515225964,515223475,515241011,17536,4200,200
515247633,515245144,515262362,17218,4201,200
515268985,515266495,515283397,16902,4202,200
515289930,515287657,515303054,15397,4203,200
515309544,515307271,515323324,16053,4204,200
515329947,515327457,515345964,18507,4205,200
515352425,515350152,515366501,16349,4206,200
515373123,515370633,515386566,15933,4207,200
515393188,515390698,515405997,15299,4208,200
515412619,515410129,515424817,14688,4209,200
515431322,515429050,515446052,17002,4210,200
515452674,515450185,515467087,16902,4211,200
515473666,515471392,515489027,17635,4212,200
515495649,515493160,515511328,18168,4213,200
515517950,515515461,515534284,18823,4214,200
515540906,515538417,515554369,15952,4215,200
515560991,515558501,515575721,17220,4216,200
515582344,515579854,515596440,16586,4217,200
515603064,515600573,515616844,16271,4218,200
515623343,515621069,515636783,15714,4219,200
515643234,515640961,515656064,15103,4220,200
515662686,515660196,515676804,16608,4221,200
515683428,515680937,515698475,17538,4222,200
515705098,515702608,515718878,16270,4223,200
515725391,515723118,515740458,17340,4224,200
515747041,515744769,515760822,16053,4225,200
515767445,515764955,515781224,16269,4226,200
515787847,515785357,515802259,16902,4227,200
515808881,515806392,515822978,16586,4228,200
515829601,515827111,515844983,17872,4229,200
515851606,515849116,515865069,15953,4230,200
515871691,515869201,515885808,16607,4231,200
515892431,515889941,515906843,16902,4232,200
515913466,515910976,515928827,17851,4233,200
515935450,515932960,515950179,17219,4234,200
515956764,515954491,515971493,17002,4235,200
515978115,515975626,515992528,16902,4236,200
515999034,515996761,516012180,15419,4237,200
516018666,516016392,516032109,15717,4238,200
516038602,516036329,516051727,15398,4239,200
516058348,516055859,516074049,18190,4240,200
516080621,516078347,516093746,15399,4241,200
516100366,516097878,516114145,16267,4242,200
516120667,516118394,516134447,16053,4243,200
516141070,516138579,516154849,16270,4244,200
516161472,516158982,516174936,15954,4245,200
516181469,516179196,516196516,17320,4246,200
516203138,516200649,516215968,15319,4247,200
516222590,516220100,516235103,15003,4248,200
516241601,516239328,516255381,16053,4249,200
516262004,516259514,516275467,15953,4250,200
516281927,516279654,516296340,16686,4251,200
516302857,516300583,516315983,15400,4252,200
516322434,516320162,516335264,15102,4253,200
516341886,516339396,516356636,17240,4254,200
516363138,516360865,516378838,17973,4255,200
516385462,516382971,516399221,16250,4256,200
516405844,516403354,516420573,17219,4257,200
516427077,516424803,516441807,17004,4258,200
516448333,516446061,516463061,17000,4259,200
516469684,516467194,516485385,18191,4260,200
516491843,516489570,516504653,15083,4261,200
516511154,516508881,516525884,17003,4262,200
516532417,516530145,516544298,14153,4263,200
516550819,516548546,516564599,16053,4264,200
516571086,516568813,516582966,14153,4265,200
516589469,516587195,516603248,16053,4266,200
516609871,516607381,516623673,16292,4267,200
516630172,516627898,516642686,14788,4268,200
516649308,516646818,516663721,16903,4269,200
516670232,516667958,516684666,16708,4270,200
516691289,516688799,516704415,15616,4271,200
516711037,516708547,516724479,15932,4272,200
516731101,516728611,516746464,17853,4273,200
516752970,516750697,516768355,17658,4274,200
516774833,516772560,516787325,14765,4275,200
516793784,516791511,516807565,16054,4276,200
516814074,516811801,516828170,16369,4277,200
516834684,516832411,516848125,15714,4278,200
516854747,516852257,516868211,15954,4279,200
516874700,516872428,516889429,17001,4280,200
516896052,516893562,516910464,16902,4281,200
516917035,516914762,516930793,16031,4282,200
516937417,516934926,516952168,17242,4283,200
516958791,516956301,516974174,17873,4284,200
516980678,516978405,516993487,15082,4285,200
517000109,516997619,517013255,15636,4286,200
517019878,517017387,517034290,16903,4287,200
517040854,517038581,517052734,14153,4288,200
517059357,517056866,517072820,15954,4289,200
517079443,517076952,517094489,17537,4290,200
517101111,517098622,517116155,17533,4291,200
517122777,517120288,517136873,16585,4292,200
517143462,517141189,517157221,16032,4293,200
517163844,517161354,517178257,16903,4294,200
517184879,517182389,517200578,18189,4295,200
517207067,517204794,517222451,17657,4296,200
517228909,517226636,517241718,15082,4297,200
517248295,517246023,517261421,15398,4298,200
517267946,517265673,517282043,16370,4299,200
517288665,517286175,517301158,14983,4300,200
517307660,517305387,517322072,16685,4301,200
517328533,517326260,517342629,16369,4302,200
517349151,517346878,517361643,14765,4303,200
517368221,517365947,517381368,15421,4304,200
517387989,517385500,517402739,17239,4305,200
517409361,517406872,517422170,15298,4306,200
517428792,517426302,517443544,17242,4307,200
517450047,517447774,517464143,16369,4308,200
517470671,517468398,517485401,17003,4309,200
517492024,517489534,517505149,15615,4310,200
517511771,517509281,517525256,15975,4311,200
517531758,517529485,517546488,17003,4312,200
517552971,517550698,517566730,16032,4313,200
517573245,517570972,517586708,15736,4314,200
517593331,517590840,517605844,15004,4315,200
517612466,517609976,517624980,15004,4316,200
517631548,517629275,517643744,14469,4317,200
517650248,517647975,517665316,17341,4318,200
517671939,517669449,517685382,15933,4319,200
517691889,517689616,517705986,16370,4320,200
517712569,517710296,517726349,16053,4321,200
517732811,517730537,517746274,15737,4322,200
517752897,517750406,517766992,16586,4323,200
517773450,517771177,517786913,15736,4324,200
517793535,517791045,517807947,16902,4325,200
517814570,517812080,517829299,17219,4326,200
517835803,517833530,517849246,15716,4327,200
517855867,517853378,517868697,15319,4328,200
517875261,517872988,517888725,15737,4329,200
517895209,517892936,517910889,17953,4330,200
517917512,517915022,517932875,17853,4331,200
517939450,517937177,517953547,16370,4332,200
517960117,517957844,517973896,16052,4333,200
517980519,517978029,517994932,16903,4334,200
518001445,517999172,518016513,17341,4335,200
518023136,518020646,518035331,14685,4336,200
518041953,518039463,518057654,18191,4337,200
518064276,518061787,518079344,17557,4338,200
518085966,518083477,518099768,16291,4339,200
518106390,518103901,518120802,16901,4340,200
518127425,518124935,518141858,16923,4341,200
518148481,518145991,518163211,17220,4342,200
518169674,518167401,518183770,16369,4343,200
518190392,518187902,518204806,16904,4344,200
518211428,518208939,518225207,16268,4345,200
518231830,518229340,518246876,17536,4346,200
518253499,518251009,518268883,17874,4347,200
518275505,518273016,518288969,15953,4348,200
518295590,518293101,518310320,17219,4349,200
518316853,518314580,518331266,16686,4350,200
518337800,518335526,518353499,17973,4351,200
518360122,518357632,518372319,14687,4352,200
518378941,518376451,518391435,14984,4353,200
518398057,518395567,518412788,17221,4354,200
518419412,518416921,518434458,17537,4355,200
518441081,518438591,518453910,15319,4356,200
518460380,518458106,518476714,18608,4357,200
518483225,518480952,518497637,16685,4358,200
518504260,518501770,518517068,15298,4359,200
518523689,518521200,518537470,16270,4360,200
518543975,518541702,518557417,15715,4361,200
518564038,518561549,518578789,17240,4362,200
518585284,518583011,518598410,15399,4363,200
518605032,518602542,518617841,15299,4364,200
518624463,518621973,518640163,18190,4365,200
518646785,518644296,518660565,16269,4366,200
518667028,518664755,518679837,15082,4367,200
518686335,518684063,518698510,14447,4368,200
518705132,518702642,518721149,18507,4369,200
518727772,518725282,518741889,16607,4370,200
518748459,518746185,518763189,17004,4371,200
518769811,518767322,518783908,16586,4372,200
518790531,518788041,518805261,17220,4373,200
518811882,518809393,518825642,16249,4374,200
518832265,518829775,518845411,15636,4375,200
518851974,518849701,518865416,15715,4376,200
518871924,518869651,518886969,17318,4377,200
518893591,518891102,518908343,17241,4378,200
518914966,518912476,518930667,18191,4379,200
518937198,518934924,518950344,15420,4380,200
518956927,518954654,518969440,14786,4381,200
518976062,518973572,518989209,15637,4382,200
518995830,518993341,519009610,16269,4383,200
519016233,519013743,519031301,17558,4384,200
519037828,519035556,519052580,17024,4385,200
519059088,519056816,519071898,15082,4386,200
519078521,519076030,519091668,15638,4387,200
519098289,519095800,519113039,17239,4388,200
519119567,519117294,519133664,16370,4389,200
519140287,519137797,519152483,14686,4390,200
519159105,519156615,519173202,16587,4391,200
519179825,519177335,519192339,15004,4392,200
519198834,519196562,519212275,15713,4393,200
519218731,519216458,519232826,16368,4394,200
519239449,519236959,519253546,16587,4395,200
519260169,519257679,519275869,18190,4396,200
519282399,519280126,519296813,16687,4397,200
519303301,519301028,519315498,14470,4398,200
519322025,519319751,519336460,16709,4399,200
519343083,519340593,519357179,16586,4400,200
519363802,519361312,519379503,18191,4401,200
519386125,519383635,519400539,16904,4402,200
519407162,519404672,519421576,16904,4403,200
519428199,519425709,519444532,18823,4404,200
519451043,519448770,519466744,17974,4405,200
519473317,519471044,519486781,15737,4406,200
519493268,519490995,519507048,16053,4407,200
519513670,519511181,519526796,15615,4408,200
519533296,519531023,519547414,16391,4409,200
519553941,519551668,519568671,17003,4410,200
519575293,519572804,519589369,16565,4411,200
519595857,519593584,519610271,16687,4412,200
519616894,519614404,519629092,14688,4413,200
519635607,519633334,519648417,15083,4414,200
519655039,519652549,519668503,15954,4415,200
519675125,519672635,519689221,16586,4416,200
519695716,519693443,519712050,18607,4417,200
519718558,519716284,519730754,14470,4418,200
519737236,519734964,519751649,16685,4419,200
519758272,519755782,519772684,16902,4420,200
519779307,519776817,519794036,17219,4421,200
519800659,519798169,519815073,16904,4422,200
519821695,519819206,519834504,15298,4423,200
519841126,519838636,519856805,18169,4424,200
519863262,519860989,519876726,15737,4425,200
519883207,519880933,519896966,16033,4426,200
519903431,519901158,519917528,16370,4427,200
519924100,519921827,519938197,16370,4428,200
519944727,519942455,519958485,16030,4429,200
519964989,519962715,519979403,16688,4430,200
519985855,519983582,519999929,16347,4431,200
520006552,520004062,520022230,18168,4432,200
520028690,520026418,520042469,16051,4433,200
520049092,520046602,520063821,17219,4434,200
520070444,520067954,520085490,17536,4435,200
520092113,520089623,520104606,14983,4436,200
520111227,520108738,520126589,17851,4437,200
520133151,520130879,520148536,17657,4438,200
520155159,520152669,520168918,16249,4439,200
520175497,520173224,520191515,18291,4440,200
520198045,520195771,520212774,17003,4441,200
520219262,520216989,520233697,16708,4442,200
520240320,520237830,520254733,16903,4443,200
520261356,520258866,520275769,16903,4444,200
520282329,520280055,520295814,15759,4445,200
520302389,520300116,520316507,16391,4446,200
520322967,520320694,520336114,15420,4447,200
520342736,520340246,520358436,18190,4448,200
520364919,520362646,520379986,17340,4449,200
520386551,520384278,520400648,16370,4450,200
520407271,520404781,520419764,14983,4451,200
520426333,520424060,520440429,16369,4452,200
520446961,520444688,520461058,16370,4453,200
520467545,520465272,520482592,17320,4454,200
520489213,520486724,520501705,14981,4455,200
520508211,520505938,520522308,16370,4456,200
520528930,520526441,520543341,16900,4457,200
520549843,520547570,520564911,17341,4458,200
520571533,520569044,520584026,14982,4459,200
520590608,520588335,520604703,16368,4460,200
520611326,520608836,520623521,14685,4461,200
520630143,520627653,520645843,18190,4462,200
520652350,520650077,520665475,15398,4463,200
520671981,520669709,520686056,16347,4464,200
520692678,520690189,520707408,17219,4465,200
520714032,520711541,520728446,16905,4466,200
520734927,520732654,520748075,15421,4467,200
520754593,520752319,520769660,17341,4468,200
520776245,520773971,520790341,16370,4469,200
520796792,520794518,520810572,16054,4470,200
520817027,520814755,520831440,16685,4471,200
520838064,520835573,520854081,18508,4472,200
520860588,520858316,520874368,16052,4473,200
520880932,520878659,520896294,17635,4474,200
520902917,520900427,520917330,16903,4475,200
520923952,520921463,520939969,18506,4476,200
520946591,520944102,520961321,17219,4477,200
520967944,520965454,520980775,15321,4478,200
520987396,520984907,521002463,17556,4479,200
521009028,521006755,521024095,17340,4480,200
521030717,521028228,521043843,15615,4481,200
521050427,521048154,521064208,16054,4482,200
521070709,521068437,521085122,16685,4483,200
521091745,521089255,521106792,17537,4484,200
521113328,521111055,521128058,17003,4485,200
521134639,521132366,521149052,16686,4486,200
521155675,521153185,521167871,14686,4487,200
521174492,521172003,521188904,16901,4488,200
521195421,521193148,521208229,15081,4489,200
521214850,521212361,521230868,18507,4490,200
521237397,521235124,521251494,16370,4491,200
521258076,521255802,521272806,17004,4492,200
521279429,521276939,521293524,16585,4493,200
521300032,521297759,521312524,14765,4494,200
521319146,521316656,521332589,15933,4495,200
521339211,521336721,521352653,15932,4496,200
521359274,521356785,521373350,16565,4497,200
521379860,521377586,521394927,17341,4498,200
521401549,521399060,521416595,17535,4499,200
521423076,521420804,521436519,15715,4500,200
521443140,521440651,521457237,16586,4501,200
521463796,521461524,521478548,17024,4502,200
521485014,521482740,521500715,17975,4503,200
521507298,521505025,521520424,15399,4504,200
521526988,521524715,521541105,16390,4505,200
521547728,521545238,521560537,15299,4506,200
521567157,521564669,521583491,18822,4507,200
521590114,521587624,521605182,17558,4508,200
521611804,521609315,521625901,16586,4509,200
521632470,521630196,521645616,15420,4510,200
521652187,521649913,521665628,15715,4511,200
521672250,521669760,521684742,14982,4512,200
521691245,521688972,521705342,16370,4513,200
521711964,521709475,521726715,17240,4514,200
521733194,521730921,521746636,15715,4515,200
521753087,521750814,521766213,15399,4516,200
521772834,521770345,521784715,14370,4517,200
521791298,521789025,521803179,14154,4518,200
521809803,521807312,521824871,17559,4519,200
521831493,521829004,521844957,15953,4520,200
521851580,521849089,521864390,15301,4521,200
521870900,521868627,521884047,15420,4522,200
521890668,521888179,521905397,17218,4523,200
521911921,521909648,521926333,16685,4524,200
521932956,521930466,521947368,16902,4525,200
521953888,521951615,521968956,17341,4526,200
521975485,521973211,521988295,15084,4527,200
521994917,521992427,522008380,15953,4528,200
522015001,522012512,522027494,14982,4529,200
522034115,522031627,522047261,15634,4530,200
522053883,522051394,522067662,16268,4531,200
522074168,522071894,522088918,17024,4532,200
522095541,522093051,522109659,16608,4533,200
522116218,522113945,522129026,15081,4534,200
522135555,522133282,522149652,16370,4535,200
522156276,522153785,522171322,17537,4536,200
522177945,522175455,522193013,17558,4537,200
522199492,522197219,522215191,17972,4538,200
522221813,522219324,522235908,16584,4539,200
522242532,522240042,522257599,17557,4540,200
522264103,522261830,522279782,17952,4541,200
522286404,522283915,522301451,17536,4542,200
522308074,522305584,522322804,17220,4543,200
522329309,522327036,522342456,15420,4544,200
522348961,522346688,522361791,15103,4545,200
522368242,522365969,522384574,18605,4546,200
522391044,522388771,522406745,17974,4547,200
522413249,522410977,522428295,17318,4548,200
522434875,522432602,522447052,14450,4549,200
522453673,522451184,522468719,17535,4550,200
522475342,522472852,522487540,14688,4551,200
522494046,522491773,522509725,17952,4552,200
522516349,522513858,522530763,16905,4553,200
522537385,522534896,522553086,18190,4554,200
522559709,522557219,522572835,15616,4555,200
522579457,522576967,522593215,16248,4556,200
522599794,522597521,522613911,16390,4557,200
522620408,522618134,522633238,15104,4558,200
522639859,522637370,522652056,14686,4559,200
522658634,522656361,522673701,17340,4560,200
522680203,522677930,522694005,16075,4561,200
522700628,522698138,522713775,15637,4562,200
522720355,522718082,522734451,16369,4563,200
522740939,522738665,522753749,15084,4564,200
522760371,522757881,522775734,17853,4565,200
522782239,522779967,522796969,17002,4566,200
522803591,522801102,522817054,15952,4567,200
522823619,522821347,522836428,15081,4568,200
522842955,522840683,522857052,16369,4569,200
522863560,522861287,522878607,17320,4570,200
522885230,522882740,522897722,14982,4571,200
522904183,522901910,522919229,17319,4572,200
522925852,522923362,522940919,17557,4573,200
522947496,522945223,522961910,16687,4574,200
522968532,522966043,522982945,16902,4575,200
522989462,522987188,523004191,17003,4576,200
523010813,523008324,523025543,17219,4577,200
523032117,523029844,523046214,16370,4578,200
523052740,523050467,523068441,17974,4579,200
523075064,523072574,523090764,18190,4580,200
523097387,523094897,523110513,15616,4581,200
523116964,523114690,523131377,16687,4582,200
523137889,523135616,523151986,16370,4583,200
523158571,523156298,523170451,14153,4584,200
523176966,523174692,523190112,15420,4585,200
523196622,523194349,523211035,16686,4586,200
523217532,523215258,523231313,16055,4587,200
523237834,523235561,523253534,17973,4588,200
523260156,523257667,523273598,15931,4589,200
523280219,523277730,523293662,15932,4590,200
523300221,523297948,523314655,16707,4591,200
523321278,523318788,523336344,17556,4592,200
523342967,523340477,523357401,16924,4593,200
523363966,523361694,523376775,15081,4594,200
523383350,523381077,523398734,17657,4595,200
523405357,523402867,523418504,15637,4596,200
523425125,523422636,523437934,15298,4597,200
523444502,523442229,523459548,17319,4598,200
523466171,523463681,523480290,16609,4599,200
523486748,523484475,523500845,16370,4600,200
523507469,523504978,523520276,15298,4601,200
523526735,523524461,523541780,17319,4602,200
523548303,523546029,523562398,16369,4603,200
523568862,523566589,523582008,15419,4604,200
523588499,523586226,523602596,16370,4605,200
523609218,523606729,523622365,15636,4606,200
523628898,523626625,523641074,14449,4607,200
523647697,523645207,523662111,16904,4608,200
523668580,523666307,523683625,17318,4609,200
523690187,523687914,523702997,15083,4610,200
523709568,523707296,523722377,15081,4611,200
523728999,523726509,523742460,15951,4612,200
523749083,523746593,523762547,15954,4613,200
523769169,523766680,523785187,18507,4614,200
523791810,523789320,523804325,15005,4615,200
523810946,523808457,523823776,15319,4616,200
523830279,523828006,523844059,16053,4617,200
523850682,523848192,523865748,17556,4618,200
523872255,523869983,523888589,18606,4619,200
523895213,523892722,523907094,14372,4620,200
523913717,523911227,523928130,16903,4621,200
523934639,523932366,523948419,16053,4622,200
523954936,523952663,523970298,17635,4623,200
523976921,523974431,523992939,18508,4624,200
523999437,523997164,524015137,17973,4625,200
524021760,524019270,524037440,18170,4626,200
524044062,524041573,524058791,17218,4627,200
524065275,524063002,524080657,17655,4628,200
524087280,524084790,524100090,15300,4629,200
524106713,524104223,524120810,16587,4630,200
524127305,524125033,524140767,15734,4631,200
524147232,524144960,524162299,17339,4632,200
524168799,524166526,524183211,16685,4633,200
524189712,524187439,524204442,17003,4634,200
524210967,524208694,524225064,16370,4635,200
524231634,524229360,524245077,15717,4636,200
524251663,524249390,524267680,18290,4637,200
524274303,524271813,524289666,17853,4638,200
524296183,524293909,524310912,17003,4639,200
524317497,524315225,524332226,17001,4640,200
524338848,524336358,524351362,15004,4641,200
524357869,524355595,524372303,16708,4642,200
524378810,524376537,524390691,14154,4643,200
524397194,524394921,524410318,15397,4644,200
524416939,524414450,524430402,15952,4645,200
524437025,524434534,524451121,16587,4646,200
524457742,524455253,524471521,16268,4647,200
524477973,524475700,524490463,14763,4648,200
524497085,524494595,524511161,16566,4649,200
524517783,524515293,524530909,15616,4650,200
524537422,524535150,524550906,15756,4651,200
524557529,524555038,524570675,15637,4652,200
524577298,524574807,524591394,16587,4653,200
524598016,524595526,524612091,16565,4654,200
524618712,524616223,524632493,16270,4655,200
524639115,524636625,524654478,17853,4656,200
524661101,524658611,524675198,16587,4657,200
524681667,524679394,524695468,16074,4658,200
524702090,524699600,524715533,15933,4659,200
524722002,524719728,524737681,17953,4660,200
524744304,524741814,524756185,14371,4661,200
524762705,524760432,524776801,16369,4662,200
524783423,524780934,524797204,16270,4663,200
524803708,524801436,524817804,16368,4664,200
524824425,524821936,524838520,16584,4665,200
524845014,524842742,524860059,17317,4666,200
524866681,524864191,524882380,18189,4667,200
524889002,524886512,524905018,18506,4668,200
524911639,524909150,524926684,17534,4669,200
524933305,524930816,524947402,16586,4670,200
524954024,524951534,524967804,16270,4671,200
524974312,524972039,524996174,24135,4672,200
525002797,525000307,525016893,16586,4673,200
525023515,525021025,525037612,16587,4674,200
525044147,525041874,525056323,14449,4675,200
525062894,525060621,525077308,16687,4676,200
525083835,525081563,525097614,16051,4677,200
525104122,525101849,525120456,18607,4678,200
525126919,525124646,525141986,17340,4679,200
525148437,525146164,525163166,17002,4680,200
525169748,525167475,525183549,16074,4681,200
525190029,525187756,525205729,17973,4682,200
525212351,525209861,525227418,17557,4683,200
525234041,525231551,525247800,16249,4684,200
525254422,525251932,525268518,16586,4685,200
525275087,525272814,525287263,14449,4686,200
525293787,525291514,525308200,16686,4687,200
525314822,525312333,525330500,18167,4688,200
525337023,525334750,525351119,16369,4689,200
525357624,525355352,525372670,17318,4690,200
525379128,525376854,525392592,15738,4691,200
525399214,525396724,525412676,15952,4692,200
525419298,525416808,525434997,18189,4693,200
525441620,525439130,525454429,15299,4694,200
525460919,525458646,525473749,15103,4695,200
525480371,525477881,525492884,15003,4696,200
525499413,525497140,525513193,16053,4697,200
525519815,525517325,525532328,15003,4698,200
525538951,525536460,525552731,16271,4699,200
525559353,525556864,525571529,14665,4700,200
525578058,525575784,525592134,16350,4701,200
525598701,525596428,525613768,17340,4702,200
525620390,525617901,525634466,16565,4703,200
525641088,525638598,525653919,15321,4704,200
525660501,525658229,525674914,16685,4705,200
525681536,525679046,525695611,16565,4706,200
525702194,525699921,525714686,14765,4707,200
525721308,525718818,525736375,17557,4708,200
525742907,525740634,525755735,15101,4709,200
525762357,525759867,525776770,16903,4710,200
525783392,525780902,525796538,15636,4711,200
525803042,525800769,525816843,16074,4712,200
525823466,525820975,525838851,17876,4713,200
525845474,525842984,525861173,18189,4714,200
525867795,525865305,525881892,16587,4715,200
525888515,525886025,525901346,15321,4716,200
525907797,525905524,525921576,16052,4717,200
525928039,525925767,525942157,16390,4718,200
525948655,525946382,525963722,17340,4719,200
525970344,525967854,525984440,16586,4720,200
525991063,525988573,526006109,17536,4721,200
526012731,526010241,526029064,18823,4722,200
526035687,526033197,526049151,15954,4723,200
526055677,526053404,526069456,16052,4724,200
526076078,526073589,526089858,16269,4725,200
526096338,526094064,526111067,17003,4726,200
526117556,526115283,526132602,17319,4727,200
526139189,526136916,526154867,17951,4728,200
526161488,526158999,526176850,17851,4729,200
526183472,526180982,526198222,17240,4730,200
526204846,526202355,526218309,15954,4731,200
526224930,526222441,526241264,18823,4732,200
526247886,526245397,526260379,14982,4733,200
526267001,526264511,526281415,16904,4734,200
526287924,526285651,526302971,17320,4735,200
526309593,526307104,526322741,15637,4736,200
526329304,526327032,526344033,17001,4737,200
526350655,526348166,526363802,15636,4738,200
526370265,526367992,526385333,17341,4739,200
526391863,526389590,526407248,17658,4740,200
526413871,526411381,526426997,15616,4741,200
526433618,526431129,526447377,16248,4742,200
526454000,526451510,526467778,16268,4743,200
526474345,526472073,526487175,15102,4744,200
526493640,526491367,526507737,16370,4745,200
526514359,526511869,526527505,15636,4746,200
526534080,526531807,526547840,16033,4747,200
526554335,526552062,526568431,16369,4748,200
526575054,526572564,526588833,16269,4749,200
526595335,526593062,526609431,16369,4750,200
526616054,526613564,526632388,18824,4751,200
526639010,526636521,526654055,17534,4752,200
526660677,526658188,526673508,15320,4753,200
526680131,526677640,526692960,15320,4754,200
526699582,526697092,526713339,16247,4755,200
526719828,526717555,526732637,15082,4756,200
526739258,526736769,526752068,15299,4757,200
526758519,526756247,526772297,16050,4758,200
526778756,526776483,526793485,17002,4759,200
526800108,526797618,526815807,18189,4760,200
526822319,526820046,526837366,17320,4761,200
526843867,526841595,526857963,16368,4762,200
526864586,526862096,526877078,14982,4763,200
526883578,526881305,526898940,17635,4764,200
526905518,526903245,526917398,14153,4765,200
526924019,526921530,526937166,15636,4766,200
526943788,526941298,526957883,16585,4767,200
526964506,526962016,526979868,17852,4768,200
526986374,526984102,526999499,15397,4769,200
527006121,527003631,527019899,16268,4770,200
527026521,527024032,527041567,17535,4771,200
527048191,527045700,527063891,18191,4772,200
527070418,527068145,527085484,17339,4773,200
527092071,527089798,527103952,14154,4774,200
527110540,527108266,527126240,17974,4775,200
527132863,527130373,527147930,17557,4776,200
527154381,527152107,527167190,15083,4777,200
527173812,527171322,527188541,17219,4778,200
527195105,527192831,527209834,17003,4779,200
527216356,527214082,527229482,15400,4780,200
527236017,527233744,527250113,16369,4781,200
527256735,527254245,527268616,14371,4782,200
527275238,527272748,527290600,17852,4783,200
527297122,527294849,527313140,18291,4784,200
527319763,527317273,527333206,15933,4785,200
527339706,527337434,527354434,17000,4786,200
527361057,527358567,527375470,16903,4787,200
527381960,527379687,527396056,16369,4788,200
527402576,527400302,527416988,16686,4789,200
527423485,527421212,527438552,17340,4790,200
527445126,527442852,527460509,17657,4791,200
527467132,527464642,527481882,17240,4792,200
527488505,527486015,527503234,17219,4793,200
527509736,527507463,527521934,14471,4794,200
527528556,527526066,527543602,17536,4795,200
527550225,527547735,527563055,15320,4796,200
527569537,527567264,527583633,16369,4797,200
527590255,527587765,527605955,18190,4798,200
527612539,527610266,527625981,15715,4799,200
527632603,527630113,527647987,17874,4800,200
527654454,527652181,527668255,16074,4801,200
527674876,527672387,527690237,17850,4802,200
527696740,527694467,527710202,15735,4803,200
527716703,527714430,527729533,15103,4804,200
527736156,527733665,527749640,15975,4805,200
527756261,527753772,527769725,15953,4806,200
527776219,527773946,527791920,17974,4807,200
527798542,527796053,527813905,17852,4808,200
527820529,527818038,527834943,16905,4809,200
527841428,527839155,527855841,16686,4810,200
527862344,527860072,527877707,17635,4811,200
527884232,527881959,527897380,15421,4812,200
527904002,527901512,527918119,16607,4813,200
527924742,527922252,527937552,15300,4814,200
527944173,527941684,527957616,15932,4815,200
527964238,527961748,527980254,18506,4816,200
527986783,527984511,528002166,17655,4817,200
528008743,528006469,528023155,16686,4818,200
528029776,528027287,528042607,15320,4819,200
528049229,528046739,528062692,15953,4820,200
528069314,528066824,528082145,15321,4821,200
528088767,528086277,528102526,16249,4822,200
528109147,528106658,528125163,18505,4823,200
528131785,528129296,528144910,15614,4824,200
528151428,528149156,528164892,15736,4825,200
528171394,528169121,528186144,17023,4826,200
528192766,528190276,528204646,14370,4827,200
528211267,528208778,528225047,16269,4828,200
528231612,528229338,528245075,15737,4829,200
528251697,528249207,528264527,15320,4830,200
528271149,528268659,528285879,17220,4831,200
528292502,528290012,528308835,18823,4832,200
528315363,528313091,528328847,15756,4833,200
528335469,528332979,528350537,17558,4834,200
528357159,528354669,528371889,17220,4835,200
528378378,528376106,528391821,15715,4836,200
528398317,528396044,528411780,15736,4837,200
528418401,528415911,528432498,16587,4838,200
528438993,528436720,528451824,15104,4839,200
528458446,528455956,528473830,17874,4840,200
528480454,528477963,528492650,14687,4841,200
528499272,528496782,528515605,18823,4842,200
528522227,528519738,528537272,17534,4843,200
528543773,528541500,528559790,18290,4844,200
528566411,528563922,528579241,15319,4845,200
528585863,528583373,528599959,16586,4846,200
528606580,528604092,528620339,16247,4847,200
528626962,528624472,528639793,15321,4848,200
528646367,528644094,528660125,16031,4849,200
528666747,528664258,528681476,17218,4850,200
528687979,528685706,528703026,17320,4851,200
528709648,528707159,528724694,17535,4852,200
528731317,528728826,528743831,15005,4853,200
528750356,528748083,528765107,17024,4854,200
528771598,528769326,528786012,16686,4855,200
528792591,528790318,528806372,16054,4856,200
528812996,528810505,528826754,16249,4857,200
528833263,528830990,528847359,16369,4858,200
528853983,528851492,528868394,16902,4859,200
528874912,528872638,528888058,15420,4860,200
528894680,528892190,528909410,17220,4861,200
528916032,528913543,528928862,15319,4862,200
528935484,528932994,528948926,15932,4863,200
528955376,528953103,528967573,14470,4864,200
528974196,528971705,528989876,18171,4865,200
528996403,528994130,529010500,16370,4866,200
529017122,529014632,529031852,17220,4867,200
529038358,529036085,529052455,16370,4868,200
529058960,529056687,529073372,16685,4869,200
529079995,529077505,529093457,15952,4870,200
529099916,529097642,529114646,17004,4871,200
529121106,529118832,529134887,16055,4872,200
529141511,529139020,529155608,16588,4873,200
529162088,529159814,529174602,14788,4874,200
529181223,529178734,529196903,18169,4875,200
529203432,529201159,529217212,16053,4876,200
529223735,529221462,529239435,17973,4877,200
529246058,529243568,529260471,16903,4878,200
529267042,529264769,529281139,16370,4879,200
529287673,529285399,529302087,16688,4880,200
529308709,529306220,529324388,18168,4881,200
529331011,529328521,529345423,16902,4882,200
529351876,529349603,529367576,17973,4883,200
529374039,529371767,529387481,15714,4884,200
529394103,529391613,529408833,17220,4885,200
529415293,529413020,529428757,15737,4886,200
529435225,529432952,529449005,16053,4887,200
529455628,529453138,529468142,15004,4888,200
529474765,529472274,529488523,16249,4889,200
529495046,529492774,529508192,15418,4890,200
529514699,529512426,529528817,16391,4891,200
529535440,529532950,529550822,17872,4892,200
529557445,529554955,529572175,17220,4893,200
529578796,529576308,529591605,15297,4894,200
529598135,529595862,529611915,16053,4895,200
529618501,529616229,529632913,16684,4896,200
529639535,529637045,529654581,17536,4897,200
529661076,529658803,529675489,16686,4898,200
529682110,529679621,529694306,14685,4899,200
529700929,529698438,529715974,17536,4900,200
529722596,529720107,529735722,15615,4901,200
529742343,529739854,529756440,16586,4902,200
529762895,529760622,529776041,15419,4903,200
529782492,529780219,529795006,14787,4904,200
529801629,529799138,529815093,15955,4905,200
529821554,529819282,529837571,18289,4906,200
529844062,529841788,529857188,15400,4907,200
529863695,529861421,529876842,15421,4908,200
529883352,529881080,529898420,17340,4909,200
529905042,529902553,529918505,15952,4910,200
529925075,529922802,529937252,14450,4911,200
529943873,529941384,529958939,17555,4912,200
529965560,529963071,529980944,17873,4913,200
529987567,529985077,530001664,16587,4914,200
530008286,530005797,530021411,15614,4915,200
530028034,530025543,530041498,15955,4916,200
530047976,530045703,530062388,16685,4917,200
530069010,530066520,530082157,15637,4918,200
530088607,530086335,530101733,15398,4919,200
530108295,530106022,530120491,14469,4920,200
530126991,530124718,530140770,16052,4921,200
530147393,530144903,530161173,16270,4922,200
530167760,530165486,530181857,16371,4923,200
530188347,530186073,530203731,17658,4924,200
530210316,530208043,530225045,17002,4925,200
530231554,530229280,530246282,17002,4926,200
530252904,530250415,530265714,15299,4927,200
530272300,530270027,530285425,15398,4928,200
530292046,530289557,530305509,15952,4929,200
530312130,530309641,530327175,17534,4930,200
530333704,530331430,530347801,16371,4931,200
530354257,530351983,530369322,17339,4932,200
530375944,530373455,530391961,18506,4933,200
530398492,530396219,530411934,15715,4934,200
530418494,530416221,530433540,17319,4935,200
530440164,530437673,530454894,17221,4936,200
530461517,530459027,530474980,15953,4937,200
530481502,530479229,530496231,17002,4938,200
530502852,530500363,530516611,16248,4939,200
530523114,530520841,530537844,17003,4940,200
530544467,530541977,530557613,15636,4941,200
530564234,530561745,530578014,16269,4942,200
530584635,530582146,530598731,16585,4943,200
530605293,530603021,530619411,16390,4944,200
530625991,530623717,530639455,15738,4945,200
530645971,530643698,530659414,15716,4946,200
530666036,530663546,530679479,15933,4947,200
530686009,530683736,530700106,16370,4948,200
530706729,530704239,530719876,15637,4949,200
530726498,530724008,530740911,16903,4950,200
530747477,530745204,530761890,16686,4951,200
530768419,530766146,530782833,16687,4952,200
530789454,530786966,530804184,17218,4953,200
530810716,530808442,530824812,16370,4954,200
530831318,530829045,530843514,14469,4955,200
530850136,530847646,530863916,16270,4956,200
530870538,530868049,530885605,17556,4957,200
530892184,530889911,530907252,17341,4958,200
530913874,530911385,530927971,16586,4959,200
530934593,530932104,530947086,14982,4960,200
530953622,530951349,530969006,17657,4961,200
530975629,530973139,530990358,17219,4962,200
530996980,530994491,531009178,14687,4963,200
531015800,531013310,531029602,16292,4964,200
531036062,531033789,531050813,17024,4965,200
531057333,531055061,531070479,15418,4966,200
531077101,531074611,531089931,15320,4967,200
531096497,531094223,531108694,14471,4968,200
531115199,531112926,531129949,17023,4969,200
531136454,531134181,531149285,15104,4970,200
531155909,531153417,531170322,16905,4971,200
531176943,531174455,531192010,17555,4972,200
531198594,531196321,531212711,16390,4973,200
531219334,531216844,531232819,15975,4974,200
531239300,531237027,531253079,16052,4975,200
531259652,531257378,531275035,17657,4976,200
531281524,531279251,531295936,16685,4977,200
531302438,531300165,531316872,16707,4978,200
531323400,531321128,531336525,15397,4979,200
531343148,531340657,531357562,16905,4980,200
531364185,531361695,531379251,17556,4981,200
531385772,531383499,531400521,17022,4982,200
531406973,531404700,531419803,15103,4983,200
531426283,531424010,531439747,15737,4984,200
531446251,531443978,531461002,17024,4985,200
531467501,531465228,531483200,17972,4986,200
531489822,531487333,531503918,16585,4987,200
531510540,531508051,531523664,15613,4988,200
531530285,531527796,531545036,17240,4989,200
531551490,531549216,531564300,15084,4990,200
531570705,531568432,531584332,15900,4991,200
531590738,531588464,531608436,19972,4992,200
531615000,531612727,531627492,14765,4993,200
531634020,531631747,531649066,17319,4994,200
531655557,531653285,531669653,16368,4995,200
531676222,531673949,531691289,17340,4996,200
531697910,531695421,531711055,15634,4997,200
531717629,531715356,531731091,15735,4998,200
531737713,531735223,531752780,17557,4999,200
531759402,531756913,531774469,17556,5000,200
531781391,531778602,531795884,17282,1,225
531802535,531799747,531818950,19203,2,225
531825602,531822813,531839778,16965,3,225
531846430,531843641,531859952,16311,4,225
531866603,531863815,531880127,16312,5,225
531886780,531883990,531901275,17285,6,225
531907927,531905138,531923392,18254,7,225
531930043,531927255,531943903,16648,8,225
531950555,531947766,531966336,18570,9,225
531972986,531970199,531986530,16331,10,225
531993242,531990671,532006132,15461,11,225
532012849,532010277,532025739,15462,12,225
532032479,532029690,532044735,15045,13,225
532051475,532048686,532064999,16313,14,225
532071739,532068951,532087520,18569,15,225
532094257,532091686,532110039,18353,16,225
532116780,532113991,532130642,16651,17,225
532137383,532134594,532149957,15363,18,225
532156697,532153908,532172478,18570,19,225
532179219,532176430,532194368,17938,20,225
532201108,532198320,532215602,17282,21,225
532222342,532219554,532237469,17915,22,225
532244209,532241421,532257415,15994,23,225
532264156,532261367,532278333,16966,24,225
532285073,532282285,532301487,19202,25,225
532308226,532305439,532322086,16647,26,225
532328826,532326038,532342687,16649,27,225
532349428,532346640,532365526,18886,28,225
532372266,532369478,532387730,18252,29,225
532394470,532391682,532409597,17915,30,225
532416338,532413550,532430515,16965,31,225
532437255,532434468,532450483,16015,32,225
532457226,532454436,532471720,17284,33,225
532478462,532475673,532492956,17283,34,225
532499695,532496908,532512585,15677,35,225
532519324,532516536,532532214,15678,36,225
532538955,532536165,532554082,17917,37,225
532560822,532558034,532574344,16310,38,225
532581084,532578296,532593025,14729,39,225
532599764,532596976,532614913,17937,40,225
532621653,532618865,532635195,16330,41,225
532641936,532639147,532656113,16966,42,225
532662832,532660261,532677326,17065,43,225
532684067,532681278,532697907,16629,44,225
532704647,532701859,532719141,17282,45,225
532725882,532723093,532740038,16945,46,225
532746779,532743990,532760303,16313,47,225
532767044,532764255,532779301,15046,48,225
532786041,532783252,532798931,15679,49,225
532805671,532802883,532820482,17599,50,225
532827223,532824434,532842033,17599,51,225
532848774,532845985,532862297,16312,52,225
532869038,532866249,532881611,15362,53,225
532888350,532885562,532904130,18568,54,225
532910870,532908082,532925997,17915,55,225
532932738,532929949,532948498,18549,56,225
532955239,532952450,532968129,15679,57,225
532974854,532972282,532989663,17381,58,225
532996381,532993809,533010559,16750,59,225
533017299,533014511,533030189,15678,60,225
533036928,533034140,533052076,17936,61,225
533058816,533056028,533072674,16646,62,225
533079416,533076626,533095196,18570,63,225
533101936,533099148,533115775,16627,64,225
533122515,533119727,533137642,17915,65,225
533144376,533141804,533158869,17065,66,225
533165587,533163016,533179763,16747,67,225
533186503,533183715,533201946,18231,68,225
533208686,533205898,533221576,15678,69,225
533228315,533225527,533241204,15677,70,225
533247943,533245156,533263407,18251,71,225
533270147,533267359,533284958,17599,72,225
533291698,533288910,533306193,17283,73,225
533312915,533310343,533327093,16750,74,225
533333834,533331045,533346408,15363,75,225
533353120,533350548,533367930,17382,76,225
533374639,533372068,533389450,17382,77,225
533396190,533393402,533408763,15361,78,225
533415501,533412714,533429023,16309,79,225
533435763,533432975,533449625,16650,80,225
533456366,533453794,533471176,17382,81,225
533477916,533475128,533492072,16944,82,225
533498813,533496024,533512357,16333,83,225
533519097,533516309,533532641,16332,84,225
533539381,533536593,533555478,18885,85,225
533562219,533559430,533574792,15362,86,225
533581521,533578950,533594726,15776,87,225
533601465,533598677,533615959,17282,88,225
533622699,533619911,533636244,16333,89,225
533642959,533640386,533656820,16434,90,225
533663560,533660772,533677717,16945,91,225
533684457,533681669,533698001,16332,92,225
533704741,533701953,533719233,17280,93,225
533725973,533723185,533739834,16649,94,225
533746574,533743787,533759780,15993,95,225
533766520,533763732,533780696,16964,96,225
533787437,533784648,533801593,16945,97,225
533808333,533805545,533823461,17916,98,225
533830201,533827413,533844379,16966,99,225
533851118,533848331,533864661,16330,100,225
533871490,533868702,533885350,16648,101,225
533892181,533889391,533905704,16313,102,225
533912534,533909745,533926057,16312,103,225
533932886,533930098,533946113,16015,104,225
533952943,533950154,533965517,15363,105,225
533972347,533969558,533987812,18254,106,225
533994547,533991975,534009674,17699,107,225
534016503,534013715,534031968,18253,108,225
534038798,534036009,534052638,16629,109,225
534059468,534056679,534073308,16629,110,225
534080137,534077349,534094948,17599,111,225
534101778,534098989,534115639,16650,112,225
534122468,534119680,534135357,15677,113,225
534142185,534139397,534155074,15677,114,225
534161904,534159114,534174794,15680,115,225
534181623,534178834,534195485,16651,116,225
534202314,534199526,534214570,15044,117,225
534221398,534218610,534236209,17599,118,225
534243038,534240250,534254978,14728,119,225
534261807,534259018,534276301,17283,120,225
534283131,534280343,534295704,15361,121,225
534302532,534299744,534317659,17915,122,225
534324489,534321700,534337379,15679,123,225
534344207,534341419,534357097,15678,124,225
534363927,534361137,534376185,15048,125,225
534383014,534380225,534397509,17284,126,225
534404223,534401652,534420638,18986,127,225
534427466,534424679,534439722,15043,128,225
534446550,534443762,534460707,16945,129,225
534467536,534464748,534482030,17282,130,225
534488760,534486188,534503255,17067,131,225
534510085,534507296,534524896,17600,132,225
534531724,534528937,534545246,16309,133,225
534552076,534549287,534567225,17938,134,225
534574055,534571266,534587598,16332,135,225
534594317,534591746,534609148,17402,136,225
534615977,534613189,534630470,17281,137,225
534637299,534634511,534651793,17282,138,225
534658622,534655834,534672145,16311,139,225
534678975,534676186,534694417,18231,140,225
534701247,534698458,534716691,18233,141,225
534723521,534720732,534737043,16311,142,225
534743872,534741084,534757099,16015,143,225
534763928,534761140,534779393,18253,144,225
534786223,534783434,534800401,16967,145,225
534807230,534804442,534819486,15044,146,225
534826314,534823526,534840807,17281,147,225
534847635,534844848,534863099,18251,148,225
534869928,534867140,534885075,17935,149,225
534891904,534889116,534905765,16649,150,225
534912594,534909806,534925485,15679,151,225
534932314,534929525,534947124,17599,152,225
534953851,534951280,534968346,17066,153,225
534975176,534972387,534989352,16965,154,225
534996181,534993393,535008438,15045,155,225
535015157,535012586,535028363,15777,156,225
535035192,535032403,535056839,24436,157,225
535063668,535060880,535078161,17281,158,225
535084989,535082202,535099165,16963,159,225
535105994,535103206,535119200,15994,160,225
535125928,535123357,535141054,17697,161,225
535147883,535145095,535162715,17620,162,225
535169545,535166757,535185641,18884,163,225
535192472,535189683,535205700,16017,164,225
535212530,535209741,535227023,17282,165,225
535233852,535231064,535249316,18252,166,225
535256147,535253358,535268721,15363,167,225
535275550,535272762,535287491,14729,168,225
535294320,535291532,535310418,18886,169,225
535317249,535314460,535330456,15996,170,225
535337195,535334624,535351689,17065,171,225
535358416,535355845,535372277,16432,172,225
535378998,535376427,535392858,16431,173,225
535399582,535397010,535412788,15778,174,225
535419516,535416944,535433377,16433,175,225
535440207,535437419,535454363,16944,176,225
535461194,535458405,535476320,17915,177,225
535483150,535480362,535497328,16966,178,225
535504159,535501370,535519603,18233,179,225
535526434,535523645,535539325,15680,180,225
535546155,535543366,535561282,17916,181,225
535568112,535565324,535582606,17282,182,225
535589338,535586767,535601912,15145,183,225
535608741,535605953,535622265,16312,184,225
535629096,535626307,535642957,16650,185,225
535649787,535646999,535663311,16312,186,225
535670142,535667353,535685269,17916,187,225
535692099,535689311,535704039,14728,188,225
535710869,535708080,535725363,17283,189,225
535732194,535729405,535745717,16312,190,225
535752547,535749759,535768010,18251,191,225
535774842,535772052,535789336,17284,192,225
535796058,535793486,535809264,15778,193,225
535816094,535813305,535831222,17917,194,225
535838051,535835264,535852228,16964,195,225
535859059,535856270,535872266,15996,196,225
535879095,535876307,535895192,18885,197,225
535902023,535899234,535914914,15680,198,225
535921743,535918955,535934633,15678,199,225
535941464,535938675,535955959,17284,200,225
535962791,535960001,535977285,17284,201,225
535984114,535981327,535997975,16648,202,225
536004807,536002018,536019301,17283,203,225
536026131,536023343,536041595,18252,204,225
536048425,536045637,536063890,18253,205,225
536070721,536067932,536082978,15046,206,225
536089807,536087019,536103962,16943,207,225
536110682,536108110,536124521,16411,208,225
536131351,536128563,536146477,17914,209,225
536153307,536150519,536167802,17283,210,225
536174631,536171844,536190074,18230,211,225
536196904,536194116,536210111,15995,212,225
536216940,536214153,536231116,16963,213,225
536237948,536235158,536251808,16650,214,225
536258638,536255850,536271845,15995,215,225
536278674,536275886,536295089,19203,216,225
536301919,536299131,536318016,18885,217,225
536324848,536322059,536339341,17282,218,225
536346171,536343383,536360665,17282,219,225
536367495,536364707,536381336,16629,220,225
536388166,536385378,536401373,15995,221,225
536408204,536405415,536420460,15045,222,225
536427289,536424501,536441445,16944,223,225
536448275,536445487,536462114,16627,224,225
536468944,536466156,536482803,16647,225,225
536489633,536486845,536502524,15679,226,225
536509355,536506565,536524820,18255,227,225
536531651,536528862,536547431,18569,228,225
536554261,536551473,536568438,16965,229,225
536575268,536572480,536591048,18568,230,225
536597880,536595091,536613977,18886,231,225
536620808,536618019,536634352,16333,232,225
536641183,536638394,536655677,17283,233,225
536662508,536659720,536677001,17281,234,225
536683831,536681043,536696720,15677,235,225
536703551,536700762,536716124,15362,236,225
536722853,536720282,536738296,18014,237,225
536745126,536742338,536761224,18886,238,225
536768054,536765266,536784468,19202,239,225
536791298,536788510,536803872,15362,240,225
536810701,536807913,536825511,17598,241,225
536832341,536829553,536846181,16628,242,225
536853011,536850223,536867822,17599,243,225
536874653,536871864,536890751,18887,244,225
536897581,536894793,536912391,17598,245,225
536919222,536916433,536934664,18231,246,225
536941494,536938706,536955966,17260,247,225
536962796,536960008,536976003,15995,248,225
536982833,536980044,536997328,17284,249,225
537004066,537001495,537019193,17698,250,225
537026023,537023235,537041467,18232,251,225
537048298,537045510,537064712,19202,252,225
537071543,537068754,537087641,18887,253,225
537094472,537091684,537108649,16965,254,225
537115386,537112814,537130513,17699,255,225
537137246,537134675,537152057,17382,256,225
537158887,537156099,537172430,16331,257,225
537179168,537176596,537193978,17382,258,225
537200692,537198120,537215186,17066,259,225
537222017,537219229,537237144,17915,260,225
537243878,537241307,537258055,16748,261,225
537264886,537262097,537278726,16629,262,225
537285556,537282768,537299418,16650,263,225
537306249,537303460,537319455,15995,264,225
537326285,537323497,537339174,15677,265,225
537346004,537343216,537358577,15361,266,225
537365408,537362619,537379586,16967,267,225
537386418,537383628,537402200,18572,268,225
537408918,537406346,537425333,18987,269,225
537432163,537429375,537446973,17598,270,225
537453804,537451015,537468953,17938,271,225
537475784,537472995,537488041,15046,272,225
537494871,537492082,537507128,15046,273,225
537513959,537511170,537528453,17283,274,225
537535284,537532495,537548807,16312,275,225
537555638,537552849,537570766,17917,276,225
537577596,537574808,537592407,17599,277,225
537599237,537596449,537613731,17282,278,225
537620561,537617773,537634104,16331,279,225
537640936,537638146,537654143,15997,280,225
537660972,537658184,537674495,16311,281,225
537681324,537678537,537697421,18884,282,225
537704252,537701463,537719083,17620,283,225
537725914,537723125,537740407,17282,284,225
537747237,537744449,537762364,17915,285,225
537769194,537766406,537784005,17599,286,225
537790835,537788047,537805327,17280,287,225
537812157,537809369,537826967,17598,288,225
537833797,537831009,537846685,15676,289,225
537853515,537850726,537866720,15994,290,225
537873550,537870761,537888044,17283,291,225
537894873,537892086,537908397,16311,292,225
537915228,537912439,537929721,17282,293,225
537936552,537933763,537951046,17283,294,225
537957876,537955088,537972370,17282,295,225
537979200,537976412,537992723,16311,296,225
537999554,537996765,538015969,19204,297,225
538022798,538020011,538036320,16309,298,225
538043149,538040362,538055405,15043,299,225
538062234,538059446,538075441,15995,300,225
538082160,538079588,538096971,17383,301,225
538103710,538101138,538115651,14513,302,225
538122480,538119692,538136657,16965,303,225
538143487,538140699,538156060,15361,304,225
538162891,538160102,538177384,17282,305,225
538184215,538181426,538197422,15996,306,225
538204253,538201464,538218092,16628,307,225
538224819,538222248,538239313,17065,308,225
538246144,538243355,538259667,16312,309,225
538266498,538263709,538279388,15679,310,225
538286217,538283429,538300394,16965,311,225
538307225,538304436,538321719,17283,312,225
538328550,538325761,538341757,15996,313,225
538348587,538345798,538363735,17937,314,225
538370566,538367777,538383139,15362,315,225
538389969,538387181,538403513,16332,316,225
538410249,538407678,538423477,15799,317,225
538430210,538427639,538446307,18668,318,225
538453138,538450349,538467631,17282,319,225
538474462,538471673,538487035,15362,320,225
538493865,538491077,538508676,17599,321,225
538515506,538512718,538529979,17261,322,225
538536809,538534021,538550669,16648,323,225
538557499,538554711,538571675,16964,324,225
538578506,538575717,538591080,15363,325,225
538597910,538595122,538611116,15994,326,225
538617947,538615158,538632442,17284,327,225
538639272,538636484,538653427,16943,328,225
538660256,538657469,538675699,18230,329,225
538682528,538679741,538697655,17914,330,225
538704485,538701697,538719295,17598,331,225
538726125,538723337,538739986,16649,332,225
538746816,538744028,538761626,17598,333,225
538768457,538765668,538782613,16945,334,225
538789443,538786655,538803303,16648,335,225
538810132,538807345,538823021,15676,336,225
538829851,538827063,538844977,17914,337,225
538851807,538849019,538866935,17916,338,225
538873767,538870977,538887627,16650,339,225
538894457,538891669,538909268,17599,340,225
538916098,538913310,538930274,16964,341,225
538937105,538934316,538951915,17599,342,225
538958746,538955957,538974844,18887,343,225
538981674,538978886,538996167,17281,344,225
539002892,539000320,539018990,18670,345,225
539025821,539023032,539041603,18571,346,225
539048434,539045645,539063898,18253,347,225
539070729,539067940,539085222,17282,348,225
539092053,539089264,539105575,16311,349,225
539112405,539109617,539127532,17915,350,225
539134256,539131686,539149067,17381,351,225
539155897,539153109,539170074,16965,352,225
539176785,539174213,539189674,15461,353,225
539196505,539193716,539210028,16312,354,225
539216859,539214070,539232324,18254,355,225
539239154,539236366,539253015,16649,356,225
539259845,539257057,539272736,15679,357,225
539279568,539276778,539292459,15681,358,225
539299288,539296500,539313782,17282,359,225
539320504,539317933,539334661,16728,360,225
539341490,539338703,539355330,16627,361,225
539362161,539359372,539377943,18571,362,225
539384773,539381985,539398318,16333,363,225
539405147,539402360,539418669,16309,364,225
539425498,539422711,539439359,16648,365,225
539446189,539443401,539461654,18253,366,225
539468484,539465696,539483949,18253,367,225
539490781,539487991,539503987,15996,368,225
539510817,539508029,539523708,15679,369,225
539530538,539527749,539542795,15046,370,225
539549624,539546836,539565722,18886,371,225
539572552,539569764,539587046,17282,372,225
539593876,539591088,539608687,17599,373,225
539615517,539612729,539630328,17599,374,225
539637158,539634370,539651969,17599,375,225
539658800,539656011,539672978,16967,376,225
539679807,539677020,539695251,18231,377,225
539702082,539699293,539716576,17283,378,225
539723406,539720618,539738869,18251,379,225
539745604,539743032,539758494,15462,380,225
539765325,539762536,539779818,17282,381,225
539786544,539783972,539800384,16412,382,225
539807215,539804427,539821392,16965,383,225
539828223,539825435,539841112,15677,384,225
539847943,539845154,539864357,19203,385,225
539871076,539868505,539885232,16727,386,225
539892062,539889274,539906239,16965,387,225
539913070,539910281,539925961,15680,388,225
539932792,539930003,539946970,16967,389,225
539953801,539951012,539967325,16313,390,225
539974156,539971368,539987362,15994,391,225
539994190,539991403,540008346,16943,392,225
540015177,540012389,540029038,16649,393,225
540035869,540033080,540051966,18886,394,225
540058798,540056009,540072974,16965,395,225
540079804,540077016,540093349,16333,396,225
540100180,540097391,540113725,16334,397,225
540120555,540117767,540135387,17620,398,225
540142218,540139430,540157028,17598,399,225
540163751,540161179,540178562,17383,400,225
540185392,540182604,540197648,15044,401,225
540204478,540201689,540218656,16967,402,225
540225487,540222698,540239980,17282,403,225
540246809,540244022,540262253,18231,404,225
540269083,540266295,540283261,16966,405,225
540290091,540287303,540304586,17283,406,225
540311416,540308628,540324623,15995,407,225
540331453,540328665,540347550,18885,408,225
540354381,540351592,540367902,16310,409,225
540374624,540372052,540389435,17383,410,225
540396265,540393477,540411708,18231,411,225
540418538,540415750,540433031,17281,412,225
540439862,540437073,540454988,17915,413,225
540461718,540459147,540475263,16116,414,225
540482093,540479305,540497558,18253,415,225
540504389,540501600,540517616,16016,416,225
540524446,540521658,540538307,16649,417,225
540545137,540542349,540560919,18570,418,225
540567750,540564961,540583848,18887,419,225
540590679,540587891,540606460,18569,420,225
540613291,540610502,540625865,15363,421,225
540632592,540630020,540646115,16095,422,225
540652946,540650157,540667124,16967,423,225
540673955,540671167,540687816,16649,424,225
540694648,540691859,540708509,16650,425,225
540715339,540712551,540731436,18885,426,225
540738266,540735478,540752443,16965,427,225
540759273,540756485,540772817,16332,428,225
540779648,540776859,540794143,17284,429,225
540800973,540798185,540815466,17281,430,225
540822297,540819508,540834553,15045,431,225
540841383,540838594,540853954,15360,432,225
540860783,540857995,540873990,15995,433,225
540880722,540878151,540895216,17065,434,225
540902047,540899258,540915571,16313,435,225
540922401,540919613,540935925,16312,436,225
540942755,540939967,540956931,16964,437,225
540963761,540960973,540983828,22855,438,225
540990559,540987987,541003450,15463,439,225
541010172,541007600,541022746,15146,440,225
541029574,541026787,541043436,16649,441,225
541050267,541047478,541064443,16965,442,225
541071273,541068485,541086737,18252,443,225
541093566,541090779,541107743,16964,444,225
541114573,541111785,541127461,15676,445,225
541134290,541131502,541148151,16649,446,225
541154982,541152193,541169475,17282,447,225
541176196,541173624,541190055,16431,448,225
541196886,541194097,541212013,17916,449,225
541218737,541216166,541233232,17066,450,225
541240062,541237274,541254873,17599,451,225
541261704,541258915,541274594,15679,452,225
541281424,541278636,541295919,17283,453,225
541302750,541299961,541317243,17282,454,225
541324073,541321285,541338251,16966,455,225
541345081,541342293,541359575,17282,456,225
541366405,541363617,541381552,17935,457,225
541388382,541385594,541401947,16353,458,225
541408778,541405989,541423589,17600,459,225
541430420,541427631,541445230,17599,460,225
541452060,541449272,541466554,17282,461,225
541473384,541470596,541487878,17282,462,225
541494708,541491920,541508568,16648,463,225
541515400,541512610,541531497,18887,464,225
541538326,541535539,541552186,16647,465,225
541559016,541556228,541574480,18252,466,225
541581310,541578522,541595150,16628,467,225
541601980,541599192,541617760,18568,468,225
541624590,541621802,541637479,15677,469,225
541644309,541641521,541658487,16966,470,225
541665317,541662529,541677575,15046,471,225
541684405,541681616,541697611,15995,472,225
541704442,541701653,541718619,16966,473,225
541725449,541722661,541741231,18570,474,225
541748062,541745273,541760635,15362,475,225
541767465,541764677,541783562,18885,476,225
541790393,541787604,541804886,17282,477,225
541811717,541808928,541824289,15361,478,225
541831118,541828330,541844008,15678,479,225
541850837,541848049,541863726,15677,480,225
541870448,541867876,541885575,17699,481,225
541892404,541889617,541906582,16965,482,225
541913315,541910745,541927493,16748,483,225
541934323,541931535,541949134,17599,484,225
541955965,541953176,541969487,16311,485,225
541976318,541973529,541992417,18888,486,225
541999148,541996577,542015562,18985,487,225
542022393,542019604,542037204,17600,488,225
542044034,542041246,542060131,18885,489,225
542066961,542064173,542081139,16966,490,225
542087970,542085181,542102463,17282,491,225
542109294,542106505,542122501,15996,492,225
542129331,542126542,542144142,17600,493,225
542150972,542148184,542166099,17915,494,225
542172930,542170141,542187741,17600,495,225
542194570,542191783,542209064,17281,496,225
542215895,542213107,542228153,15046,497,225
542234982,542232195,542249477,17282,498,225
542256307,542253519,542271434,17915,499,225
542278264,542275476,542293073,17597,500,225
542299904,542297115,542313765,16650,501,225
542320596,542317807,542336695,18888,502,225
542343525,542340737,542356415,15678,503,225
542363245,542360457,542376790,16333,504,225
542383521,542380949,542398985,18036,505,225
542405816,542403027,542418390,15363,506,225
542425221,542422432,542437794,15362,507,225
542444624,542441836,542459119,17283,508,225
542465949,542463162,542481077,17915,509,225
542487800,542485229,542501661,16432,510,225
542508492,542505704,542522986,17282,511,225
542529818,542527028,542544313,17285,512,225
542551145,542548356,542564669,16313,513,225
542571500,542568711,542584707,15996,514,225
542591538,542588749,542605398,16649,515,225
542612229,542609440,542624505,15065,516,225
542631336,542628547,542646146,17599,517,225
542652977,542650188,542665889,15701,518,225
542672719,542669931,542687214,17283,519,225
542694044,542691256,542707905,16649,520,225
542714736,542711947,542730835,18888,521,225
542737666,542734877,542752475,17598,522,225
542759304,542756517,542772511,15994,523,225
542779340,542776552,542792547,15995,524,225
542799262,542796691,542812152,15461,525,225
542818982,542816193,542833792,17599,526,225
542840623,542837834,542854483,16649,527,225
542861313,542858525,542877094,18569,528,225
542883925,542881136,542898102,16966,529,225
542904934,542902144,542919112,16968,530,225
542925942,542923154,542940119,16965,531,225
542946949,542944161,542962098,17937,532,225
542968929,542966140,542981502,15362,533,225
542988331,542985543,543001855,16312,534,225
543008685,543005897,543022547,16650,535,225
543029281,543026709,543043437,16728,536,225
543050268,543047479,543065078,17599,537,225
543071909,543069120,543086403,17283,538,225
543093233,543090445,543106439,15994,539,225
543113172,543110601,543128954,18353,540,225
543135785,543132996,543150910,17914,541,225
543157741,543154952,543171582,16630,542,225
543178412,543175624,543194193,18569,543,225
543201024,543198235,543214885,16650,544,225
543221715,543218927,543237496,18569,545,225
543244327,543241538,543257533,15995,546,225
543264364,543261575,543279490,17915,547,225
543286322,543283533,543301132,17599,548,225
543307860,543305288,543321721,16433,549,225
543328553,543325763,543341759,15996,550,225
543348588,543345800,543360529,14729,551,225
543367237,543364666,543381731,17065,552,225
543388562,543385773,543403372,17599,553,225
543410201,543407414,543423725,16311,554,225
543430556,543427768,543442496,14728,555,225
543449325,543446537,543464453,17916,556,225
543471283,543468495,543486093,17598,557,225
543492924,543490136,543507417,17281,558,225
543514248,543511459,543530030,18571,559,225
543536756,543534185,543549646,15461,560,225
543556476,543553688,543570653,16965,561,225
543577484,543574695,543591640,16945,562,225
543598471,543595683,543611044,15361,563,225
543617875,543615086,543630766,15680,564,225
543637598,543634808,543652092,17284,565,225
543658922,543656134,543673414,17280,566,225
543680244,543677456,543695370,17914,567,225
543702199,543699412,543717960,18548,568,225
543724691,543722120,543736949,14829,569,225
543743780,543740991,543757641,16650,570,225
543764471,543761683,543778649,16966,571,225
543785479,543782691,543800290,17599,572,225
543807122,543804333,543822904,18571,573,225
543829625,543827053,543844119,17066,574,225
543850950,543848162,543865105,16943,575,225
543871935,543869147,543885142,15995,576,225
543891972,543889184,543908387,19203,577,225
543915218,543912429,543929373,16944,578,225
543936203,543933416,543949746,16330,579,225
543956576,543953788,543970099,16311,580,225
543976928,543974141,543991739,17598,581,225
543998569,543995781,544014984,19203,582,225
544021720,544019149,544036530,17381,583,225
544043361,544040572,544057854,17282,584,225
544064684,544061896,544078545,16649,585,225
544085376,544082587,544098267,15680,586,225
544105097,544102308,544118618,16310,587,225
544125448,544122660,544138337,15677,588,225
544145057,544142486,544159868,17382,589,225
544166698,544163910,544179588,15678,590,225
544186322,544183750,544201133,17383,591,225
544207843,544205272,544221683,16411,592,225
544228514,544225725,544243642,17917,593,225
544250474,544247684,544265284,17600,594,225
544272114,544269326,544284688,15362,595,225
544291518,544288729,544306666,17937,596,225
544313495,544310708,544328937,18229,597,225
544335767,544332979,544348974,15995,598,225
544355711,544353140,544370521,17381,599,225
544377351,544374563,544391846,17283,600,225
544398678,544395888,544411885,15997,601,225
544418715,544415926,544433526,17600,602,225
544440358,544437569,544455802,18233,603,225
544462537,544459965,544477348,17383,604,225
544484178,544481390,544497701,16311,605,225
544504532,544501743,544519364,17621,606,225
544526195,544523407,544540056,16649,607,225
544546887,544544098,544561064,16966,608,225
544567894,544565106,544581417,16311,609,225
544588249,544585459,544601456,15997,610,225
544608288,544605498,544622466,16968,611,225
544629297,544626508,544641870,15362,612,225
544648698,544645911,544663845,17934,613,225
544670567,544667995,544684745,16750,614,225
544691576,544688788,544705732,16944,615,225
544712563,544709774,544728660,18886,616,225
544735490,544732702,544749013,16311,617,225
544755843,544753055,544770969,17914,618,225
544777799,544775011,544792292,17281,619,225
544799121,544796334,544812328,15994,620,225
544819160,544816370,544832366,15996,621,225
544839196,544836408,544853374,16966,622,225
544860204,544857416,544872776,15360,623,225
544879507,544876936,544894950,18014,624,225
544901780,544898992,544915640,16648,625,225
544922471,544919682,544935360,15678,626,225
544942190,544939402,544956368,16966,627,225
544963197,544960410,544976086,15676,628,225
544982915,544980127,544996122,15995,629,225
545002952,545000164,545016476,16312,630,225
545023305,545020518,545035878,15360,631,225
545042707,545039919,545057518,17599,632,225
545064349,545061561,545078843,17282,633,225
545085674,545082885,545098881,15996,634,225
545105711,545102923,545121492,18569,635,225
545128323,545125535,545141846,16311,636,225
545148676,545145888,545163170,17282,637,225
545170001,545167213,545182256,15043,638,225
545188968,545186396,545201858,15462,639,225
545208687,545205899,545222231,16332,640,225
545229063,545226273,545243556,17283,641,225
545250388,545247599,545264880,17281,642,225
545271712,545268922,545284602,15680,643,225
545291431,545288643,545306262,17619,644,225
545313092,545310304,545326635,16331,645,225
545333465,545330677,545346672,15995,646,225
545353502,545350713,545367996,17283,647,225
545374826,545372038,545389636,17598,648,225
545396366,545393794,545410544,16750,649,225
545417375,545414586,545430265,15679,650,225
545437094,545434306,545451925,17619,651,225
545458755,545455967,545474197,18230,652,225
545481028,545478239,545495205,16966,653,225
545502037,545499247,545515899,16652,654,225
545522730,545519941,545536590,16649,655,225
545543323,545540751,545556213,15462,656,225
545563045,545560255,545575619,15364,657,225
545582449,545579660,545596309,16649,658,225
545603139,545600351,545617633,17282,659,225
545624464,545621675,545638304,16629,660,225
545645135,545642346,545658342,15996,661,225
545665171,545662383,545679347,16964,662,225
545686177,545683389,545700988,17599,663,225
545707818,545705030,545720391,15361,664,225
545727220,545724432,545740743,16311,665,225
545747479,545744907,545763259,18352,666,225
545770090,545767301,545783950,16649,667,225
545790781,545787992,545804959,16967,668,225
545811788,545809001,545827252,18251,669,225
545834083,545831294,545847289,15995,670,225
545854119,545851330,545867007,15677,671,225
545873726,545871154,545886616,15462,672,225
545893446,545890658,545908910,18252,673,225
545915742,545912952,545928949,15997,674,225
545935779,545932990,545949323,16333,675,225
545956154,545953365,545971934,18569,676,225
545978765,545975976,545992943,16967,677,225
545999656,545997085,546013516,16431,678,225
546020347,546017558,546033869,16311,679,225
546040699,546037911,546055193,17282,680,225
546062024,546059235,546077150,17915,681,225
546083981,546081192,546098474,17282,682,225
546105304,546102516,546118849,16333,683,225
546125680,546122891,546138887,15996,684,225
546145718,546142929,546159896,16967,685,225
546166726,546163938,546181536,17598,686,225
546188367,546185578,546203832,18254,687,225
546210663,546207874,546224840,16966,688,225
546231670,546228882,546246165,17283,689,225
546252894,546250322,546267050,16728,690,225
546273879,546271092,546288372,17280,691,225
546295202,546292414,546310666,18252,692,225
546317496,546314708,546331673,16965,693,225
546338503,546335715,546352047,16332,694,225
546358778,546356207,546374222,18015,695,225
546380945,546378374,546396071,17697,696,225
546402902,546400114,546417712,17598,697,225
546424430,546421859,546439578,17719,698,225
546446409,546443620,546459298,15678,699,225
546466129,546463340,546481594,18254,700,225
546488424,546485636,546501946,16310,701,225
546508776,546505988,546523904,17916,702,225
546530735,546527946,546544913,16967,703,225
546551745,546548956,546564634,15678,704,225
546571465,546568676,546586592,17916,705,225
546593422,546590634,546608233,17599,706,225
546615063,546612275,546628586,16311,707,225
546635416,546632628,546650858,18230,708,225
546657689,546654900,546673470,18570,709,225
546680300,546677512,546694793,17281,710,225
546701624,546698835,546715801,16966,711,225
546722631,546719843,546735204,15361,712,225
546742035,546739246,546756212,16966,713,225
546762940,546760369,546777750,17381,714,225
546784581,546781792,546797810,16018,715,225
546804642,546801852,546819137,17285,716,225
546825967,546823179,546841094,17915,717,225
546847924,546845136,546861467,16331,718,225
546868181,546865611,546883646,18035,719,225
546890478,546887688,546904971,17283,720,225
546911802,546909013,546925326,16313,721,225
546932156,546929368,546947938,18570,722,225
546954768,546951980,546966709,14729,723,225
546973540,546970751,546988033,17282,724,225
546994864,546992075,547009358,17283,725,225
547016080,547013508,547031228,17720,726,225
547038058,547035270,547050316,15046,727,225
547057028,547054457,547072493,18036,728,225
547079322,547076535,547092213,15678,729,225
547099042,547096255,547114485,18230,730,225
547121315,547118527,547136781,18254,731,225
547143611,547140823,547156839,16016,732,225
547163669,547160881,547177847,16966,733,225
547184677,547181889,547198855,16966,734,225
547205686,547202898,547219546,16648,735,225
547226376,547223588,547238949,15361,736,225
547245778,547242990,547259954,16964,737,225
547266785,547263996,547279992,15996,738,225
547286822,547284033,547301948,17915,739,225
547308778,547305990,547323272,17282,740,225
547330104,547327314,547344598,17284,741,225
547351428,547348640,547365921,17281,742,225
547372752,547369963,547387584,17621,743,225
547394414,547391626,547408590,16964,744,225
547415421,547412632,547431519,18887,745,225
547438349,547435561,547450290,14729,746,225
547457119,547454331,547472584,18253,747,225
547479415,547476626,547492305,15679,748,225
547499135,547496347,547511392,15045,749,225
547518221,547515433,547532081,16648,750,225
547538794,547536222,547552317,16095,751,225
547559147,547556359,547573323,16964,752,225
547580032,547577462,547594526,17064,753,225
547601358,547598568,547613932,15364,754,225
547620762,547617974,547635573,17599,755,225
547642310,547639738,547656488,16750,756,225
547663318,547660530,547677158,16628,757,225
547683990,547681200,547698484,17284,758,225
547705314,547702526,547719491,16965,759,225
547726321,547723533,547739211,15678,760,225
547746040,547743253,547761504,18251,761,225
547768233,547765662,547782072,16410,762,225
547788904,547786115,547802111,15996,763,225
547808942,547806153,547823119,16966,764,225
547829950,547827162,547844759,17597,765,225
547851590,547848802,547864797,15995,766,225
547871626,547868838,547884831,15993,767,225
547891661,547888873,547905520,16647,768,225
547912350,547909562,547926526,16964,769,225
547933356,547930568,547945929,15361,770,225
547952760,547949970,547966937,16967,771,225
547973767,547970979,547987942,16963,772,225
547994773,547991984,548009584,17600,773,225
548016415,548013626,548029643,16017,774,225
548036473,548033685,548049680,15995,775,225
548056510,548053721,548070032,16311,776,225
548076861,548074074,548089435,15361,777,225
548096265,548093477,548112047,18570,778,225
548118876,548116089,548131450,15361,779,225
548138281,548135491,548154695,19204,780,225
548161525,548158737,548174752,16015,781,225
548181581,548178794,548196075,17281,782,225
548202905,548200117,548218368,18251,783,225
548225198,548222410,548239376,16966,784,225
548246206,548243418,548261017,17599,785,225
548267847,548265059,548282658,17599,786,225
548289396,548286824,548304523,17699,787,225
548311355,548308566,548326482,17916,788,225
548333312,548330524,548346856,16332,789,225
548353687,548350898,548367548,16650,790,225
548374378,548371591,548388555,16964,791,225
548395386,548392597,548408277,15680,792,225
548415107,548412319,548427997,15678,793,225
548434826,548432039,548447399,15360,794,225
548454228,548451440,548467751,16311,795,225
548474583,548471794,548489394,17600,796,225
548496224,548493436,548509114,15678,797,225
548515944,548513156,548529151,15995,798,225
548535982,548533193,548548555,15362,799,225
548555385,548552597,548569247,16650,800,225
548575986,548573414,548589847,16433,801,225
548596679,548593890,548610224,16334,802,225
548616934,548614362,548631765,17403,803,225
548638595,548635807,548652119,16312,804,225
548658950,548656161,548672495,16334,805,225
548679220,548676648,548693714,17066,806,225
548700544,548697756,548715671,17915,807,225
548722501,548719713,548736995,17282,808,225
548743825,548741037,548758634,17597,809,225
548765360,548762788,548779537,16749,810,225
548786368,548783580,548800546,16966,811,225
548807376,548804588,548821870,17282,812,225
548828702,548825913,548843195,17282,813,225
548850025,548847237,548862916,15679,814,225
548869746,548866958,548882953,15995,815,225
548889781,548886994,548902038,15044,816,225
548908867,548906079,548923044,16965,817,225
548929875,548927086,548945340,18254,818,225
548952173,548949382,548967955,18573,819,225
548974785,548971997,548988646,16649,820,225
548995477,548992688,549009020,16332,821,225
549015851,549013062,549031315,18253,822,225
549038144,549035357,549052005,16648,823,225
549058835,549056047,549073329,17282,824,225
549080160,549077371,549094000,16629,825,225
549100831,549098043,549114692,16649,826,225
549121523,549118734,549137304,18570,827,225
549144028,549141456,549158205,16749,828,225
549165034,549162247,549178578,16331,829,225
549185408,549182620,549198299,15679,830,225
549205130,549202341,549219307,16966,831,225
549226138,549223349,549240631,17282,832,225
549247461,549244673,549261321,16648,833,225
549268151,549265363,549283299,17936,834,225
549290129,549287341,549302386,15045,835,225
549309215,549306428,549325312,18884,836,225
549332142,549329354,549346636,17282,837,225
549353466,549350678,549367643,16965,838,225
549374473,549371685,549388650,16965,839,225
549395383,549392810,549409222,16412,840,225
549416052,549413264,549429912,16648,841,225
549436742,549433954,549451572,17618,842,225
549458402,549455614,549470976,15362,843,225
549477806,549475018,549491351,16333,844,225
549498181,549495393,549513646,18253,845,225
549520477,549517688,549533705,16017,846,225
549540535,549537747,549555346,17599,847,225
549562177,549559388,549576671,17283,848,225
549583502,549580714,549597045,16331,849,225
549603877,549601088,549615817,14729,850,225
549622649,549619859,549638747,18888,851,225
549645578,549642789,549661021,18232,852,225
549667853,549665064,549683316,18252,853,225
549690146,549687358,549704639,17281,854,225
549711470,549708681,549726934,18253,855,225
549733764,549730976,549748912,17936,856,225
549755743,549752954,549768633,15679,857,225
549775464,549772675,549791562,18887,858,225
549798392,549795604,549812232,16628,859,225
549819063,549816274,549831636,15362,860,225
549838466,549835678,549853276,17598,861,225
549860107,549857318,549874897,17579,862,225
549881729,549878940,549893987,15047,863,225
549900722,549898152,549915196,17044,864,225
549921912,549919341,549936405,17064,865,225
549943235,549940447,549957412,16965,866,225
549964243,549961454,549978421,16967,867,225
549985252,549982463,549998142,15679,868,225
550004972,550002184,550019465,17281,869,225
550026297,550023507,550039820,16313,870,225
550046650,550043862,550059539,15677,871,225
550066370,550063581,550080527,16946,872,225
550087358,550084570,550102824,18254,873,225
550109654,550106866,550124464,17598,874,225
550131295,550128507,550146737,18230,875,225
550153568,550150779,550168062,17283,876,225
550174893,550172104,550188100,15996,877,225
550194930,550192142,550210690,18548,878,225
550217521,550214733,550231045,16312,879,225
550237764,550235192,550250654,15462,880,225
550257483,550254696,550270374,15678,881,225
550277204,550274416,550292332,17916,882,225
550299163,550296374,550311737,15363,883,225
550318567,550315779,550334663,18884,884,225
550341495,550338706,550355968,17262,885,225
550362799,550360011,550377925,17914,886,225
550384756,550381968,550398934,16966,887,225
550405766,550402977,550419943,16966,888,225
550426773,550423985,550442236,18251,889,225
550449067,550446279,550463245,16966,890,225
550469983,550467412,550482556,15144,891,225
550489386,550486598,550504514,17916,892,225
550511250,550508677,550525111,16434,893,225
550531851,550529279,550546344,17065,894,225
550553174,550550386,550567352,16966,895,225
550574182,550571394,550589962,18568,896,225
550596793,550594004,550609682,15678,897,225
550616394,550613822,550628334,14512,898,225
550635163,550632375,550651576,19201,899,225
550658408,550655618,550673554,17936,900,225
550680292,550677721,550692549,14828,901,225
550699379,550696590,550714506,17916,902,225
550721337,550718548,550733910,15362,903,225
550740739,550737951,550755233,17282,904,225
550762064,550759275,550776873,17598,905,225
550783703,550780915,550798830,17915,906,225
550805660,550802872,550819521,16649,907,225
550826352,550823563,550841796,18233,908,225
550848628,550845838,550863122,17284,909,225
550869952,550867164,550885417,18253,910,225
550892247,550889459,550906742,17283,911,225
550913572,550910784,550928065,17281,912,225
550934896,550932107,550949368,17261,913,225
550956198,550953410,550972611,19201,914,225
550979442,550976653,550994274,17621,915,225
551001104,550998316,551013678,15362,916,225
551020509,551017720,551033398,15678,917,225
551040228,551037439,551054720,17281,918,225
551061431,551058859,551076559,17700,919,225
551083389,551080601,551097567,16966,920,225
551104398,551101609,551119545,17936,921,225
551126375,551123587,551139581,15994,922,225
551146411,551143622,551160272,16650,923,225
551167103,551164314,551183202,18888,924,225
551190033,551187244,551202290,15046,925,225
551209120,551206332,551221377,15045,926,225
551228206,551225418,551242383,16965,927,225
551249213,551246425,551262103,15678,928,225
551268933,551266144,551281189,15045,929,225
551288018,551285230,551303462,18232,930,225
551310293,551307504,551324449,16945,931,225
551331279,551328491,551346068,17577,932,225
551352898,551350110,551367076,16966,933,225
551373906,551371118,551386163,15045,934,225
551392994,551390205,551408121,17916,935,225
551414951,551412163,551427525,15362,936,225
551434355,551431566,551449165,17599,937,225
551455995,551453207,551471438,18231,938,225
551478268,551475480,551492129,16649,939,225
551498959,551496171,551512820,16649,940,225
551519651,551516862,551532540,15678,941,225
551539370,551536582,551551943,15361,942,225
551558773,551555985,551579430,23445,943,225
551586261,551583473,551601704,18231,944,225
551608534,551605746,551622711,16965,945,225
551629541,551626753,551642430,15677,946,225
551649260,551646472,551664070,17598,947,225
551670901,551668113,551684425,16312,948,225
551691256,551688468,551706720,18252,949,225
551713551,551710763,551728045,17282,950,225
551734876,551732087,551747449,15362,951,225
551754278,551751490,551770375,18885,952,225
551777206,551774418,551793303,18885,953,225
551800134,551797345,551812074,14729,954,225
551818790,551816218,551831363,15145,955,225
551838193,551835404,551851399,15995,956,225
551858229,551855441,551873376,17935,957,225
551880205,551877418,551895332,17914,958,225
551902163,551899375,551915370,15995,959,225
551922200,551919412,551936695,17283,960,225
551943525,551940737,551957386,16649,961,225
551964216,551961428,551978394,16966,962,225
551985113,551982541,551999605,17064,963,225
552006335,552003763,552021778,18015,964,225
552028608,552025820,552041498,15678,965,225
552048328,552045540,552062800,17260,966,225
552069630,552066842,552085727,18885,967,225
552092558,552089769,552104499,14730,968,225
552111216,552108645,552124105,15460,969,225
552130935,552128147,552145429,17282,970,225
552152259,552149471,552166753,17282,971,225
552173582,552170795,552186156,15361,972,225
552192986,552190197,552208767,18570,973,225
552215597,552212809,552230408,17599,974,225
552237239,552234450,552251079,16629,975,225
552257909,552255121,552271137,16016,976,225
552277967,552275179,552292778,17599,977,225
552299609,552296820,552315053,18233,978,225
552321884,552319095,552335744,16649,979,225
552342470,552339898,552355994,16096,980,225
552362826,552360036,552375716,15680,981,225
552382546,552379758,552398327,18569,982,225
552405157,552402369,552419018,16649,983,225
552425848,552423060,552439371,16311,984,225
552446202,552443413,552458458,15045,985,225
552465287,552462499,552481702,19203,986,225
552488532,552485744,552502393,16649,987,225
552509223,552506435,552521162,14727,988,225
552527873,552525301,552542366,17065,989,225
552549197,552546409,552564661,18252,990,225
552571491,552568703,552587906,19203,991,225
552594737,552591949,552608598,16649,992,225
552615429,552612640,552631210,18570,993,225
552638041,552635253,552653189,17936,994,225
552660019,552657231,552674514,17283,995,225
552681344,552678556,552696154,17598,996,225
552702985,552700196,552717796,17600,997,225
552724628,552721839,552737519,15680,998,225
552744349,552741561,552758842,17281,999,225
552765673,552762884,552779851,16967,1000,225
552786770,552783982,552801897,17915,1001,225
552808817,552806028,552821390,15362,1002,225
552828309,552825521,552843120,17599,1003,225
552850038,552847251,552866137,18886,1004,225
552873056,552870268,552887234,16966,1005,225
552894048,552891476,552909175,17699,1006,225
552916094,552913306,552929616,16310,1007,225
552936536,552933747,552951031,17284,1008,225
552957951,552955163,552973414,18251,1009,225
552980333,552977545,552993877,16332,1010,225
553000703,552998130,553015513,17383,1011,225
553022432,553019644,553037897,18253,1012,225
553044816,553042028,553057389,15361,1013,225
553064307,553061519,553078800,17281,1014,225
553085616,553083044,553101081,18037,1015,225
553108000,553105212,553124414,19202,1016,225
553131233,553128661,553145073,16412,1017,225
553151993,553149204,553166170,16966,1018,225
553173089,553170301,553189187,18886,1019,225
553196106,553193318,553210284,16966,1020,225
553217203,553214415,553231380,16965,1021,225
553238299,553235511,553252476,16965,1022,225
553259397,553256607,553273257,16650,1023,225
553280073,553277501,553292963,15462,1024,225
553299881,553297093,553313721,16628,1025,225
553320640,553317852,553334184,16332,1026,225
553341103,553338315,553356231,17916,1027,225
553363054,553360482,553377211,16729,1028,225
553384021,553381449,553399801,18352,1029,225
553406721,553403932,553421553,17621,1030,225
553428472,553425684,553442650,16966,1031,225
553449570,553446781,553463727,16946,1032,225
553470647,553467858,553485139,17281,1033,225
553492060,553489270,553505267,15997,1034,225
553512187,553509398,553526998,17600,1035,225
553533917,553531129,553546490,15361,1036,225
553553410,553550621,553567904,17283,1037,225
553574823,553572035,553589317,17282,1038,225
553596136,553593563,553608710,15147,1039,225
553615629,553612840,553629490,16650,1040,225
553636409,553633621,553648982,15361,1041,225
553655900,553653112,553672314,19202,1042,225
553679233,553676445,553693726,17281,1043,225
553700646,553697857,553713220,15363,1044,225
553720138,553717350,553735582,18232,1045,225
553742405,553739833,553757215,17382,1046,225
553764135,553761346,553778628,17282,1047,225
553785547,553782759,553799408,16649,1048,225
553806327,553803538,553821136,17598,1049,225
553828056,553825267,553842550,17283,1050,225
553849469,553846681,553862359,15678,1051,225
553869278,553866489,553883456,16967,1052,225
553890276,553887705,553905085,17380,1053,225
553912005,553909216,553926182,16966,1054,225
553933103,553930313,553948883,18570,1055,225
553955704,553953131,553970515,17384,1056,225
553977436,553974646,553991295,16649,1057,225
553998214,553995426,554012074,16648,1058,225
554018993,554016205,554032853,16648,1059,225
554039772,554036984,554052978,15994,1060,225
554059896,554057108,554075340,18232,1061,225
554082260,554079471,554097387,17916,1062,225
554104190,554101617,554117397,15780,1063,225
554124315,554121527,554137543,16016,1064,225
554144461,554141674,554159589,17915,1065,225
554166509,554163720,554178765,15045,1066,225
554185683,554182895,554201148,18253,1067,225
554208067,554205279,554221612,16333,1068,225
554228532,554225743,554243997,18254,1069,225
554250917,554248128,554264778,16650,1070,225
554271699,554268909,554285876,16967,1071,225
554292795,554290007,554305686,15679,1072,225
554312605,554309816,554328387,18571,1073,225
554335306,554332518,554348850,16332,1074,225
554355770,554352981,554369946,16965,1075,225
554376750,554374178,554390612,16434,1076,225
554397532,554394743,554413630,18887,1077,225
554420549,554417761,554433440,15679,1078,225
554440359,554437571,554452299,14728,1079,225
554459217,554456429,554473691,17262,1080,225
554480610,554477822,554493184,15362,1081,225
554500103,554497314,554515230,17916,1082,225
554522149,554519361,554536642,17281,1083,225
554543560,554540773,554558686,17913,1084,225
554565605,554562817,554579781,16964,1085,225
554586700,554583912,554602482,18570,1086,225
554609401,554606613,554622924,16311,1087,225
554629844,554627055,554644022,16967,1088,225
554650943,554648153,554665120,16967,1089,225
554672038,554669251,554685245,15994,1090,225
554692164,554689376,554705055,15679,1091,225
554711973,554709185,554725180,15995,1092,225
554732098,554729311,554746591,17280,1093,225
554753511,554750722,554768975,18253,1094,225
554775787,554773215,554788044,14829,1095,225
554794962,554792174,554809794,17620,1096,225
554816713,554813925,554828654,14729,1097,225
554835575,554832785,554849753,16968,1098,225
554856672,554853884,554870216,16332,1099,225
554877134,554874347,554890973,16626,1100,225
554897892,554895104,554913019,17915,1101,225
554919939,554917150,554932512,15362,1102,225
554939431,554936642,554952322,15680,1103,225
554959240,554956452,554974387,17935,1104,225
554981307,554978518,554994198,15680,1105,225
555001022,554998450,555014566,16116,1106,225
555021485,555018697,555036295,17598,1107,225
555043214,555040426,555057707,17281,1108,225
555064627,555061838,555078804,16966,1109,225
555085610,555083038,555100104,17066,1110,225
555107023,555104235,555120882,16647,1111,225
555127803,555125013,555141958,16945,1112,225
555148878,555146090,555163351,17261,1113,225
555170271,555167482,555182529,15047,1114,225
555189449,555186660,555202023,15363,1115,225
555208941,555206153,555222484,16331,1116,225
555229403,555226615,555244868,18253,1117,225
555251788,555248999,555265311,16312,1118,225
555272231,555269442,555287696,18254,1119,225
555294616,555291827,555309425,17598,1120,225
555316346,555313556,555329237,15681,1121,225
555336154,555333367,555350964,17597,1122,225
555357884,555355095,555370772,15677,1123,225
555377691,555374902,555392184,17282,1124,225
555399104,555396315,555413282,16967,1125,225
555420203,555417414,555433409,15995,1126,225
555440329,555437540,555452585,15045,1127,225
555459504,555456715,555473681,16966,1128,225
555480600,555477812,555495411,17599,1129,225
555502330,555499542,555517478,17936,1130,225
555524397,555521609,555540177,18568,1131,225
555546976,555544405,555560837,16432,1132,225
555567756,555564968,555580330,15362,1133,225
555587143,555584571,555601321,16750,1134,225
555608241,555605452,555623368,17916,1135,225
555630287,555627499,555644149,16650,1136,225
555651069,555648280,555665246,16966,1137,225
555672166,555669377,555685372,15995,1138,225
555692292,555689502,555705183,15681,1139,225
555712101,555709313,555726595,17282,1140,225
555733515,555730726,555747375,16649,1141,225
555754294,555751506,555768134,16628,1142,225
555775053,555772265,555789230,16965,1143,225
555796149,555793361,555809040,15679,1144,225
555815959,555813170,555829819,16649,1145,225
555836738,555833950,555851864,17914,1146,225
555858783,555855995,555871674,15679,1147,225
555878593,555875804,555892433,16629,1148,225
555899352,555896564,555913846,17282,1149,225
555920765,555917977,555936547,18570,1150,225
555943466,555940678,555959247,18569,1151,225
555966167,555963378,555979373,15995,1152,225
555986292,555983503,556002074,18571,1153,225
556008994,556006205,556023805,17600,1154,225
556030724,556027936,556044902,16966,1155,225
556051713,556049141,556065236,16095,1156,225
556072155,556069367,556084095,14728,1157,225
556091014,556088225,556104221,15996,1158,225
556111141,556108352,556124686,16334,1159,225
556131606,556128817,556146733,17916,1160,225
556153653,556150864,556168463,17599,1161,225
556175382,556172594,556188589,15995,1162,225
556195508,556192719,556211606,18887,1163,225
556218525,556215737,556233651,17914,1164,225
556240452,556237880,556255917,18037,1165,225
556262836,556260048,556275725,15677,1166,225
556282542,556279970,556295115,15145,1167,225
556302033,556299245,556314607,15362,1168,225
556321432,556318860,556335926,17066,1169,225
556342845,556340057,556357022,16965,1170,225
556363941,556361153,556376515,15362,1171,225
556383433,556380645,556395374,14729,1172,225
556402293,556399505,556417441,17936,1173,225
556424360,556421572,556438200,16628,1174,225
556445119,556442331,556459930,17599,1175,225
556466849,556464061,556480690,16629,1176,225
556487609,556484821,556502757,17936,1177,225
556509676,556506888,556524150,17262,1178,225
556531070,556528281,556544909,16628,1179,225
556551827,556549040,556564717,15677,1180,225
556571635,556568847,556584841,15994,1181,225
556591657,556589085,556604863,15778,1182,225
556611783,556608994,556626593,17599,1183,225
556633513,556630724,556645453,14729,1184,225
556652373,556649584,556666845,17261,1185,225
556673765,556670977,556690180,19203,1186,225
556697099,556694311,556710305,15994,1187,225
556717224,556714436,556732688,18252,1188,225
556739607,556736819,556755705,18886,1189,225
556762521,556759950,556777016,17066,1190,225
556783936,556781147,556796826,15679,1191,225
556803746,556800957,556816003,15046,1192,225
556822921,556820133,556836781,16648,1193,225
556843700,556840912,556856907,15995,1194,225
556863826,556861038,556879268,18230,1195,225
556886067,556883494,556900857,17363,1196,225
556907674,556905103,556920565,15462,1197,225
556927390,556924819,556940596,15777,1198,225
556947516,556944727,556962326,17599,1199,225
556969245,556966457,556982451,15994,1200,225
556989369,556986581,557004497,17916,1201,225
557011415,557008628,557023989,15361,1202,225
557030908,557028120,557045718,17598,1203,225
557052638,557049850,557065845,15995,1204,225
557072764,557069975,557088545,18570,1205,225
557095464,557092675,557111245,18570,1206,225
557118063,557115492,557131585,16093,1207,225
557138504,557135716,557152028,16312,1208,225
557158947,557156159,557173125,16966,1209,225
557180043,557177255,557193902,16647,1210,225
557200822,557198033,557217237,19204,1211,225
557224156,557221368,557238649,17281,1212,225
557245569,557242780,557261329,18549,1213,225
557268249,557265460,557284030,18570,1214,225
557290951,557288161,557305129,16968,1215,225
557311942,557309370,557325465,16095,1216,225
557332386,557329596,557345910,16314,1217,225
557352830,557350041,557367641,17600,1218,225
557374561,557371772,557390026,18254,1219,225
557396945,557394157,557409201,15044,1220,225
557416119,557413331,557429324,15993,1221,225
557436243,557433455,557449449,15994,1222,225
557456368,557453579,557470861,17282,1223,225
557477781,557474992,557491304,16312,1224,225
557498223,557495435,557512062,16627,1225,225
557518982,557516193,557534762,18569,1226,225
557541572,557539001,557565267,26266,1227,225
557572186,557569399,557591428,22029,1228,225
557598347,557595559,557611238,15679,1229,225
557618156,557615368,557632333,16965,1230,225
557639252,557636464,557653430,16966,1231,225
557660349,557657561,557675497,17936,1232,225
557682417,557679628,557696912,17284,1233,225
557703831,557701043,557718009,16966,1234,225
557724929,557722140,557738451,16311,1235,225
557745371,557742582,557759233,16651,1236,225
557766153,557763364,557780015,16651,1237,225
557786935,557784146,557801745,17599,1238,225
557808664,557805876,557823474,17598,1239,225
557830393,557827605,557842333,14728,1240,225
557849251,557846463,557862456,15993,1241,225
557869374,557866586,557883868,17282,1242,225
557890787,557887999,557906567,18568,1243,225
557913486,557910698,557928296,17598,1244,225
557935116,557932544,557950264,17720,1245,225
557957184,557954396,557972331,17935,1246,225
557979251,557976462,557993429,16967,1247,225
558000348,557997560,558013575,16015,1248,225
558020388,558017817,558034565,16748,1249,225
558041484,558038696,558054713,16017,1250,225
558061632,558058844,558074838,15994,1251,225
558081756,558078968,558097535,18567,1252,225
558104455,558101666,558118295,16629,1253,225
558125214,558122426,558139054,16628,1254,225
558145973,558143185,558158229,15044,1255,225
558165148,558162359,558179642,17283,1256,225
558186562,558183773,558201056,17283,1257,225
558207975,558205187,558223757,18570,1258,225
558230677,558227888,558245487,17599,1259,225
558252405,558249618,558267870,18252,1260,225
558274789,558272001,558288333,16332,1261,225
558295132,558292561,558307705,15144,1262,225
558314623,558311835,558327830,15995,1263,225
558334749,558331960,558347322,15362,1264,225
558354240,558351452,558367764,16312,1265,225
558374684,558371895,558388546,16651,1266,225
558395465,558392677,558409959,17282,1267,225
558416880,558414090,558432008,17918,1268,225
558438814,558436243,558451071,14828,1269,225
558457991,558455202,558471853,16651,1270,225
558478772,558475984,558494235,18251,1271,225
558501154,558498366,558516934,18568,1272,225
558523853,558521065,558537692,16627,1273,225
558544611,558541823,558559422,17599,1274,225
558566342,558563553,558578916,15363,1275,225
558585834,558583046,558598724,15678,1276,225
558605540,558602967,558619718,16751,1277,225
558626637,558623849,558640814,16965,1278,225
558647613,558645042,558661453,16411,1279,225
558668372,558665584,558681261,15677,1280,225
558688181,558685391,558701071,15680,1281,225
558707989,558705201,558720879,15678,1282,225
558727797,558725009,558741975,16966,1283,225
558748895,558746106,558763071,16965,1284,225
558769990,558767202,558784483,17281,1285,225
558791402,558788614,558805264,16650,1286,225
558812063,558809491,558826873,17382,1287,225
558833793,558831004,558849574,18570,1288,225
558856493,558853705,558870671,16966,1289,225
558877591,558874802,558891769,16967,1290,225
558898689,558895900,558910946,15046,1291,225
558917866,558915077,558933329,18252,1292,225
558940135,558937563,558955578,18015,1293,225
558962497,558959709,558976992,17283,1294,225
558983913,558981123,558997118,15995,1295,225
559004037,559001249,559016925,15676,1296,225
559023844,559021056,559035785,14729,1297,225
559042705,559039916,559054962,15046,1298,225
559061883,559059093,559074773,15680,1299,225
559081691,559078903,559098106,19203,1300,225
559104905,559102333,559120686,18353,1301,225
559127607,559124818,559140835,16017,1302,225
559147754,559144966,559162247,17281,1303,225
559169167,559166378,559181741,15363,1304,225
559188660,559185871,559202183,16312,1305,225
559209101,559206314,559222623,16309,1306,225
559229543,559226754,559244038,17284,1307,225
559250959,559248169,559265137,16968,1308,225
559272056,559269268,559285601,16333,1309,225
559292521,559289732,559308620,18888,1310,225
559315540,559312751,559330688,17937,1311,225
559337608,559334819,559351785,16966,1312,225
559358703,559355916,559372860,16944,1313,225
559379780,559376991,559395562,18571,1314,225
559402481,559399693,559417946,18253,1315,225
559424865,559422077,559439675,17598,1316,225
559446594,559443806,559461404,17598,1317,225
559468214,559465642,559484628,18986,1318,225
559491443,559488871,559506571,17700,1319,225
559513491,559510702,559528302,17600,1320,225
559535100,559532528,559549278,16750,1321,225
559556197,559553409,559571008,17599,1322,225
559577927,559575139,559591787,16648,1323,225
559598707,559595918,559613201,17283,1324,225
559620122,559617332,559633667,16335,1325,225
559640476,559637905,559654019,16114,1326,225
559660938,559658150,559676403,18253,1327,225
559683323,559680534,559697500,16966,1328,225
559704420,559701631,559716361,14730,1329,225
559723282,559720492,559738429,17937,1330,225
559745348,559742560,559758575,16015,1331,225
559765494,559762706,559781276,18570,1332,225
559788195,559785407,559802689,17282,1333,225
559809609,559806820,559822816,15996,1334,225
559829736,559826946,559843597,16651,1335,225
559850516,559847728,559863090,15362,1336,225
559870009,559867220,559884503,17283,1337,225
559891423,559888634,559906234,17600,1338,225
559913153,559910365,559926993,16628,1339,225
559933914,559931125,559947119,15994,1340,225
559954038,559951250,559967561,16311,1341,225
559974377,559971805,559988237,16432,1342,225
559995156,559992368,560011255,18887,1343,225
560018068,560015497,560032561,17064,1344,225
560039480,560036692,560054629,17937,1345,225
560061549,560058760,560076697,17937,1346,225
560083616,560080828,560098108,17280,1347,225
560105028,560102239,560118869,16630,1348,225
560125788,560123000,560140599,17599,1349,225
560147519,560144730,560160093,15363,1350,225
560167011,560164223,560179901,15678,1351,225
560186820,560184031,560200027,15996,1352,225
560206946,560204157,560221102,16945,1353,225
560228021,560225233,560242199,16966,1354,225
560249119,560246330,560263614,17284,1355,225
560270534,560267745,560284711,16966,1356,225
560291630,560288842,560307729,18887,1357,225
560314648,560311860,560328171,16311,1358,225
560335091,560332302,560349586,17284,1359,225
560356411,560353839,560371538,17699,1360,225
560378458,560375669,560393902,18233,1361,225
560400822,560398033,560415970,17937,1362,225
560422890,560420101,560436095,15994,1363,225
560443014,560440225,560456874,16649,1364,225
560463793,560461005,560475733,14728,1365,225
560482652,560479863,560494908,15045,1366,225
560501826,560499038,560517608,18570,1367,225
560524527,560521739,560539654,17915,1368,225
560546467,560543896,560559991,16095,1369,225
560566911,560564122,560581089,16967,1370,225
560588009,560585220,560601532,16312,1371,225
560608452,560605663,560622292,16629,1372,225
560629212,560626423,560643052,16629,1373,225
560649971,560647183,560665099,17916,1374,225
560672018,560669230,560688115,18885,1375,225
560695035,560692246,560709845,17599,1376,225
560716765,560713976,560730943,16967,1377,225
560737863,560735074,560750119,15045,1378,225
560757037,560754249,560772503,18254,1379,225
560779421,560776634,560793283,16649,1380,225
560800202,560797414,560815012,17598,1381,225
560821930,560819143,560834820,15677,1382,225
560841739,560838950,560855916,16966,1383,225
560862836,560860047,560878617,18570,1384,225
560885536,560882748,560899714,16966,1385,225
560906634,560903845,560921128,17283,1386,225
560928048,560925259,560942225,16966,1387,225
560949145,560946356,560963956,17600,1388,225
560970875,560968087,560984736,16649,1389,225
560991656,560988867,561005180,16313,1390,225
561012100,561009311,561028514,19203,1391,225
561035433,561032645,561047691,15046,1392,225
561054610,561051822,561068787,16965,1393,225
561075707,561072918,561089883,16965,1394,225
561096802,561094014,561109693,15679,1395,225
561116611,561113823,561131758,17935,1396,225
561138561,561135989,561152085,16096,1397,225
561158898,561156325,561173076,16751,1398,225
561179995,561177207,561192569,15362,1399,225
561199488,561196699,561212695,15996,1400,225
561219614,561216826,561232842,16016,1401,225
561239659,561237087,561253518,16431,1402,225
561260437,561257649,561274929,17280,1403,225
561281848,561279060,561297313,18253,1404,225
561304232,561301444,561317459,16015,1405,225
561324283,561321711,561338777,17066,1406,225
561345697,561342908,561358270,15362,1407,225
561365068,561362497,561378612,16115,1408,225
561385531,561382742,561400341,17599,1409,225
561407260,561404472,561423356,18884,1410,225
561430274,561427487,561443818,16331,1411,225
561450737,561447949,561465886,17937,1412,225
561472805,561470017,561486982,16965,1413,225
561493902,561491113,561508080,16967,1414,225
561514999,561512211,561528204,15993,1415,225
561535124,561532335,561549301,16966,1416,225
561556221,561553432,561577531,24099,1417,225
561584332,561581761,561598297,16536,1418,225
561605215,561602428,561617472,15044,1419,225
561624390,561621602,561637281,15679,1420,225
561644201,561641412,561656774,15362,1421,225
561663692,561660904,561678523,17619,1422,225
561685442,561682654,561698986,16332,1423,225
561705904,561703117,561719111,15994,1424,225
561726030,561723241,561738602,15361,1425,225
561745520,561742732,561760647,17915,1426,225
561767566,561764778,561782375,17597,1427,225
561789295,561786506,561802184,15678,1428,225
561809103,561806315,561822310,15995,1429,225
561829113,561826541,561844557,18016,1430,225
561851477,561848689,561867258,18569,1431,225
561874178,561871389,561888989,17600,1432,225
561895908,561893120,561908799,15679,1433,225
561915719,561912930,561929579,16649,1434,225
561936499,561933710,561950992,17282,1435,225
561957911,561955123,561971117,15994,1436,225
561978037,561975248,561991876,16628,1437,225
561998796,561996007,562014239,18232,1438,225
562021159,562018371,562035970,17599,1439,225
562042888,562040101,562056430,16329,1440,225
562063349,562060561,562077210,16649,1441,225
562084129,562081341,562098940,17599,1442,225
562105859,562103071,562119383,16312,1443,225
562126303,562123515,562140797,17282,1444,225
562147717,562144928,562161577,16649,1445,225
562168495,562165708,562182990,17282,1446,225
562189910,562187121,562206009,18888,1447,225
562212928,562210140,562225186,15046,1448,225
562232105,562229317,562244679,15362,1449,225
562251598,562248810,562266092,17282,1450,225
562273012,562270223,562287506,17283,1451,225
562294426,562291638,562310208,18570,1452,225
562317128,562314339,562329701,15362,1453,225
562336619,562333831,562349510,15679,1454,225
562356428,562353640,562368368,14728,1455,225
562375287,562372499,562387861,15362,1456,225
562394781,562391991,562408325,16334,1457,225
562415245,562412456,562429106,16650,1458,225
562436025,562433237,562447965,14728,1459,225
562454883,562452095,562469039,16944,1460,225
562475957,562473170,562492372,19202,1461,225
562499291,562496503,562513152,16649,1462,225
562520071,562517283,562536170,18887,1463,225
562543090,562540301,562557583,17282,1464,225
562564503,562561714,562578681,16967,1465,225
562585487,562582916,562598378,15462,1466,225
562605180,562602608,562618704,16096,1467,225
562625623,562622835,562640434,17599,1468,225
562647353,562644565,562661848,17283,1469,225
562668769,562665979,562681657,15678,1470,225
562688576,562685788,562703070,17282,1471,225
562709989,562707201,562724165,16964,1472,225
562731084,562728296,562746547,18251,1473,225
562753466,562750678,562768594,17916,1474,225
562775513,562772725,562788403,15678,1475,225
562795323,562792534,562811104,18570,1476,225
562818023,562815235,562830914,15679,1477,225
562837722,562835150,562851563,16413,1478,225
562858484,562855695,562872324,16629,1479,225
562879245,562876455,562894372,17917,1480,225
562901291,562898503,562914498,15995,1481,225
562921417,562918629,562937199,18570,1482,225
562944118,562941330,562959899,18569,1483,225
562966818,562964030,562979708,15678,1484,225
562986627,562983839,563002090,18251,1485,225
563009010,563006222,563023167,16945,1486,225
563029975,563027404,563044131,16727,1487,225
563050949,563048377,563065760,17383,1488,225
563072679,563069891,563085568,15677,1489,225
563092487,563089699,563106665,16966,1490,225
563113585,563110796,563129366,18570,1491,225
563136285,563133497,563150124,16627,1492,225
563157043,563154255,563172171,17916,1493,225
563178984,563176413,563194449,18036,1494,225
563201370,563198581,563215230,16649,1495,225
563222150,563219361,563235040,15679,1496,225
563241959,563239170,563256136,16966,1497,225
563262957,563260386,563279055,18669,1498,225
563285975,563283186,563300470,17284,1499,225
563307390,563304601,563321885,17284,1500,225
563328804,563326016,563345217,19201,1501,225
563352137,563349348,563366315,16967,1502,225
563373234,563370446,563389647,19201,1503,225
563396565,563393778,563411060,17282,1504,225
563417980,563415191,563432791,17600,1505,225
563439710,563436922,563453867,16945,1506,225
563460672,563458100,563475165,17065,1507,225
563482085,563479296,563495629,16333,1508,225
563502548,563499760,563517359,17599,1509,225
563524278,563521490,563538433,16943,1510,225
563545351,563542564,563559529,16965,1511,225
563566330,563563759,563580169,16410,1512,225
563587088,563584300,563602849,18549,1513,225
563609651,563607081,563622541,15460,1514,225
563629459,563626671,563644269,17598,1515,225
563651189,563648400,563664395,15995,1516,225
563671315,563668525,563685175,16650,1517,225
563692094,563689306,563706271,16965,1518,225
563713191,563710402,563725763,15361,1519,225
563732682,563729893,563746225,16332,1520,225
563753145,563750356,563766351,15995,1521,225
563773269,563770481,563787741,17260,1522,225
563794661,563791872,563808501,16629,1523,225
563815421,563812632,563827995,15363,1524,225
563834913,563832125,563849068,16943,1525,225
563855888,563853317,563871036,17719,1526,225
563877955,563875167,563892450,17283,1527,225
563899369,563896581,563913547,16966,1528,225
563920466,563917678,563935931,18253,1529,225
563942852,563940062,563955424,15362,1530,225
563962343,563959554,563976203,16649,1531,225
563983021,563980450,563996544,16094,1532,225
564003464,564000675,564018907,18232,1533,225
564025703,564023132,564040514,17382,1534,225
564047433,564044645,564062559,17914,1535,225
564069479,564066690,564084605,17915,1536,225
564091524,564088736,564104731,15995,1537,225
564111651,564108862,564125175,16313,1538,225
564132095,564129306,564147539,18233,1539,225
564154459,564151670,564169606,17936,1540,225
564176526,564173737,564190387,16650,1541,225
564197307,564194518,564212772,18254,1542,225
564219568,564216997,564233429,16432,1543,225
564240347,564237560,564253892,16332,1544,225
564260812,564258023,564274651,16628,1545,225
564281570,564278782,564294144,15362,1546,225
564301063,564298274,564316844,18570,1547,225
564323763,564320975,564337602,16627,1548,225
564344521,564341733,564357411,15678,1549,225
564364331,564361541,564379795,18254,1550,225
564386714,564383926,564399605,15679,1551,225
564406524,564403736,564421016,17280,1552,225
564427935,564425147,564443715,18568,1553,225
564450634,564447846,564464812,16966,1554,225
564471731,564468943,564485592,16649,1555,225
564492396,564489825,564505603,15778,1556,225
564512426,564509854,564524682,14828,1557,225
564531601,564528812,564545779,16967,1558,225
564552700,564549910,564564957,15047,1559,225
564571876,564569087,564586031,16944,1560,225
564592951,564590162,564607445,17283,1561,225
564614364,564611576,564626620,15044,1562,225
564633539,564630750,564649635,18885,1563,225
564656554,564653766,564670415,16649,1564,225
564677333,564674546,564689588,15042,1565,225
564696508,564693718,564710665,16947,1566,225
564717585,564714796,564732395,17599,1567,225
564739315,564736526,564751255,14729,1568,225
564758174,564755385,564772668,17283,1569,225
564779587,564776799,564791527,14728,1570,225
564798446,564795657,564811652,15995,1571,225
564818571,564815782,564832116,16334,1572,225
564838913,564836342,564852458,16116,1573,225
564859378,564856589,564872901,16312,1574,225
564879820,564877032,564894946,17914,1575,225
564901866,564899077,564916676,17599,1576,225
564923595,564920807,564938089,17282,1577,225
564945008,564942220,564959502,17282,1578,225
564966420,564963633,564980598,16965,1579,225
564987517,564984729,564999775,15046,1580,225
565006693,565003905,565021504,17599,1581,225
565028423,565025635,565043550,17915,1582,225
565050357,565047785,565064534,16749,1583,225
565071454,565068665,565085632,16967,1584,225
565092428,565089857,565106921,17064,1585,225
565113839,565111052,565128016,16964,1586,225
565134935,565132147,565147824,15677,1587,225
565154742,565151954,565169869,17915,1588,225
565176789,565174000,565189996,15996,1589,225
565196915,565194127,565211408,17281,1590,225
565218327,565215539,565232503,16964,1591,225
565239423,565236634,565252629,15995,1592,225
565259547,565256759,565273723,16964,1593,225
565280642,565277853,565294482,16629,1594,225
565301401,565298613,565315263,16650,1595,225
565322182,565319394,565336022,16628,1596,225
565342941,565340153,565358068,17915,1597,225
565364987,565362199,565378215,16016,1598,225
565385134,565382346,565399628,17282,1599,225
565406548,565403759,565421675,17916,1600,225
565428595,565425807,565442140,16333,1601,225
565449061,565446272,565463239,16967,1602,225
565470159,565467371,565484337,16966,1603,225
565491258,565488469,565506069,17600,1604,225
565512989,565510201,565525879,15678,1605,225
565532701,565530130,565546561,16431,1606,225
565553481,565550693,565566055,15362,1607,225
565572974,565570186,565588755,18569,1608,225
565595675,565592887,565609535,16648,1609,225
565616455,565613667,565631603,17936,1610,225
565638523,565635735,565651413,15678,1611,225
565658333,565655544,565671856,16312,1612,225
565678776,565675988,565694242,18254,1613,225
565701162,565698374,565714369,15995,1614,225
565721289,565718500,565737386,18886,1615,225
565744306,565741518,565758484,16966,1616,225
565765403,565762616,565780212,17596,1617,225
565787134,565784344,565801945,17601,1618,225
565808864,565806076,565824962,18886,1619,225
565831881,565829093,565846692,17599,1620,225
565853613,565850824,565868741,17917,1621,225
565875661,565872873,565889521,16648,1622,225
565896441,565893653,565911568,17915,1623,225
565918488,565915700,565931695,15995,1624,225
565938613,565935826,565952157,16331,1625,225
565959077,565956289,565974204,17915,1626,225
565981124,565978336,565997538,19202,1627,225
566004459,566001670,566017349,15679,1628,225
566024268,566021480,566039417,17937,1629,225
566046338,566043549,566060199,16650,1630,225
566067119,566064331,566080327,15996,1631,225
566087247,566084458,566103345,18887,1632,225
566110266,566107477,566124760,17283,1633,225
566131682,566128892,566146493,17601,1634,225
566153415,566150625,566167592,16967,1635,225
566174513,566171724,566189640,17916,1636,225
566196560,566193772,566210400,16628,1637,225
566217320,566214532,566229894,15362,1638,225
566236813,566234025,566250356,16331,1639,225
566257277,566254488,566270484,15996,1640,225
566277404,566274615,566291263,16648,1641,225
566298182,566295394,566314596,19202,1642,225
566321412,566318839,566336244,17405,1643,225
566343164,566340376,566356688,16312,1644,225
566363608,566360820,566378440,17620,1645,225
566385259,566382687,566399437,16750,1646,225
566406358,566403569,566422138,18569,1647,225
566429058,566426270,566445473,19203,1648,225
566452393,566449605,566467858,18253,1649,225
566474779,566471990,566487669,15679,1650,225
566494481,566491910,566508342,16432,1651,225
566515262,566512474,566530094,17620,1652,225
566537014,566534225,566551192,16967,1653,225
566558113,566555324,566574212,18888,1654,225
566581131,566578344,566594338,15994,1655,225
566601257,566598469,566615752,17283,1656,225
566622672,566619884,566635879,15995,1657,225
566642798,566640010,566654738,14728,1658,225
566661657,566658869,566675518,16649,1659,225
566682438,566679650,566695327,15677,1660,225
566702139,566699568,566715346,15778,1661,225
566722265,566719477,566735156,15679,1662,225
566742076,566739287,566754966,15679,1663,225
566761885,566759097,566775746,16649,1664,225
566782667,566779878,566797476,17598,1665,225
566804396,566801608,566818890,17282,1666,225
566825811,566823022,566839989,16967,1667,225
566846909,566844121,566863008,18887,1668,225
566869927,566867140,566885075,17935,1669,225
566891995,566889207,566905540,16333,1670,225
566912460,566909671,566927588,17917,1671,225
566934507,566931719,566950606,18887,1672,225
566957527,566954738,566971703,16965,1673,225
566978625,566975835,566990566,14731,1674,225
566997486,566994697,567012316,17619,1675,225
567019236,567016448,567033097,16649,1676,225
567040018,567037229,567054512,17283,1677,225
567061433,567058644,567077213,18569,1678,225
567084132,567081344,567099279,17935,1679,225
567106098,567103526,567120930,17404,1680,225
567127749,567125177,567141609,16432,1681,225
567148530,567145741,567162392,16651,1682,225
567169312,567166524,567183150,16626,1683,225
567190071,567187282,567205852,18570,1684,225
567212772,567209984,567228553,18569,1685,225
567235360,567232789,567247933,15144,1686,225
567254853,567252064,567269980,17916,1687,225
567276900,567274112,567291393,17281,1688,225
567298314,567295525,567312808,17283,1689,225
567319729,567316940,567333905,16965,1690,225
567340825,567338037,567354686,16649,1691,225
567361606,567358818,567376099,17281,1692,225
567383019,567380231,567397512,17281,1693,225
567404431,567401643,567418608,16965,1694,225
567425528,567422740,567440022,17282,1695,225
567446943,567444154,567461436,17282,1696,225
567468357,567465568,567482851,17283,1697,225
567489772,567486983,567504265,17282,1698,225
567511185,567508397,567525363,16966,1699,225
567532283,567529495,567545828,16333,1700,225
567552749,567549960,567566272,16312,1701,225
567573192,567570404,567587370,16966,1702,225
567594290,567591502,567606863,15361,1703,225
567613668,567611097,567627507,16410,1704,225
567634428,567631639,567648923,17284,1705,225
567655844,567653055,567668418,15363,1706,225
567675337,567672549,567688882,16333,1707,225
567695802,567693014,567710611,17597,1708,225
567717531,567714743,567730737,15994,1709,225
567737657,567734868,567750547,15679,1710,225
567757468,567754678,567770359,15681,1711,225
567777278,567774490,567790802,16312,1712,225
567797722,567794934,567813503,18569,1713,225
567820423,567817635,567835572,17937,1714,225
567842492,567839704,567858274,18570,1715,225
567865074,567862502,567880854,18352,1716,225
567887774,567884986,567900664,15678,1717,225
567907583,567904795,567921107,16312,1718,225
567928027,567925239,567943174,17935,1719,225
567950095,567947306,567964273,16967,1720,225
567971193,567968405,567985053,16648,1721,225
567991973,567989185,568006466,17281,1722,225
568013385,568010597,568028513,17916,1723,225
568035433,568032645,568050244,17599,1724,225
568057164,568054376,568070371,15995,1725,225
568077290,568074502,568092439,17937,1726,225
568099359,568096571,568115773,19202,1727,225
568122598,568120027,568135171,15144,1728,225
568141993,568139421,568156488,17067,1729,225
568163408,568160620,568178535,17915,1730,225
568185455,568182667,568199315,16648,1731,225
568206235,568203447,568220074,16627,1732,225
568226995,568224206,568241173,16967,1733,225
568248094,568245304,568261956,16652,1734,225
568268875,568266088,568283053,16965,1735,225
568289973,568287185,568303517,16332,1736,225
568310437,568307649,568324615,16966,1737,225
568331535,568328746,568344741,15995,1738,225
568351661,568348872,568365184,16312,1739,225
568372103,568369316,568385962,16646,1740,225
568392882,568390093,568406743,16650,1741,225
568413563,568410992,568428056,17064,1742,225
568434976,568432187,568449153,16966,1743,225
568456073,568453285,568470568,17283,1744,225
568477489,568474700,568490696,15996,1745,225
568497616,568494827,568512108,17281,1746,225
568519028,568516240,568534156,17916,1747,225
568541076,568538288,568555570,17282,1748,225
568562490,568559702,568575694,15992,1749,225
568582613,568579825,568596474,16649,1750,225
568603394,568600606,568619175,18569,1751,225
568626096,568623307,568641224,17917,1752,225
568648049,568645477,568663514,18037,1753,225
568670435,568667646,568683958,16312,1754,225
568690878,568688090,568703768,15678,1755,225
568710580,568708009,568726362,18353,1756,225
568733282,568730494,568747143,16649,1757,225
568754063,568751275,568767586,16311,1758,225
568774508,568771718,568790290,18572,1759,225
568797212,568794422,568810419,15997,1760,225
568817339,568814551,568831516,16965,1761,225
568838436,568835648,568853584,17936,1762,225
568860505,568857715,568872762,15047,1763,225
568879682,568876893,568892573,15680,1764,225
568899492,568896704,568914956,18252,1765,225
568921877,568919088,568936053,16965,1766,225
568942974,568940185,568956834,16649,1767,225
568963753,568960966,568977909,16943,1768,225
568984709,568982138,568998887,16749,1769,225
569005806,569003019,569019013,15994,1770,225
569025812,569023241,569039989,16748,1771,225
569046909,569044121,569059166,15045,1772,225
569066085,569063297,569079946,16649,1773,225
569086865,569084078,569101360,17282,1774,225
569108281,569105492,569122459,16967,1775,225
569129381,569126591,569145480,18889,1776,225
569152401,569149612,569164656,15044,1777,225
569171575,569168787,569185415,16628,1778,225
569192232,569189659,569207359,17700,1779,225
569214280,569211491,569228773,17282,1780,225
569235693,569232905,569249238,16333,1781,225
569256158,569253370,569269046,15676,1782,225
569275966,569273178,569291748,18570,1783,225
569298669,569295880,569311876,15996,1784,225
569318796,569316008,569333945,17937,1785,225
569340866,569338077,569355043,16966,1786,225
569361963,569359175,569375169,15994,1787,225
569381969,569379397,569397751,18354,1788,225
569404672,569401883,569419483,17600,1789,225
569426403,569423615,569440243,16628,1790,225
569447163,569444375,569462628,18253,1791,225
569469549,569466760,569482756,15996,1792,225
569489676,569486887,569502904,16017,1793,225
569509825,569507036,569522716,15680,1794,225
569529635,569526847,569542842,15995,1795,225
569549762,569546973,569563305,16332,1796,225
569570225,569567437,569583769,16332,1797,225
569590689,569587901,569606153,18252,1798,225
569613073,569610285,569626280,15995,1799,225
569633199,569630411,569648031,17620,1800,225
569654952,569652163,569667842,15679,1801,225
569674761,569671973,569690205,18232,1802,225
569697126,569694337,569709384,15047,1803,225
569716304,569713515,569729511,15996,1804,225
569736430,569733642,569750924,17282,1805,225
569757844,569755056,569771049,15993,1806,225
569777967,569775180,569791489,16309,1807,225
569798410,569795621,569810668,15047,1808,225
569817586,569814799,569830159,15360,1809,225
569836973,569834402,569850178,15776,1810,225
569857097,569854309,569870936,16627,1811,225
569877856,569875068,569891062,15994,1812,225
569897982,569895193,569911506,16313,1813,225
569918426,569915638,569931316,15678,1814,225
569938235,569935447,569950175,14728,1815,225
569957094,569954306,569970934,16628,1816,225
569977854,569975066,569993635,18569,1817,225
570000555,569997767,570015703,17936,1818,225
570022625,570019835,570037773,17938,1819,225
570044597,570042025,570057804,15779,1820,225
570064625,570062053,570078170,16117,1821,225
570085089,570082302,570100534,18232,1822,225
570107454,570104666,570120661,15995,1823,225
570127580,570124792,570140808,16016,1824,225
570147614,570145042,570161474,16432,1825,225
570168394,570165606,570181915,16309,1826,225
570188835,570186047,570204299,18252,1827,225
570211121,570208550,570225932,17382,1828,225
570232851,570230064,570247027,16963,1829,225
570253948,570251159,570270047,18888,1830,225
570276861,570274289,570291355,17066,1831,225
570298276,570295487,570313425,17938,1832,225
570320347,570317557,570335157,17600,1833,225
570342078,570339289,570357860,18571,1834,225
570364780,570361992,570377354,15362,1835,225
570384274,570381485,570397818,16333,1836,225
570404739,570401950,570420520,18570,1837,225
570427439,570424651,570441300,16649,1838,225
570448220,570445432,570462398,16966,1839,225
570469318,570466530,570484129,17599,1840,225
570490936,570488363,570506064,17701,1841,225
570512892,570510319,570527703,17384,1842,225
570534622,570531835,570549770,17935,1843,225
570556689,570553902,570570528,16626,1844,225
570577448,570574660,570590972,16312,1845,225
570597892,570595104,570611415,16311,1846,225
570618336,570615547,570632829,17282,1847,225
570639749,570636961,570654243,17282,1848,225
570661164,570658375,570675025,16650,1849,225
570681946,570679157,570696757,17600,1850,225
570703676,570700889,570717199,16310,1851,225
570724119,570721331,570738928,17597,1852,225
570745848,570743060,570760657,17597,1853,225
570767579,570764789,570782072,17283,1854,225
570788894,570786323,570803705,17382,1855,225
570810626,570807837,570826070,18233,1856,225
570832990,570830202,570846851,16649,1857,225
570853771,570850983,570867294,16311,1858,225
570874215,570871426,570889025,17599,1859,225
570895945,570893157,570910123,16966,1860,225
570917044,570914255,570929618,15363,1861,225
570936419,570933847,570948992,15145,1862,225
570955910,570953123,570970721,17598,1863,225
570977642,570974853,570991503,16650,1864,225
570998301,570995730,571013427,17697,1865,225
571020251,571017679,571035062,17383,1866,225
571041982,571039194,571053923,14729,1867,225
571060842,571058054,571074364,16310,1868,225
571081174,571078602,571095352,16750,1869,225
571102272,571099484,571117399,17915,1870,225
571124222,571121651,571140004,18353,1871,225
571146820,571144248,571160048,15800,1872,225
571166967,571164179,571181124,16945,1873,225
571188044,571185256,571201588,16332,1874,225
571208508,571205720,571223634,17914,1875,225
571230444,571227873,571245254,17381,1876,225
571252175,571249386,571264432,15046,1877,225
571271352,571268563,571286162,17599,1878,225
571293082,571290294,571308862,18568,1879,225
571315783,571312994,571330593,17599,1880,225
571337513,571334725,571351670,16945,1881,225
571358590,571355802,571372135,16333,1882,225
571379055,571376267,571393233,16966,1883,225
571400153,571397365,571414014,16649,1884,225
571420935,571418146,571434795,16649,1885,225
571441715,571438927,571455893,16966,1886,225
571462812,571460025,571481273,21248,1887,225
571488194,571485405,571503975,18570,1888,225
571510894,571508107,571526675,18568,1889,225
571533497,571530926,571547357,16431,1890,225
571554277,571551489,571566535,15046,1891,225
571573346,571570775,571587523,16748,1892,225
571594444,571591655,571608938,17283,1893,225
571615858,571613070,571637611,24541,1894,225
571644530,571641743,571662992,21249,1895,225
571669802,571667229,571683959,16730,1896,225
571690881,571688091,571704740,16649,1897,225
571711539,571708966,571724745,15779,1898,225
571731666,571728877,571746815,17938,1899,225
571753735,571750947,571769200,18253,1900,225
571776121,571773332,571789982,16650,1901,225
571796903,571794114,571811714,17600,1902,225
571818635,571815846,571833446,17600,1903,225
571840366,571837578,571855492,17914,1904,225
571862411,571859624,571875302,15678,1905,225
571882221,571879433,571897369,17936,1906,225
571904290,571901501,571919755,18254,1907,225
571926675,571923887,571940535,16648,1908,225
571947456,571944667,571961634,16967,1909,225
571968554,571965766,571982077,16311,1910,225
571988889,571986317,572003382,17065,1911,225
572010301,572007514,572024794,17280,1912,225
572031601,572029030,572045778,16748,1913,225
572052698,572049910,572067508,17598,1914,225
572074427,572071640,572087971,16331,1915,225
572094893,572092103,572108776,16673,1916,225
572115696,572112908,572130506,17598,1917,225
572137426,572134638,572151288,16650,1918,225
572158209,572155420,572173358,17938,1919,225
572180279,572177490,572193169,15679,1920,225
572200088,572197300,572212028,14728,1921,225
572218948,572216159,572232808,16649,1922,225
572239613,572237042,572255393,18351,1923,225
572262313,572259525,572274253,14728,1924,225
572281173,572278384,572296638,18254,1925,225
572303557,572300770,572317733,16963,1926,225
572324654,572321865,572338832,16967,1927,225
572345752,572342964,572359929,16965,1928,225
572366849,572364061,572381977,17916,1929,225
572388897,572386109,572402104,15995,1930,225
572409024,572406235,572424151,17916,1931,225
572431071,572428283,572445565,17282,1932,225
572452485,572449697,572468899,19202,1933,225
572475819,572473031,572491283,18252,1934,225
572498094,572495523,572512272,16749,1935,225
572519193,572516404,572533350,16946,1936,225
572540270,572537482,572552843,15361,1937,225
572559762,572556974,572571702,14728,1938,225
572578622,572575833,572593750,17917,1939,225
572600670,572597882,572613878,15996,1940,225
572620796,572618009,572635291,17282,1941,225
572642212,572639423,572655735,16312,1942,225
572662656,572659867,572677467,17600,1943,225
572684387,572681599,572699197,17598,1944,225
572706118,572703329,572718691,15362,1945,225
572725610,572722822,572739155,16333,1946,225
572746075,572743287,572759916,16629,1947,225
572766738,572764165,572781549,17384,1948,225
572788469,572785681,572803934,18253,1949,225
572810855,572808066,572823744,15678,1950,225
572830663,572827875,572846128,18253,1951,225
572853049,572850260,572865306,15046,1952,225
572872225,572869437,572885748,16311,1953,225
572892669,572889880,572904927,15047,1954,225
572911755,572909183,572925595,16412,1955,225
572932515,572929727,572948297,18570,1956,225
572955114,572952543,572968975,16432,1957,225
572975896,572973107,572991340,18233,1958,225
572998166,572995594,573011711,16117,1959,225
573018632,573015843,573033759,17916,1960,225
573040680,573037891,573055827,17936,1961,225
573062748,573059959,573078844,18885,1962,225
573085661,573083089,573097602,14513,1963,225
573104407,573101836,573120505,18669,1964,225
573127426,573124637,573139684,15047,1965,225
573146603,573143815,573161751,17936,1966,225
573168672,573165883,573185087,19204,1967,225
573192007,573189219,573207788,18569,1968,225
573214708,573211920,573229517,17597,1969,225
573236438,573233649,573250299,16650,1970,225
573257221,573254431,573271083,16652,1971,225
573278003,573275215,573290893,15678,1972,225
573297812,573295024,573314227,19203,1973,225
573321148,573318359,573333721,15362,1974,225
573340640,573337852,573355767,17915,1975,225
573362686,573359899,573376209,16310,1976,225
573383129,573380341,573397306,16965,1977,225
573404227,573401438,573417771,16333,1978,225
573424691,573421903,573438868,16965,1979,225
573445789,573443001,573459649,16648,1980,225
573466568,573463780,573480092,16312,1981,225
573487012,573484224,573500873,16649,1982,225
573507794,573505005,573521338,16333,1983,225
573528257,573525469,573541148,15679,1984,225
573548067,573545279,573560958,15679,1985,225
573567878,573565089,573581422,16333,1986,225
573588342,573585554,573600915,15361,1987,225
573607834,573605046,573620724,15678,1988,225
573627643,573624855,573640216,15361,1989,225
573647135,573644347,573660679,16332,1990,225
573667599,573664811,573680805,15994,1991,225
573687724,573684936,573700930,15994,1992,225
573707849,573705061,573722343,17282,1993,225
573729264,573726475,573744074,17599,1994,225
573750995,573748206,573766123,17917,1995,225
573773043,573770255,573787538,17283,1996,225
573794344,573791773,573809154,17381,1997,225
573816074,573813286,573830905,17619,1998,225
573837826,573835037,573851349,16312,1999,225
573858270,573855481,573873714,18233,2000,225
573880635,573877846,573896732,18886,2001,225
573903651,573900864,573916857,15993,2002,225
573923776,573920988,573937299,16311,2003,225
573944219,573941431,573960001,18570,2004,225
573966923,573964133,573982051,17918,2005,225
573988971,573986183,574004099,17916,2006,225
574011019,574008231,574023908,15677,2007,225
574030828,574028040,574045637,17597,2008,225
574052559,574049770,574066736,16966,2009,225
574073655,574070868,574088149,17281,2010,225
574095070,574092281,574108932,16651,2011,225
574115851,574113064,574131632,18568,2012,225
574138553,574135764,574152098,16334,2013,225
574159017,574156230,574173172,16942,2014,225
574180095,574177305,574192352,15047,2015,225
574199153,574196581,574213014,16433,2016,225
574219935,574217146,574233141,15995,2017,225
574240060,574237272,574254235,16963,2018,225
574261155,574258367,574276281,17914,2019,225
574283202,574280414,574297695,17281,2020,225
574304614,574301827,574320711,18884,2021,225
574327632,574324843,574340838,15995,2022,225
574347758,574344969,574361301,16332,2023,225
574368221,574365433,574382716,17283,2024,225
574389523,574386951,574403363,16412,2025,225
574410283,574407495,574425747,18252,2026,225
574432668,574429879,574447479,17600,2027,225
574454399,574451611,574469546,17935,2028,225
574476467,574473678,574491931,18253,2029,225
574498853,574496063,574513346,17283,2030,225
574520266,574517478,574535412,17934,2031,225
574542332,574539544,574556827,17283,2032,225
574563638,574561066,574576211,15145,2033,225
574583132,574580343,574595706,15363,2034,225
574602515,574599942,574617980,18038,2035,225
574624901,574622112,574638762,16650,2036,225
574645570,574642999,574659092,16093,2037,225
574666013,574663225,574679537,16312,2038,225
574686456,574683669,574700634,16965,2039,225
574707450,574704878,574720973,16095,2040,225
574727893,574725105,574742071,16966,2041,225
574748993,574746204,574761566,15362,2042,225
574768487,574765698,574783298,17600,2043,225
574790219,574787430,574805028,17598,2044,225
574811948,574809160,574825786,16626,2045,225
574832614,574830042,574847107,17065,2046,225
574854029,574851240,574869495,18255,2047,225
574876416,574873627,574888989,15362,2048,225
574895907,574893120,574909451,16331,2049,225
574916371,574913583,574931182,17599,2050,225
574938103,574935314,574952281,16967,2051,225
574959202,574956413,574974013,17600,2052,225
574980932,574978145,574993189,15044,2053,225
575000109,574997321,575014287,16966,2054,225
575021208,575018419,575035047,16628,2055,225
575041969,575039180,575062647,23467,2056,225
575069568,575066780,575082775,15995,2057,225
575089696,575086907,575101953,15046,2058,225
575108873,575106085,575122735,16650,2059,225
575129656,575126867,575143201,16334,2060,225
575150121,575147333,575164297,16964,2061,225
575171217,575168429,575185395,16966,2062,225
575192315,575189527,575205204,15677,2063,225
575212017,575209445,575228115,18670,2064,225
575235036,575232248,575249530,17282,2065,225
575256450,575253662,575269972,16310,2066,225
575276892,575274104,575290415,16311,2067,225
575297335,575294547,575310859,16312,2068,225
575317779,575314991,575331956,16965,2069,225
575338876,575336088,575352082,15994,2070,225
575359003,575356214,575371261,15047,2071,225
575378181,575375393,575393963,18570,2072,225
575400884,575398096,575415695,17599,2073,225
575422615,575419827,575437108,17281,2074,225
575444028,575441240,575456918,15678,2075,225
575463838,575461050,575479303,18253,2076,225
575486225,575483436,575498799,15363,2077,225
575505719,575502931,575520550,17619,2078,225
575527379,575524806,575541872,17066,2079,225
575548792,575546004,575563919,17915,2080,225
575570842,575568052,575583099,15047,2081,225
575590019,575587231,575604830,17599,2082,225
575611751,575608963,575625612,16649,2083,225
575632532,575629744,575647027,17283,2084,225
575653948,575651160,575668441,17281,2085,225
575675361,575672573,575691143,18570,2086,225
575698066,575695276,575712876,17600,2087,225
575719797,575717008,575735578,18570,2088,225
575742498,575739710,575756359,16649,2089,225
575763280,575760491,575778744,18253,2090,225
575785665,575782876,575798554,15678,2091,225
575805475,575802686,575821571,18885,2092,225
575828492,575825703,575841382,15679,2093,225
575848302,575845514,575862162,16648,2094,225
575869084,575866294,575884211,17917,2095,225
575891133,575888344,575905943,17599,2096,225
575912864,575910076,575927991,17915,2097,225
575934911,575932124,575947168,15044,2098,225
575954088,575951300,575968899,17599,2099,225
575975820,575973032,575990969,17937,2100,225
575997890,575995102,576011414,16312,2101,225
576018334,576015546,576032829,17283,2102,225
576039749,576036961,576054896,17935,2103,225
576061816,576059028,576075360,16332,2104,225
576082281,576079492,576095803,16311,2105,225
576102724,576099935,576117533,17598,2106,225
576124454,576121665,576137661,15996,2107,225
576144482,576141910,576159947,18037,2108,225
576166867,576164079,576181361,17282,2109,225
576188282,576185493,576202144,16651,2110,225
576209065,576206276,576223241,16965,2111,225
576230161,576227373,576244337,16964,2112,225
576251258,576248469,576265436,16967,2113,225
576272259,576269687,576286437,16750,2114,225
576293357,576290569,576307219,16650,2115,225
576314026,576311454,576327886,16432,2116,225
576334807,576332018,576347718,15700,2117,225
576354638,576351849,576366894,15045,2118,225
576373813,576371025,576388307,17282,2119,225
576395229,576392440,576410039,17599,2120,225
576416960,576414171,576432108,17937,2121,225
576439028,576436240,576451919,15679,2122,225
576458838,576456051,576473332,17281,2123,225
576480145,576477573,576494322,16749,2124,225
576501119,576498548,576514663,16115,2125,225
576521583,576518795,576537365,18570,2126,225
576544285,576541497,576559093,17596,2127,225
576566013,576563225,576578904,15679,2128,225
576585822,576583035,576600315,17280,2129,225
576607236,576604447,576621413,16966,2130,225
576628233,576625661,576641440,15779,2131,225
576648359,576645571,576663507,17936,2132,225
576670428,576667639,576684585,16946,2133,225
576691409,576688838,576703349,14511,2134,225
576710268,576707480,576724761,17281,2135,225
576731681,576728893,576746827,17934,2136,225
576753748,576750959,576768241,17282,2137,225
576775161,576772373,576789022,16649,2138,225
576795824,576793253,576810317,17064,2139,225
576817238,576814449,576833020,18571,2140,225
576839940,576837152,576854117,16965,2141,225
576861038,576858249,576875531,17282,2142,225
576882452,576879663,576894414,14751,2143,225
576901334,576898545,576917115,18570,2144,225
576923913,576921341,576936171,14830,2145,225
576943090,576940302,576957585,17283,2146,225
576964506,576961717,576980287,18570,2147,225
576987207,576984419,577003305,18886,2148,225
577010225,577007437,577023747,16310,2149,225
577030669,577027880,577044191,16311,2150,225
577051111,577048323,577065289,16966,2151,225
577072209,577069421,577088623,19202,2152,225
577095544,577092755,577108751,15996,2153,225
577115670,577112882,577129531,16649,2154,225
577136343,577133771,577150204,16433,2155,225
577157123,577154336,577171280,16944,2156,225
577178200,577175412,577192061,16649,2157,225
577198982,577196193,577212822,16629,2158,225
577219744,577216954,577233922,16968,2159,225
577240842,577238054,577254366,16312,2160,225
577261288,577258499,577276098,17599,2161,225
577283019,577280230,577297195,16965,2162,225
577304116,577301327,577317639,16312,2163,225
577324559,577321771,577339685,17914,2164,225
577346606,577343817,577360782,16965,2165,225
577367702,577364914,577382195,17281,2166,225
577389115,577386327,577403292,16965,2167,225
577410213,577407424,577425341,17917,2168,225
577432262,577429473,577446440,16967,2169,225
577453360,577450572,577467219,16647,2170,225
577474139,577471351,577489266,17915,2171,225
577496185,577493398,577510363,16965,2172,225
577517283,577514495,577532094,17599,2173,225
577538913,577536341,577552119,15778,2174,225
577559039,577556250,577574504,18254,2175,225
577581425,577578636,577593387,14751,2176,225
577600307,577597518,577615117,17599,2177,225
577622038,577619249,577636216,16967,2178,225
577643136,577640347,577657945,17598,2179,225
577664865,577662077,577680013,17936,2180,225
577686933,577684145,577699823,15678,2181,225
577706629,577704057,577719203,15146,2182,225
577726020,577723449,577740830,17381,2183,225
577747751,577744962,577760957,15995,2184,225
577767877,577765088,577782688,17600,2185,225
577789609,577786820,577802183,15363,2186,225
577809103,577806314,577823913,17599,2187,225
577830834,577828045,577846298,18253,2188,225
577853218,577850430,577868029,17599,2189,225
577874733,577872161,577888293,16132,2190,225
577895213,577892425,577909074,16649,2191,225
577915995,577913206,577928885,15679,2192,225
577935804,577933016,577951584,18568,2193,225
577958505,577955716,577970446,14730,2194,225
577977365,577974577,577991858,17281,2195,225
577998778,577995990,578011985,15995,2196,225
578018905,578016117,578032110,15993,2197,225
578039029,578036241,578054155,17914,2198,225
578061075,578058287,578075252,16965,2199,225
578082172,578079384,578095717,16333,2200,225
578102638,578099849,578116815,16966,2201,225
578123735,578120947,578136940,15993,2202,225
578143860,578141072,578158038,16966,2203,225
578164959,578162170,578177215,15045,2204,225
578184135,578181346,578197680,16334,2205,225
578204600,578201812,578219748,17936,2206,225
578226669,578223880,578241162,17282,2207,225
578248082,578245294,578262238,16944,2208,225
578269158,578266370,578284286,17916,2209,225
578291206,578288418,578306985,18567,2210,225
578313905,578311117,578328083,16966,2211,225
578335003,578332215,578347576,15361,2212,225
578354496,578351708,578368674,16966,2213,225
578375595,578372806,578390404,17598,2214,225
578397325,578394536,578411502,16966,2215,225
578418423,578415635,578433551,17916,2216,225
578440471,578437683,578455914,18231,2217,225
578462834,578460046,578475725,15679,2218,225
578482548,578479976,578497042,17066,2219,225
578503963,578501174,578517508,16334,2220,225
578524429,578521640,578537319,15679,2221,225
578544239,578541451,578557782,16331,2222,225
578564582,578562011,578580047,18036,2223,225
578586967,578584179,578599858,15679,2224,225
578606777,578603989,578619667,15678,2225,225
578626587,578623799,578640763,16964,2226,225
578647684,578644895,578661228,16333,2227,225
578668147,578665360,578681691,16331,2228,225
578688611,578685823,578703759,17936,2229,225
578710680,578707891,578724858,16967,2230,225
578731779,578728990,578745619,16629,2231,225
578752539,578749751,578767032,17281,2232,225
578773952,578771164,578786525,15361,2233,225
578793444,578790656,578806335,15679,2234,225
578813256,578810467,578827411,16944,2235,225
578834331,578831543,578846271,14728,2236,225
578853191,578850403,578866419,16016,2237,225
578873340,578870551,578888805,18254,2238,225
578895726,578892937,578910219,17282,2239,225
578917026,578914455,578932808,18353,2240,225
578939728,578936940,578955194,18254,2241,225
578962115,578959326,578976291,16965,2242,225
578983212,578980423,578999625,19202,2243,225
579006546,579003757,579022325,18568,2244,225
579029245,579026457,579043422,16965,2245,225
579050342,579047554,579063865,16311,2246,225
579070680,579068109,579086124,18015,2247,225
579093045,579090257,579105619,15362,2248,225
579112540,579109751,579125429,15678,2249,225
579132349,579129561,579144607,15046,2250,225
579151528,579148739,579165388,16649,2251,225
579172200,579169629,579185090,15461,2252,225
579192010,579189222,579206503,17281,2253,225
579213423,579210635,579227917,17282,2254,225
579234738,579232166,579249866,17700,2255,225
579256786,579253998,579272885,18887,2256,225
579279805,579277017,579292062,15045,2257,225
579298982,579296193,579314447,18254,2258,225
579321368,579318579,579333624,15045,2259,225
579340543,579337755,579354404,16649,2260,225
579361324,579358536,579374846,16310,2261,225
579381766,579378978,579395605,16627,2262,225
579402526,579399737,579415100,15363,2263,225
579422020,579419231,579436830,17599,2264,225
579443750,579440962,579457926,16964,2265,225
579464846,579462058,579480628,18570,2266,225
579487549,579484760,579503331,18571,2267,225
579510252,579507463,579522510,15047,2268,225
579529431,579526642,579542322,15680,2269,225
579549242,579546454,579561498,15044,2270,225
579568418,579565630,579580674,15044,2271,225
579587594,579584806,579602405,17599,2272,225
579609325,579606537,579624453,17916,2273,225
579631373,579628585,579644599,16014,2274,225
579651520,579648731,579665044,16313,2275,225
579671964,579669176,579687746,18570,2276,225
579694567,579691995,579708743,16748,2277,225
579715664,579712875,579730813,17938,2278,225
579737732,579734945,579750938,15993,2279,225
579757857,579755069,579771063,15994,2280,225
579777983,579775194,579791843,16649,2281,225
579798763,579795975,579813257,17282,2282,225
579820071,579817499,579832329,14830,2283,225
579839250,579836461,579854693,18232,2284,225
579861613,579858825,579875451,16626,2285,225
579882371,579879583,579896866,17283,2286,225
579903693,579901121,579916900,15779,2287,225
579923818,579921031,579937680,16649,2288,225
579944495,579941924,579958672,16748,2289,225
579965593,579962805,579981057,18252,2290,225
579987978,579985190,580001839,16649,2291,225
580008761,580005971,580023888,17917,2292,225
580030684,580028113,580045493,17380,2293,225
580052414,580049625,580066592,16967,2294,225
580073512,580070724,580086719,15995,2295,225
580093638,580090850,580106844,15994,2296,225
580113764,580110976,580127940,16964,2297,225
580134860,580132072,580149671,17599,2298,225
580156591,580153803,580173006,19203,2299,225
580179926,580177138,580193787,16649,2300,225
580200707,580197919,580214862,16943,2301,225
580221783,580218994,580236592,17598,2302,225
580243514,580240725,580257036,16311,2303,225
580263957,580261168,580279400,18232,2304,225
580286321,580283532,580299212,15680,2305,225
580306131,580303343,580320626,17283,2306,225
580327546,580324758,580342040,17282,2307,225
580348842,580346271,580364622,18351,2308,225
580371543,580368754,580385720,16966,2309,225
580392641,580389852,580405531,15679,2310,225
580412451,580409663,580425341,15678,2311,225
580432260,580429473,580447070,17597,2312,225
580453991,580451203,580468486,17283,2313,225
580475406,580472618,580490554,17936,2314,225
580497475,580494686,580511652,16966,2315,225
580518573,580515784,580532413,16629,2316,225
580539213,580536641,580553370,16729,2317,225
580560291,580557503,580573497,15994,2318,225
580580418,580577629,580593625,15996,2319,225
580600545,580597757,580616643,18886,2320,225
580623564,580620776,580637425,16649,2321,225
580644345,580641557,580658205,16648,2322,225
580665126,580662337,580679621,17284,2323,225
580686541,580683753,580702004,18251,2324,225
580708925,580706136,580720866,14730,2325,225
580727787,580724998,580743569,18571,2326,225
580750489,580747701,580763062,15361,2327,225
580769983,580767194,580784794,17600,2328,225
580791716,580788926,580807497,18571,2329,225
580814417,580811629,580828278,16649,2330,225
580835199,580832410,580849691,17281,2331,225
580856612,580853823,580869819,15996,2332,225
580876738,580873951,580891231,17280,2333,225
580898151,580895363,580913933,18570,2334,225
580920755,580918185,580935565,17380,2335,225
580942486,580939697,580957614,17917,2336,225
580964411,580961839,580978904,17065,2337,225
580985719,580983148,580999896,16748,2338,225
581006816,581004028,581023231,19203,2339,225
581030152,581027363,581043043,15680,2340,225
581049852,581047280,581063396,16116,2341,225
581070316,581067528,581084494,16966,2342,225
581091414,581088626,581105274,16648,2343,225
581112196,581109407,581127660,18253,2344,225
581134581,581131793,581149076,17283,2345,225
581155997,581153208,581169203,15995,2346,225
581176123,581173335,581190617,17282,2347,225
581197443,581194872,581210649,15777,2348,225
581217571,581214781,581230779,15998,2349,225
581237700,581234911,581252511,17600,2350,225
581259335,581256764,581271592,14828,2351,225
581278512,581275724,581292371,16647,2352,225
581299292,581296503,581315074,18571,2353,225
581321994,581319206,581337776,18570,2354,225
581344697,581341908,581358854,16946,2355,225
581365773,581362986,581380900,17914,2356,225
581387726,581385153,581402854,17701,2357,225
581409776,581406987,581423636,16649,2358,225
581430441,581427868,581446222,18354,2359,225
581453027,581450455,581468492,18037,2360,225
581475411,581472624,581489906,17282,2361,225
581496826,581494038,581511004,16966,2362,225
581517925,581515136,581532419,17283,2363,225
581539341,581536552,581551915,15363,2364,225
581558836,581556047,581577952,21905,2365,225
581584873,581582085,581598734,16649,2366,225
581605560,581602988,581619738,16750,2367,225
581626562,581623990,581640424,16434,2368,225
581647345,581644557,581661206,16649,2369,225
581668127,581665338,581681967,16629,2370,225
581688764,581686193,581702941,16748,2371,225
581709863,581707073,581723385,16312,2372,225
581730304,581727517,581744165,16648,2373,225
581750979,581748408,581766760,18352,2374,225
581773680,581770892,581787222,16330,2375,225
581794143,581791354,581807033,15679,2376,225
581813838,581811266,581829619,18353,2377,225
581836540,581833751,581850718,16967,2378,225
581857640,581854851,581874054,19203,2379,225
581880852,581878280,581894692,16412,2380,225
581901612,581898824,581915789,16965,2381,225
581922590,581920019,581935797,15778,2382,225
581942613,581940041,581956790,16749,2383,225
581963616,581961045,581977477,16432,2384,225
581984398,581981609,581999544,17935,2385,225
582006464,582003676,582019037,15361,2386,225
582025957,582023169,582042053,18884,2387,225
582048974,582046185,582061547,15362,2388,225
582068467,582065679,582081694,16015,2389,225
582088614,582085826,582103109,17283,2390,225
582109929,582107357,582122502,15145,2391,225
582129421,582126634,582144886,18252,2392,225
582151806,582149018,582165961,16943,2393,225
582172882,582170093,582186764,16671,2394,225
582193684,582190896,582209465,18569,2395,225
582216387,582213598,582230247,16649,2396,225
582237168,582234380,582250058,15678,2397,225
582256979,582254190,582269552,15362,2398,225
582276471,582273683,582291934,18251,2399,225
582298856,582296066,582311746,15680,2400,225
582318666,582315878,582332525,16647,2401,225
582339342,582336770,582352549,15779,2402,225
582359470,582356681,582375569,18888,2403,225
582382490,582379702,582397300,17598,2404,225
582404221,582401433,582420318,18885,2405,225
582427239,582424450,582440783,16333,2406,225
582447705,582444915,582462516,17601,2407,225
582469435,582466648,582483928,17280,2408,225
582490849,582488060,582510240,22180,2409,225
582516943,582514372,582536981,22609,2410,225
582543903,582541113,582558712,17599,2411,225
582565633,582562845,582580761,17916,2412,225
582587681,582584893,582601522,16629,2413,225
582608443,582605654,582621987,16333,2414,225
582628908,582626119,582644352,18233,2415,225
582651273,582648484,582664480,15996,2416,225
582671401,582668612,582683974,15362,2417,225
582690894,582688106,582705389,17283,2418,225
582712093,582709521,582727657,18136,2419,225
582734577,582731789,582746834,15045,2420,225
582753753,582750965,582770168,19203,2421,225
582777090,582774301,582791265,16964,2422,225
582798092,582795520,582813240,17720,2423,225
582820042,582817469,582833902,16433,2424,225
582840823,582838035,582855634,17599,2425,225
582862555,582859767,582877049,17282,2426,225
582883971,582881182,582897515,16333,2427,225
582904436,582901647,582919268,17621,2428,225
582926188,582923400,582940048,16648,2429,225
582946968,582944180,582960830,16650,2430,225
582967750,582964962,582981611,16649,2431,225
582988532,582985743,583003343,17600,2432,225
583010151,583007580,583024012,16432,2433,225
583030932,583028144,583044476,16332,2434,225
583051301,583048729,583067080,18351,2435,225
583074001,583071212,583088199,16987,2436,225
583095119,583092331,583109613,17282,2437,225
583116534,583113745,583130712,16967,2438,225
583137633,583134845,583151494,16649,2439,225
583158415,583155627,583171644,16017,2440,225
583178565,583175776,583192404,16628,2441,225
583199326,583196537,583214453,17916,2442,225
583221375,583218586,583234897,16311,2443,225
583241817,583239029,583255676,16647,2444,225
583262597,583259809,583276459,16650,2445,225
583283284,583280713,583297144,16431,2446,225
583304064,583301276,583318221,16945,2447,225
583325141,583322353,583339319,16966,2448,225
583346239,583343451,583358812,15361,2449,225
583365638,583363067,583380766,17699,2450,225
583387687,583384899,583402182,17283,2451,225
583409103,583406314,583423597,17283,2452,225
583430517,583427730,583446299,18569,2453,225
583453220,583450432,583467715,17283,2454,225
583474635,583471847,583488158,16311,2455,225
583495078,583492290,583509570,17280,2456,225
583516371,583513800,583530865,17065,2457,225
583537786,583534998,583552596,17598,2458,225
583559516,583556728,583573673,16945,2459,225
583580594,583577806,583594454,16648,2460,225
583601377,583598587,583614921,16334,2461,225
583621842,583619053,583636020,16967,2462,225
583642941,583640153,583656147,15994,2463,225
583663067,583660279,583677561,17282,2464,225
583684481,583681693,583699945,18252,2465,225
583706866,583704077,583720072,15995,2466,225
583726992,583724203,583742456,18253,2467,225
583749377,583746588,583765475,18887,2468,225
583772396,583769607,583786258,16651,2469,225
583793058,583790487,583805948,15461,2470,225
583812868,583810080,583825123,15043,2471,225
583832043,583829255,583844933,15678,2472,225
583851853,583849065,583866009,16944,2473,225
583872929,583870141,583887739,17598,2474,225
583894660,583891872,583910441,18569,2475,225
583917362,583914573,583933143,18570,2476,225
583940064,583937275,583952638,15363,2477,225
583959559,583956770,583973736,16966,2478,225
583980656,583977868,583994517,16649,2479,225
584001438,583998649,584017218,18569,2480,225
584024139,584021350,584038317,16967,2481,225
584045236,584042449,584059075,16626,2482,225
584065995,584063207,584081144,17937,2483,225
584088064,584085276,584102241,16965,2484,225
584109161,584106373,584123338,16965,2485,225
584130259,584127470,584143465,15995,2486,225
584150385,584147597,584162643,15046,2487,225
584169563,584166774,584185976,19202,2488,225
584192897,584190108,584208024,17916,2489,225
584214945,584212156,584228785,16629,2490,225
584235706,584232917,584250854,17937,2491,225
584257672,584255102,584271195,16093,2492,225
584278115,584275327,584292292,16965,2493,225
584299213,584296424,584312103,15679,2494,225
584319024,584316235,584333835,17600,2495,225
584340757,584337968,584355250,17282,2496,225
584362171,584359382,584375061,15679,2497,225
584381981,584379193,584396158,16965,2498,225
584403080,584400291,584417889,17598,2499,225
584424809,584422021,584441224,19203,2500,225
584448145,584445357,584462955,17598,2501,225
584469876,584467088,584483736,16648,2502,225
584490657,584487868,584503547,15679,2503,225
584510467,584507679,584524012,16333,2504,225
584530934,584528145,584546082,17937,2505,225
584553003,584550214,584566843,16629,2506,225
584573765,584570976,584586656,15680,2507,225
584593577,584590788,584609991,19203,2508,225
584616796,584614224,584631291,17067,2509,225
584638213,584635424,584653994,18570,2510,225
584660915,584658127,584673805,15678,2511,225
584680725,584677936,584695536,17600,2512,225
584702458,584699669,584717923,18254,2513,225
584724844,584722055,584738366,16311,2514,225
584745286,584742498,584760097,17599,2515,225
584767017,584764229,584781828,17599,2516,225
584788749,584785961,584801957,15996,2517,225
584808876,584806088,584824002,17914,2518,225
584830923,584828135,584845418,17283,2519,225
584852340,584849551,584866517,16966,2520,225
584873438,584870650,584885694,15044,2521,225
584892613,584889826,584908395,18569,2522,225
584915316,584912527,584928226,15699,2523,225
584935145,584932357,584947107,14750,2524,225
584954028,584951239,584968184,16945,2525,225
584975105,584972316,584991203,18887,2526,225
584998124,584995335,585012302,16967,2527,225
585019222,585016434,585033399,16965,2528,225
585040320,585037531,585052577,15046,2529,225
585059496,585056708,585073040,16332,2530,225
585079961,585077172,585094772,17600,2531,225
585101692,585098904,585116840,17936,2532,225
585123760,585120972,585140173,19201,2533,225
585147094,585144305,585162875,18570,2534,225
585169797,585167008,585184290,17282,2535,225
585191211,585188423,585205073,16650,2536,225
585211993,585209205,585225516,16311,2537,225
585232436,585229648,585246930,17282,2538,225
585253851,585251062,585267712,16650,2539,225
585274633,585271844,585289781,17937,2540,225
585296701,585293913,585309275,15362,2541,225
585316194,585313407,585329400,15993,2542,225
585336320,585333532,585350497,16965,2543,225
585357417,585354629,585373198,18569,2544,225
585380119,585377331,585394613,17282,2545,225
585401536,585398745,585414109,15364,2546,225
585421030,585418241,585436158,17917,2547,225
585443079,585440291,585458544,18253,2548,225
585465465,585462677,585478987,16310,2549,225
585485910,585483120,585499117,15997,2550,225
585506037,585503249,585519896,16647,2551,225
585526816,585524029,585540676,16647,2552,225
585547481,585544909,585561657,16748,2553,225
585568577,585565789,585580832,15043,2554,225
585587753,585584964,585600959,15995,2555,225
585607878,585605091,585623660,18569,2556,225
585630580,585627792,585644758,16966,2557,225
585651680,585648891,585665225,16334,2558,225
585672144,585669357,585688242,18885,2559,225
585695163,585692375,585707737,15362,2560,225
585714658,585711869,585727547,15678,2561,225
585734348,585731778,585748525,16747,2562,225
585755446,585752657,585769941,17284,2563,225
585776862,585774074,585790386,16312,2564,225
585797307,585794519,585811167,16648,2565,225
585817970,585815398,585833433,18035,2566,225
585840354,585837566,585853583,16017,2567,225
585860504,585857716,585874998,17282,2568,225
585881919,585879131,585895463,16332,2569,225
585902385,585899596,585918167,18571,2570,225
585924978,585922406,585938816,16410,2571,225
585945739,585942949,585961520,18571,2572,225
585968442,585965653,585983252,17599,2573,225
585990173,585987385,586004012,16627,2574,225
586010933,586008145,586026377,18232,2575,225
586033298,586030510,586047476,16966,2576,225
586054304,586051733,586068482,16749,2577,225
586075403,586072615,586088610,15995,2578,225
586095531,586092742,586107471,14729,2579,225
586114393,586111604,586128571,16967,2580,225
586135492,586132704,586149331,16627,2581,225
586156141,586153569,586170635,17066,2582,225
586177556,586174768,586191734,16966,2583,225
586198656,586195867,586213151,17284,2584,225
586220073,586217284,586234883,17599,2585,225
586241681,586239109,586255203,16094,2586,225
586262125,586259336,586274698,15362,2587,225
586281618,586278830,586296745,17915,2588,225
586303667,586300878,586317824,16946,2589,225
586324746,586321957,586337319,15362,2590,225
586344240,586341451,586358416,16965,2591,225
586365337,586362549,586381118,18569,2592,225
586388039,586385251,586400633,15382,2593,225
586407555,586404765,586421732,16967,2594,225
586428652,586425865,586443462,17597,2595,225
586450262,586447690,586465389,17699,2596,225
586472310,586469522,586486486,16964,2597,225
586493285,586490714,586507780,17066,2598,225
586514702,586511913,586530483,18570,2599,225
586537405,586534616,586553819,19203,2600,225
586560741,586557952,586573630,15678,2601,225
586580551,586577762,586594074,16312,2602,225
586600884,586598313,586615378,17065,2603,225
586622298,586619511,586638079,18568,2604,225
586644893,586642323,586658121,15798,2605,225
586665041,586662253,586680484,18231,2606,225
586687406,586684617,586702534,17917,2607,225
586709455,586706667,586722028,15361,2608,225
586728947,586726160,586744729,18569,2609,225
586751651,586748862,586764859,15997,2610,225
586771780,586768991,586786591,17600,2611,225
586793513,586790724,586806086,15362,2612,225
586813006,586810218,586826868,16650,2613,225
586833789,586831001,586849233,18232,2614,225
586856153,586853366,586869696,16330,2615,225
586876617,586873829,586892399,18570,2616,225
586899322,586896532,586911579,15047,2617,225
586918501,586915711,586932679,16968,2618,225
586939601,586936812,586954433,17621,2619,225
586961355,586958566,586975533,16967,2620,225
586982337,586979765,586996829,17064,2621,225
587003647,587001075,587016853,15778,2622,225
587023775,587020986,587037319,16333,2623,225
587044240,587041452,587058100,16648,2624,225
587065021,587062233,587079199,16966,2625,225
587086120,587083332,587099326,15994,2626,225
587106246,587103459,587118502,15043,2627,225
587125423,587122635,587138968,16333,2628,225
587145890,587143101,587161356,18255,2629,225
587168278,587165489,587181485,15996,2630,225
587188407,587185618,587203534,17916,2631,225
587210455,587207667,587223661,15994,2632,225
587230583,587227793,587244107,16314,2633,225
587251028,587248240,587264867,16627,2634,225
587271788,587269000,587285965,16965,2635,225
587292886,587290097,587307062,16965,2636,225
587313983,587311195,587329130,17935,2637,225
587336052,587333263,587351833,18570,2638,225
587358754,587355966,587371961,15995,2639,225
587378882,587376094,587391772,15678,2640,225
587398692,587395904,587411898,15994,2641,225
587418819,587416030,587431075,15045,2642,225
587437996,587435207,587452489,17282,2643,225
587459304,587456733,587473798,17065,2644,225
587480718,587477931,587493608,15677,2645,225
587500529,587497741,587514052,16311,2646,225
587520973,587518185,587534834,16649,2647,225
587541755,587538967,587556249,17282,2648,225
587563171,587560382,587578952,18570,2649,225
587585875,587583085,587600369,17284,2650,225
587607290,587604502,587620835,16333,2651,225
587627756,587624968,587642566,17598,2652,225
587649487,587646699,587662061,15362,2653,225
587668981,587666193,587684108,17915,2654,225
587691029,587688241,587707127,18886,2655,225
587714049,587711260,587726939,15679,2656,225
587733860,587731072,587748038,16966,2657,225
587754960,587752171,587767533,15362,2658,225
587774454,587771665,587788313,16648,2659,225
587795234,587792446,587808461,16015,2660,225
587815382,587812594,587827639,15045,2661,225
587834560,587831771,587848716,16945,2662,225
587855541,587852969,587870352,17383,2663,225
587877273,587874485,587893054,18569,2664,225
587899975,587897187,587915757,18570,2665,225
587922679,587919890,587937489,17599,2666,225
587944409,587941622,587958903,17281,2667,225
587965825,587963036,587979369,16333,2668,225
587986289,587983502,588002071,18569,2669,225
588008992,588006204,588022537,16333,2670,225
588029458,588026670,588044922,18252,2671,225
588051844,588049055,588066654,17599,2672,225
588073575,588070787,588088069,17282,2673,225
588094991,588092202,588108197,15995,2674,225
588115006,588112434,588128234,15800,2675,225
588135154,588132366,588149332,16966,2676,225
588156254,588153465,588171719,18254,2677,225
588178641,588175852,588191848,15996,2678,225
588198645,588196073,588213456,17383,2679,225
588220377,588217589,588233606,16017,2680,225
588240527,588237739,588254704,16965,2681,225
588261625,588258837,588276753,17916,2682,225
588283674,588280886,588296565,15679,2683,225
588303485,588300697,588318633,17936,2684,225
588325555,588322766,588341018,18252,2685,225
588347939,588345151,588362116,16965,2686,225
588369037,588366249,588382561,16312,2687,225
588389482,588386694,588403342,16648,2688,225
588410264,588407475,588422836,15361,2689,225
588429756,588426968,588445222,18254,2690,225
588452143,588449355,588466954,17599,2691,225
588473877,588471087,588489025,17938,2692,225
588495834,588493262,588509358,16096,2693,225
588516173,588513602,588530034,16432,2694,225
588536955,588534167,588551133,16966,2695,225
588558055,588555266,588570946,15680,2696,225
588577866,588575078,588592359,17281,2697,225
588599172,588596600,588613012,16412,2698,225
588619933,588617145,588633792,16647,2699,225
588640713,588637925,588653287,15362,2700,225
588660209,588657420,588674386,16966,2701,225
588681204,588678632,588695699,17067,2702,225
588702517,588699945,588716357,16412,2703,225
588723279,588720490,588737456,16966,2704,225
588744378,588741589,588758872,17283,2705,225
588765794,588763006,588779634,16628,2706,225
588786555,588783767,588801048,17281,2707,225
588807969,588805181,588820859,15678,2708,225
588827778,588824991,588842270,17279,2709,225
588849191,588846403,588862082,15679,2710,225
588869002,588866214,588883494,17280,2711,225
588890416,588887627,588904594,16967,2712,225
588911513,588908726,588924719,15993,2713,225
588931639,588928851,588944846,15995,2714,225
588951767,588948978,588967548,18570,2715,225
588974469,588971681,588988309,16628,2716,225
588995230,588992442,589009089,16647,2717,225
589016009,589013221,589030503,17282,2718,225
589037315,589034743,589050206,15463,2719,225
589057006,589054435,589068946,14511,2720,225
589075866,589073078,589090361,17283,2721,225
589097282,589094494,589109856,15362,2722,225
589116776,589113988,589131586,17598,2723,225
589138507,589135719,589152029,16310,2724,225
589158950,589156162,589175364,19202,2725,225
589182285,589179497,589195175,15678,2726,225
589202097,589199307,589218196,18889,2727,225
589225117,589222329,589240264,17935,2728,225
589247185,589244397,589260730,16333,2729,225
589267651,589264863,589282779,17916,2730,225
589289701,589286912,589304828,17916,2731,225
589311750,589308961,589325928,16967,2732,225
589332732,589330160,589346910,16750,2733,225
589353831,589351043,589367987,16944,2734,225
589374909,589372120,589388432,16312,2735,225
589395353,589392565,589408243,15678,2736,225
589415163,589412375,589431578,19203,2737,225
589438500,589435711,589453311,17600,2738,225
589460233,589457444,589472807,15363,2739,225
589479727,589476939,589492618,15679,2740,225
589499538,589496750,589515003,18253,2741,225
589521830,589519259,589535987,16728,2742,225
589542909,589540120,589557403,17283,2743,225
589564214,589561643,589578708,17065,2744,225
589585628,589582841,589601726,18885,2745,225
589608648,589605859,589623796,17937,2746,225
589630717,589627929,589644240,16311,2747,225
589651161,589648373,589665654,17281,2748,225
589672576,589669787,589685150,15363,2749,225
589692070,589689282,589707219,17937,2750,225
589714021,589711450,589728196,16746,2751,225
589735118,589732329,589748980,16651,2752,225
589755791,589753219,589770917,17698,2753,225
589777838,589775050,589791362,16312,2754,225
589798283,589795495,589812143,16648,2755,225
589819064,589816276,589833558,17282,2756,225
589840480,589837691,589855290,17599,2757,225
589862095,589859523,589875955,16432,2758,225
589882876,589880087,589898003,17916,2759,225
589904923,589902135,589920051,17916,2760,225
589926971,589924183,589941801,17618,2761,225
589948723,589945934,589961612,15678,2762,225
589968532,589965744,589983025,17281,2763,225
589989946,589987158,590004756,17598,2764,225
590011677,590008889,590024884,15995,2765,225
590031805,590029016,590044379,15363,2766,225
590051300,590048511,590063873,15362,2767,225
590070794,590068005,590085288,17283,2768,225
590092209,590089421,590105754,16333,2769,225
590112674,590109886,590126217,16331,2770,225
590133138,590130350,590146344,15994,2771,225
590153265,590150476,590167124,16648,2772,225
590174046,590171257,590190145,18888,2773,225
590197065,590194277,590210610,16333,2774,225
590217532,590214743,590230738,15995,2775,225
590237658,590234870,590251519,16649,2776,225
590258440,590255652,590273905,18253,2777,225
590280826,590278038,590294686,16648,2778,225
590301608,590298819,590315153,16334,2779,225
590322074,590319286,590337222,17936,2780,225
590344143,590341355,590358004,16649,2781,225
590364925,590362137,590377498,15361,2782,225
590384419,590381630,590399230,17600,2783,225
590406151,590403363,590420329,16966,2784,225
590427249,590424461,590441109,16648,2785,225
590448030,590445242,590464128,18886,2786,225
590471048,590468260,590484254,15994,2787,225
590491174,590488386,590506300,17914,2788,225
590513221,590510433,590526110,15677,2789,225
590533030,590530242,590546891,16649,2790,225
590553813,590551024,590566703,15679,2791,225
590573623,590570835,590588749,17914,2792,225
590595670,590592882,590610481,17599,2793,225
590617401,590614613,590632212,17599,2794,225
590639133,590636345,590653944,17599,2795,225
590660866,590658077,590675042,16965,2796,225
590681964,590679175,590697113,17938,2797,225
590704035,590701246,590717558,16312,2798,225
590724361,590721789,590737588,15799,2799,225
590744388,590741816,590759516,17700,2800,225
590766438,590763649,590780594,16945,2801,225
590787516,590784727,590800744,16017,2802,225
590807665,590804877,590821526,16649,2803,225
590828447,590825659,590842940,17281,2804,225
590849861,590847073,590864989,17916,2805,225
590871909,590869122,590884800,15678,2806,225
590891616,590889044,590905161,16117,2807,225
590912082,590909294,590926913,17619,2808,225
590933835,590931046,590947695,16649,2809,225
590954616,590951827,590968813,16986,2810,225
590975734,590972946,590991177,18231,2811,225
590997990,590995419,591013772,18353,2812,225
591020693,591017905,591035525,17620,2813,225
591042447,591039658,591055654,15996,2814,225
591062575,591059787,591074516,14729,2815,225
591081436,591078648,591095276,16628,2816,225
591102197,591099409,591114771,15362,2817,225
591121692,591118903,591134899,15996,2818,225
591141819,591139031,591156312,17281,2819,225
591163233,591160445,591178043,17598,2820,225
591184964,591182176,591199458,17282,2821,225
591206378,591203591,591219268,15677,2822,225
591226188,591223400,591240365,16965,2823,225
591247286,591244498,591262097,17599,2824,225
591269019,591266230,591282542,16312,2825,225
591289463,591286675,591304590,17915,2826,225
591311512,591308723,591326955,18232,2827,225
591333772,591331201,591347633,16432,2828,225
591354554,591351766,591366494,14728,2829,225
591373414,591370626,591387907,17281,2830,225
591394827,591392039,591409954,17915,2831,225
591416875,591414087,591432319,18232,2832,225
591439240,591436452,591454366,17914,2833,225
591461288,591458499,591475128,16629,2834,225
591482049,591479261,591495573,16312,2835,225
591502495,591499706,591517621,17915,2836,225
591524542,591521754,591540006,18252,2837,225
591546927,591544139,591561104,16965,2838,225
591568025,591565237,591581864,16627,2839,225
591588569,591585997,591605083,19086,2840,225
591612004,591609216,591624894,15678,2841,225
591631814,591629026,591645991,16965,2842,225
591652913,591650124,591667407,17283,2843,225
591674327,591671540,591688821,17281,2844,225
591695649,591693076,591709194,16118,2845,225
591716116,591713327,591729957,16630,2846,225
591736878,591734089,591752977,18888,2847,225
591759786,591757215,591772360,15145,2848,225
591779280,591776492,591794091,17599,2849,225
591801012,591798224,591814873,16649,2850,225
591821795,591819006,591837238,18232,2851,225
591844160,591841372,591857367,15995,2852,225
591864288,591861499,591878147,16648,2853,225
591885069,591882280,591898592,16312,2854,225
591905513,591902724,591919689,16965,2855,225
591926610,591923822,591942392,18570,2856,225
591949315,591946525,591963174,16649,2857,225
591969977,591967405,591982551,15146,2858,225
591989472,591986683,592003629,16946,2859,225
592010552,592007762,592023443,15681,2860,225
592030363,592027575,592042324,14749,2861,225
592049243,592046456,592065025,18569,2862,225
592071946,592069158,592085785,16627,2863,225
592092705,592089918,592108169,18251,2864,225
592115090,592112302,592130238,17936,2865,225
592137160,592134371,592151970,17599,2866,225
592158891,592156103,592174989,18886,2867,225
592181911,592179122,592196089,16967,2868,225
592203009,592200222,592215265,15043,2869,225
592222185,592219397,592236680,17283,2870,225
592243600,592240813,592258747,17934,2871,225
592265668,592262880,592279845,16965,2872,225
592286766,592283978,592302547,18569,2873,225
592309468,592306680,592324596,17916,2874,225
592331517,592328729,592345357,16628,2875,225
592352278,592349490,592367088,17598,2876,225
592374010,592371221,592387850,16629,2877,225
592394772,592391983,592410236,18253,2878,225
592417063,592414491,592432210,17719,2879,225
592439016,592436445,592452222,15777,2880,225
592459142,592456354,592473952,17598,2881,225
592480871,592478084,592493445,15361,2882,225
592500366,592497577,592514543,16966,2883,225
592521464,592518676,592536592,17916,2884,225
592543515,592540725,592558009,17284,2885,225
592564930,592562142,592579107,16965,2886,225
592586029,592583240,592599869,16629,2887,225
592606790,592604002,592620672,16670,2888,225
592627593,592624805,592640484,15679,2889,225
592647404,592644616,592661243,16627,2890,225
592668164,592665375,592682974,17599,2891,225
592689895,592687107,592703756,16649,2892,225
592710678,592707889,592723568,15679,2893,225
592730488,592727700,592743695,15995,2894,225
592750516,592747945,592765011,17066,2895,225
592771932,592769144,592786109,16965,2896,225
592793030,592790241,592806574,16333,2897,225
592813496,592810707,592827041,16334,2898,225
592833963,592831174,592847822,16648,2899,225
592854743,592851955,592868921,16966,2900,225
592875842,592873054,592890019,16965,2901,225
592896941,592894152,592911119,16967,2902,225
592918040,592915252,592931562,16310,2903,225
592938484,592935695,592951057,15362,2904,225
592957977,592955189,592973442,18253,2905,225
592980364,592977575,592994859,17284,2906,225
593001781,592998992,593015643,16651,2907,225
593022564,593019776,593035138,15362,2908,225
593042059,593039270,593057524,18254,2909,225
593064446,593061657,593076703,15046,2910,225
593083623,593080835,593098749,17914,2911,225
593105669,593102882,593120797,17915,2912,225
593127611,593125040,593140817,15777,2913,225
593147737,593144949,593161915,16966,2914,225
593168836,593166048,593184301,18253,2915,225
593191222,593188434,593205717,17283,2916,225
593212639,593209850,593226816,16966,2917,225
593233738,593230949,593247576,16627,2918,225
593254497,593251709,593268042,16333,2919,225
593274964,593272175,593291061,18886,2920,225
593297982,593295194,593310556,15362,2921,225
593317475,593314688,593332939,18251,2922,225
593339860,593337072,593353065,15993,2923,225
593359985,593357197,593375113,17916,2924,225
593381913,593379342,593397693,18351,2925,225
593404614,593401826,593418475,16649,2926,225
593425395,593422608,593441177,18569,2927,225
593448098,593445310,593462276,16966,2928,225
593469197,593466409,593483374,16965,2929,225
593490295,593487507,593503185,15678,2930,225
593510005,593507433,593524183,16750,2931,225
593531009,593528438,593546791,18353,2932,225
593553604,593551032,593567761,16729,2933,225
593574683,593571894,593588523,16629,2934,225
593595444,593592656,593610571,17915,2935,225
593617492,593614704,593632955,18251,2936,225
593639877,593637088,593652450,15362,2937,225
593659370,593656582,593673210,16628,2938,225
593680131,593677343,593694625,17282,2939,225
593701547,593698758,593716041,17283,2940,225
593722962,593720174,593738428,18254,2941,225
593745350,593742561,593758241,15680,2942,225
593765162,593762373,593778368,15995,2943,225
593785289,593782500,593801387,18887,2944,225
593808188,593805617,593821733,16116,2945,225
593828655,593825866,593843465,17599,2946,225
593850386,593847598,593863931,16333,2947,225
593870853,593868064,593885031,16967,2948,225
593891850,593889277,593905057,15780,2949,225
593911977,593909189,593925837,16648,2950,225
593932758,593929970,593947250,17280,2951,225
593954169,593951382,593967693,16311,2952,225
593974613,593971825,593989424,17599,2953,225
593996346,593993557,594009235,15678,2954,225
594016156,594013367,594030016,16649,2955,225
594036938,594034149,594049827,15678,2956,225
594056747,594053959,594068688,14729,2957,225
594075608,594072820,594089765,16945,2958,225
594096686,594093898,594112467,18569,2959,225
594119389,594116600,594132617,16017,2960,225
594139538,594136749,594153378,16629,2961,225
594160300,594157511,594176082,18571,2962,225
594183004,594180215,594196211,15996,2963,225
594203008,594200436,594217840,17404,2964,225
594224762,594221973,594237019,15046,2965,225
594243941,594241151,594257485,16334,2966,225
594264408,594261618,594278902,17284,2967,225
594285824,594283035,594299052,16017,2968,225
594305974,594303185,594319201,16016,2969,225
594326123,594323334,594340300,16966,2970,225
594347221,594344433,594360745,16312,2971,225
594367668,594364878,594381530,16652,2972,225
594388451,594385663,594403261,17598,2973,225
594410080,594407509,594424256,16747,2974,225
594431176,594428389,594445353,16964,2975,225
594452153,594449582,594467279,17697,2976,225
594474200,594471412,594488377,16965,2977,225
594495298,594492510,594510109,17599,2978,225
594517029,594514242,594530574,16332,2979,225
594537495,594534707,594551673,16966,2980,225
594558594,594555806,594571801,15995,2981,225
594578723,594575933,594592246,16313,2982,225
594599167,594596379,594613344,16965,2983,225
594620265,594617477,594633471,15994,2984,225
594640392,594637603,594654569,16966,2985,225
594661490,594658702,594673747,15045,2986,225
594680667,594677879,594693558,15679,2987,225
594700478,594697690,594714339,16649,2988,225
594721260,594718472,594734149,15677,2989,225
594741071,594738281,594753012,14731,2990,225
594759932,594757144,594774426,17282,2991,225
594781348,594778559,594796475,17916,2992,225
594803396,594800608,594816286,15678,2993,225
594823206,594820418,594837065,16647,2994,225
594843988,594841198,594858165,16967,2995,225
594864965,594862392,594879121,16729,2996,225
594886042,594883254,594901506,18252,2997,225
594908308,594905735,594922780,17045,2998,225
594929701,594926913,594944175,17262,2999,225
594951097,594948308,594967194,18886,3000,225
594974116,594971327,594986373,15046,3001,225
594993294,594990505,595008759,18254,3002,225
595015680,595012892,595031145,18253,3003,225
595038066,595035278,595050955,15677,3004,225
595057874,595055087,595072050,16963,3005,225
595078971,595076183,595091229,15046,3006,225
595098150,595095361,595112643,17282,3007,225
595119564,595116776,595133741,16965,3008,225
595140662,595137874,595156105,18231,3009,225
595163027,595160238,595175917,15679,3010,225
595182838,595180049,595196046,15997,3011,225
595202966,595200178,595217143,16965,3012,225
595224064,595221276,595237925,16649,3013,225
595244846,595242058,595259656,17598,3014,225
595266577,595263789,595280101,16312,3015,225
595286898,595284327,595299788,15461,3016,225
595306709,595303920,595320233,16313,3017,225
595327047,595324475,595345845,21370,3018,225
595352766,595349978,595366289,16311,3019,225
595373211,595370422,595388674,18252,3020,225
595395596,595392807,595410090,17283,3021,225
595416899,595414326,595430422,16096,3022,225
595437343,595434555,595450233,15678,3023,225
595457154,595454366,595471962,17596,3024,225
595478884,595476095,595493695,17600,3025,225
595500616,595497828,595514793,16965,3026,225
595521714,595518926,595537179,18253,3027,225
595544099,595541312,595557961,16649,3028,225
595564883,595562094,595579693,17599,3029,225
595586614,595583826,595600159,16333,3030,225
595607081,595604292,595620941,16649,3031,225
595627862,595625074,595643622,18548,3032,225
595650544,595647755,595664384,16629,3033,225
595671306,595668517,595686433,17916,3034,225
595693354,595690566,595706244,15678,3035,225
595713164,595710376,595727657,17281,3036,225
595734578,595731790,595749705,17915,3037,225
595756627,595753838,595772092,18254,3038,225
595779014,595776225,595793508,17283,3039,225
595800429,595797641,595813636,15995,3040,225
595820556,595817768,595834416,16648,3041,225
595841338,595838549,595853279,14730,3042,225
595860200,595857411,595874378,16967,3043,225
595881300,595878511,595894528,16017,3044,225
595901449,595898661,595914022,15361,3045,225
595920943,595918154,595934149,15995,3046,225
595941069,595938281,595957482,19201,3047,225
595964404,595961615,595978581,16966,3048,225
595985502,595982714,596000945,18231,3049,225
596007867,596005078,596020124,15046,3050,225
596026950,596024379,596041445,17066,3051,225
596048365,596045578,596062837,17259,3052,225
596069758,596066970,596083598,16628,3053,225
596090519,596087731,596106279,18548,3054,225
596113200,596110412,596125458,15046,3055,225
596132379,596129590,596146219,16629,3056,225
596153142,596150352,596167952,17600,3057,225
596174758,596172186,596189569,17383,3058,225
596196490,596193702,596209064,15362,3059,225
596215984,596213196,596229507,16311,3060,225
596236428,596233640,596250605,16965,3061,225
596257526,596254738,596272337,17599,3062,225
596279259,596276470,596293100,16630,3063,225
596300020,596297233,596312911,15678,3064,225
596319833,596317043,596335614,18571,3065,225
596342535,596339747,596355741,15994,3066,225
596362661,596359873,596374601,14728,3067,225
596381522,596378733,596395699,16966,3068,225
596402620,596399832,596417430,17598,3069,225
596424351,596421563,596436923,15360,3070,225
596443843,596441055,596459307,18252,3071,225
596466228,596463440,596480067,16627,3072,225
596486987,596484200,596501798,17598,3073,225
596508719,596505931,596524500,18569,3074,225
596531421,596528633,596546232,17599,3075,225
596553154,596550365,596567646,17281,3076,225
596574457,596571886,596588951,17065,3077,225
596595873,596593084,596610050,16966,3078,225
596616972,596614183,596631781,17598,3079,225
596638595,596636023,596654060,18037,3080,225
596660981,596658193,596676109,17916,3081,225
596683030,596680242,596696236,15994,3082,225
596703156,596700368,596716995,16627,3083,225
596723916,596721128,596737756,16628,3084,225
596744557,596741985,596758417,16432,3085,225
596765339,596762550,596779199,16649,3086,225
596786121,596783332,596800616,17284,3087,225
596807537,596804749,596822981,18232,3088,225
596829903,596827114,596845684,18570,3089,225
596852605,596849817,596866783,16966,3090,225
596873704,596870916,596887543,16627,3091,225
596894464,596891676,596907692,16016,3092,225
596914613,596911825,596929107,17282,3093,225
596936028,596933240,596947969,14729,3094,225
596954891,596952102,596968415,16313,3095,225
596975222,596972650,596988429,15779,3096,225
596995349,596992561,597011447,18886,3097,225
597018369,597015580,597031914,16334,3098,225
597038835,597036047,597054300,18253,3099,225
597061221,597058433,597075061,16628,3100,225
597081888,597079316,597096044,16728,3101,225
597102965,597100177,597117459,17282,3102,225
597124379,597121592,597139843,18251,3103,225
597146765,597143976,597160625,16649,3104,225
597167546,597164758,597181090,16332,3105,225
597188011,597185223,597203139,17916,3106,225
597210060,597207272,597223919,16647,3107,225
597230840,597228052,597244700,16648,3108,225
597251623,597248833,597264514,15681,3109,225
597271434,597268646,597283690,15044,3110,225
597290489,597287918,597305616,17698,3111,225
597312538,597309749,597328320,18571,3112,225
597335242,597332453,597350053,17600,3113,225
597356975,597354186,597370181,15995,3114,225
597377103,597374313,597390963,16650,3115,225
597397884,597395096,597411745,16649,3116,225
597418667,597415878,597432844,16966,3117,225
597439767,597436977,597454894,17917,3118,225
597461815,597459027,597475992,16965,3119,225
597482914,597480125,597496437,16312,3120,225
597503358,597500570,597517853,17283,3121,225
597524774,597521986,597537348,15362,3122,225
597544268,597541480,597558130,16650,3123,225
597565052,597562263,597578912,16649,3124,225
597585713,597583142,597601177,18035,3125,225
597608099,597605310,597622277,16967,3126,225
597629198,597626410,597644664,18254,3127,225
597651586,597648797,597666081,17284,3128,225
597672897,597670326,597686419,16093,3129,225
597693341,597690553,597707201,16648,3130,225
597714124,597711334,597728935,17601,3131,225
597735736,597733165,597748310,15145,3132,225
597755230,597752442,597768774,16332,3133,225
597775696,597772907,597790190,17283,3134,225
597797112,597794323,597810656,16333,3135,225
597817577,597814789,597831438,16649,3136,225
597838359,597835571,597853823,18252,3137,225
597860625,597858054,597873514,15460,3138,225
597880434,597877646,597894928,17282,3139,225
597901849,597899061,597915056,15995,3140,225
597921976,597919188,597936132,16944,3141,225
597943054,597940265,597957865,17600,3142,225
597964787,597961998,597977361,15363,3143,225
597984282,597981494,597997509,16015,3144,225
598004431,598001642,598020528,18886,3145,225
598027448,598024661,598041624,16963,3146,225
598048544,598045756,598063355,17599,3147,225
598070276,598067488,598085087,17599,3148,225
598092008,598089220,598108104,18884,3149,225
598115024,598112237,598129518,17281,3150,225
598136440,598133651,598148380,14729,3151,225
598155301,598152512,598169162,16650,3152,225
598176085,598173295,598191867,18572,3153,225
598198788,598196000,598214252,18252,3154,225
598221174,598218385,598237272,18887,3155,225
598244089,598241517,598257612,16095,3156,225
598264534,598261745,598278712,16967,3157,225
598285634,598282845,598299790,16945,3158,225
598306711,598303923,598319917,15994,3159,225
598326838,598324050,598341015,16965,3160,225
598347821,598345250,598361049,15799,3161,225
598367970,598365182,598389597,24415,3162,225
598396420,598393848,598410598,16750,3163,225
598417519,598414731,598431063,16332,3164,225
598437984,598435196,598452795,17599,3165,225
598459620,598457048,598475401,18353,3166,225
598482322,598479534,598496500,16966,3167,225
598503308,598500737,598516852,16115,3168,225
598523773,598520985,598539871,18886,3169,225
598546792,598544004,598559366,15362,3170,225
598566286,598563498,598581096,17598,3171,225
598587906,598585335,598600478,15143,3172,225
598607397,598604610,598621573,16963,3173,225
598628494,598625706,598643305,17599,3174,225
598650227,598647438,598664404,16966,3175,225
598671325,598668537,598683898,15361,3176,225
598690820,598688031,598705945,17914,3177,225
598712867,598710078,598726073,15995,3178,225
598732994,598730206,598747488,17282,3179,225
598754411,598751621,598768272,16651,3180,225
598775194,598772405,598789372,16967,3181,225
598796293,598793505,598810448,16943,3182,225
598817369,598814581,598833150,18569,3183,225
598840071,598837283,598856485,19202,3184,225
598863407,598860618,598878872,18254,3185,225
598885793,598883005,598900625,17620,3186,225
598907546,598904758,598920119,15361,3187,225
598927040,598924251,598941218,16967,3188,225
598948139,598945351,598962295,16944,3189,225
598969216,598966428,598982106,15678,3190,225
598989027,598986239,599001284,15045,3191,225
599008204,599005416,599021726,16310,3192,225
599028647,599025859,599044090,18231,3193,225
599051011,599048223,599067110,18887,3194,225
599074031,599071243,599090130,18887,3195,225
599097051,599094263,599112495,18232,3196,225
599119416,599116628,599132307,15679,3197,225
599139111,599136539,599153605,17066,3198,225
599160527,599157738,599172784,15046,3199,225
599179704,599176916,599194515,17599,3200,225
599201436,599198648,599215931,17283,3201,225
599222754,599220182,599238198,18016,3202,225
599245120,599242331,599260902,18571,3203,225
599267823,599265035,599282317,17282,3204,225
599289238,599286450,599304048,17598,3205,225
599310970,599308181,599326414,18233,3206,225
599333335,599330547,599347196,16649,3207,225
599354118,599351329,599367642,16313,3208,225
599374563,599371775,599388402,16627,3209,225
599395324,599392535,599409501,16966,3210,225
599416423,599413634,599429945,16311,3211,225
599436868,599434078,599451044,16966,3212,225
599457965,599455177,599471825,16648,3213,225
599478746,599475958,599495161,19203,3214,225
599502083,599499294,599516893,17599,3215,225
599523814,599521026,599539913,18887,3216,225
599546834,599544046,599561010,16964,3217,225
599567931,599565143,599582424,17281,3218,225
599589346,599586557,599603207,16650,3219,225
599610128,599607340,599626226,18886,3220,225
599633147,599630359,599647641,17282,3221,225
599654562,599651774,599669056,17282,3222,225
599675977,599673189,599689500,16311,3223,225
599696421,599693633,599708360,14727,3224,225
599715280,599712492,599727853,15361,3225,225
599734775,599731985,599747348,15363,3226,225
599754269,599751480,599766842,15362,3227,225
599773762,599770974,599788890,17916,3228,225
599795811,599793023,599810622,17599,3229,225
599817543,599814755,599832690,17935,3230,225
599839611,599836823,599856024,19201,3231,225
599862946,599860157,599875520,15363,3232,225
599882440,599879652,599898538,18886,3233,225
599905459,599902671,599919636,16965,3234,225
599926557,599923769,599941052,17283,3235,225
599947973,599945185,599962151,16966,3236,225
599968967,599966395,599982827,16432,3237,225
599989749,599986960,600002322,15362,3238,225
600009134,600006562,600023312,16750,3239,225
600030233,600027445,600043440,15995,3240,225
600050361,600047572,600065488,17916,3241,225
600072409,600069621,600088170,18549,3242,225
600095091,600092303,600108296,15993,3243,225
600115216,600112428,600130362,17934,3244,225
600137283,600134495,600150805,16310,3245,225
600157726,600154938,600172854,17916,3246,225
600179775,600176987,600194901,17914,3247,225
600201823,600199034,600215683,16649,3248,225
600222604,600219816,600236466,16650,3249,225
600243388,600240599,600255644,15045,3250,225
600262458,600259886,600276002,16116,3251,225
600282923,600280135,600296782,16647,3252,225
600303602,600301030,600317758,16728,3253,225
600324680,600321891,600340124,18233,3254,225
600347045,600344257,600360567,16310,3255,225
600367489,600364700,600381667,16967,3256,225
600388589,600385800,600402767,16967,3257,225
600409687,600406900,600424813,17913,3258,225
600431735,600428946,600445892,16946,3259,225
600452701,600450129,600467512,17383,3260,225
600474435,600471645,600487325,15680,3261,225
600494134,600491562,600507023,15461,3262,225
600513826,600511255,600528954,17699,3263,225
600535875,600533087,600551656,18569,3264,225
600558577,600555789,600571467,15678,3265,225
600578387,600575599,600592248,16649,3266,225
600599169,600596381,600613978,17597,3267,225
600620899,600618111,600636365,18254,3268,225
600643286,600640498,600656176,15678,3269,225
600663096,600660308,600677252,16944,3270,225
600684174,600681385,600698351,16966,3271,225
600705272,600702484,600721370,18886,3272,225
600728292,600725503,600744072,18569,3273,225
600750995,600748205,600764519,16314,3274,225
600771440,600768652,600786588,17936,3275,225
600793511,600790721,600807689,16968,3276,225
600814610,600811822,600829104,17282,3277,225
600836026,600833237,600850204,16967,3278,225
600857126,600854337,600870649,16312,3279,225
600877570,600874782,600891432,16650,3280,225
600898354,600895565,600911878,16313,3281,225
600918676,600916104,600931250,15146,3282,225
600938171,600935382,600950745,15363,3283,225
600957666,600954877,600971842,16965,3284,225
600978764,600975975,600996196,20221,3285,225
601003119,601000330,601018899,18569,3286,225
601025820,601023032,601041600,18568,3287,225
601048521,601045733,601062699,16966,3288,225
601069504,601066932,601084335,17403,3289,225
601091256,601088468,601107038,18570,3290,225
601113959,601111171,601130056,18885,3291,225
601136977,601134189,601152104,17915,3292,225
601159026,601156237,601170966,14729,3293,225
601177887,601175099,601191748,16649,3294,225
601198670,601195881,601214769,18888,3295,225
601221584,601219012,601235107,16095,3296,225
601242028,601239240,601256523,17283,3297,225
601263444,601260656,601278277,17621,3298,225
601285199,601282410,601300643,18233,3299,225
601307447,601304874,601321603,16729,3300,225
601328524,601325736,601340780,15044,3301,225
601347702,601344913,601360909,15996,3302,225
601367829,601365041,601380086,15045,3303,225
601387006,601384218,601402132,17914,3304,225
601408942,601406370,601424721,18351,3305,225
601431537,601428965,601444111,15146,3306,225
601451032,601448244,601465527,17283,3307,225
601472449,601469660,601485993,16333,3308,225
601492914,601490126,601506459,16333,3309,225
601513381,601510592,601526926,16334,3310,225
601533847,601531059,601545788,14729,3311,225
601552710,601549920,601572121,22201,3312,225
601579043,601576255,601602105,25850,3313,225
601609027,601606239,601624492,18253,3314,225
601631414,601628625,601645254,16629,3315,225
601652175,601649387,601664748,15361,3316,225
601671668,601668880,601686141,17261,3317,225
601693062,601690274,601707554,17280,3318,225
601714476,601711687,601728020,16333,3319,225
601734821,601732249,601750285,18036,3320,225
601757207,601754418,601770730,16312,3321,225
601777651,601774863,601790224,15361,3322,225
601797145,601794356,601811638,17282,3323,225
601818559,601815771,601834658,18887,3324,225
601841580,601838791,601854153,15362,3325,225
601861073,601858285,601874934,16649,3326,225
601881856,601879067,601895696,16629,3327,225
601902616,601899829,601916794,16965,3328,225
601923715,601920927,601937239,16312,3329,225
601944160,601941372,601956099,14727,3330,225
601963019,601960231,601976226,15995,3331,225
601983147,601980359,601997642,17283,3332,225
602004454,602001882,602017027,15145,3333,225
602023949,602021160,602039097,17937,3334,225
602046019,602043230,602061146,17916,3335,225
602068068,602065279,602081592,16313,3336,225
602088513,602085725,602103006,17281,3337,225
602109928,602107139,602126343,19204,3338,225
602133266,602130476,602145206,14730,3339,225
602152127,602149338,602166305,16967,3340,225
602173115,602170543,602186321,15778,3341,225
602193240,602190453,602205498,15045,3342,225
602212418,602209630,602225625,15995,3343,225
602232438,602229866,602246614,16748,3344,225
602253535,602250747,602266426,15679,3345,225
602273346,602270558,602288472,17914,3346,225
602295394,602292605,602310224,17619,3347,225
602317145,602314357,602329402,15045,3348,225
602336323,602333534,602351451,17917,3349,225
602358263,602355692,602373389,17697,3350,225
602380310,602377522,602394784,17262,3351,225
602401705,602398917,602417804,18887,3352,225
602424725,602421937,602439218,17281,3353,225
602446139,602443351,602460000,16649,3354,225
602466921,602464133,602479179,15046,3355,225
602486099,602483311,602500256,16945,3356,225
602507177,602504389,602520721,16332,3357,225
602527643,602524854,602542770,17916,3358,225
602549591,602547020,602565690,18670,3359,225
602572613,602569824,602588056,18232,3360,225
602594978,602592189,602610759,18570,3361,225
602617680,602614892,602633462,18570,3362,225
602640383,602637595,602655511,17916,3363,225
602662432,602659644,602675639,15995,3364,225
602682560,602679771,602696738,16967,3365,225
602703659,602700871,602719757,18886,3366,225
602726679,602723890,602740223,16333,3367,225
602747145,602744356,602760036,15680,3368,225
602766852,602764280,602783265,18985,3369,225
602790188,602787399,602803731,16332,3370,225
602810539,602807968,602824399,16431,3371,225
602831207,602828635,602846017,17382,3372,225
602852940,602850151,602865830,15679,3373,225
602872752,602869963,602885979,16016,3374,225
602892901,602890112,602907079,16967,3375,225
602914001,602911212,602927862,16650,3376,225
602934784,602931995,602949912,17917,3377,225
602956833,602954045,602971642,17597,3378,225
602978564,602975775,602992740,16965,3379,225
602999662,602996873,603014492,17619,3380,225
603021413,603018625,603035253,16628,3381,225
603042175,603039386,603055382,15996,3382,225
603062187,603059616,603075732,16116,3383,225
603082654,603079865,603097465,17600,3384,225
603104287,603101715,603120069,18354,3385,225
603126883,603124311,603141040,16729,3386,225
603147962,603145173,603162138,16965,3387,225
603169059,603166271,603181633,15362,3388,225
603188554,603185765,603203703,17938,3389,225
603210624,603207836,603224801,16965,3390,225
603231722,603228934,603244613,15679,3391,225
603251534,603248745,603265057,16312,3392,225
603271873,603269302,603287971,18669,3393,225
603294893,603292104,603307466,15362,3394,225
603314385,603311598,603326959,15361,3395,225
603333879,603331091,603349660,18569,3396,225
603356581,603353793,603369472,15679,3397,225
603376392,603373604,603390253,16649,3398,225
603397174,603394386,603410402,16016,3399,225
603417324,603414535,603430552,16017,3400,225
603437473,603434685,603451335,16650,3401,225
603458143,603455571,603472319,16748,3402,225
603479242,603476452,603493419,16967,3403,225
603500342,603497552,603513886,16334,3404,225
603520807,603518019,603535300,17281,3405,225
603542115,603539543,603555976,16433,3406,225
603562898,603560109,603577075,16966,3407,225
603583996,603581208,603598174,16966,3408,225
603605096,603602307,603618640,16333,3409,225
603625562,603622773,603641027,18254,3410,225
603647949,603645160,603662127,16967,3411,225
603669048,603666260,603682592,16332,3412,225
603689512,603686725,603702719,15994,3413,225
603709640,603706851,603723502,16651,3414,225
603730424,603727635,603745889,18254,3415,225
603752688,603750117,603765893,15776,3416,225
603772716,603770145,603788159,18014,3417,225
603795080,603792292,603809575,17283,3418,225
603816496,603813708,603830990,17282,3419,225
603837911,603835123,603852405,17282,3420,225
603859326,603856538,603872552,16014,3421,225
603879474,603876685,603891414,14729,3422,225
603898333,603895546,603912510,16964,3423,225
603919432,603916643,603931373,14730,3424,225
603938188,603935616,603951712,16096,3425,225
603958633,603955845,603973760,17915,3426,225
603980682,603977893,603993255,15362,3427,225
604000177,603997388,604016274,18886,3428,225
604023094,604020522,604035351,14829,3429,225
604042271,604039483,604057736,18253,3430,225
604064657,604061869,604079151,17282,3431,225
604086072,604083284,604098033,14749,3432,225
604104953,604102165,604121367,19202,3433,225
604128290,604125500,604144071,18571,3434,225
604150992,604148204,604165802,17598,3435,225
604172723,604169935,604185612,15677,3436,225
604192532,604189744,604205739,15995,3437,225
604212660,604209872,604226540,16668,3438,225
604233461,604230673,604247956,17283,3439,225
604254877,604252089,604270342,18253,3440,225
604277264,604274475,604291758,17283,3441,225
604298680,604295891,604312836,16945,3442,225
604319757,604316969,604332964,15995,3443,225
604339884,604337096,604353407,16311,3444,225
604360329,604357540,604375455,17915,3445,225
604382377,604379588,604398474,18886,3446,225
604405396,604402607,604419573,16966,3447,225
604426493,604423706,604440650,16944,3448,225
604447572,604444783,604461750,16967,3449,225
604468672,604465883,604483502,17619,3450,225
604490424,604487635,604503969,16334,3451,225
604510890,604508102,604524751,16649,3452,225
604531672,604528884,604545196,16312,3453,225
604552019,604549447,604567168,17721,3454,225
604574089,604571301,604588583,17282,3455,225
604595504,604592716,604609682,16966,3456,225
604616603,604613815,604629810,15995,3457,225
604636731,604633942,604649622,15680,3458,225
604656542,604653754,604670720,16966,3459,225
604677641,604674853,604692134,17281,3460,225
604698948,604696376,604712472,16096,3461,225
604719393,604716605,604734203,17598,3462,225
604741125,604738336,604756252,17916,3463,225
604763174,604760385,604777985,17600,3464,225
604784906,604782118,604800687,18569,3465,225
604807607,604804820,604821468,16648,3466,225
604828280,604825708,604843744,18036,3467,225
604850665,604847877,604866763,18886,3468,225
604873686,604870896,604887864,16968,3469,225
604894785,604891997,604909595,17598,3470,225
604916517,604913728,604931012,17284,3471,225
604937932,604935145,604952425,17280,3472,225
604959238,604956666,604973100,16434,3473,225
604980021,604977233,604995484,18251,3474,225
605002405,604999617,605018185,18568,3475,225
605025106,605022318,605038313,15995,3476,225
605045235,605042446,605060046,17600,3477,225
605066967,605064179,605083065,18886,3478,225
605089986,605087198,605103552,16354,3479,225
605110473,605107685,605124651,16966,3480,225
605131572,605128784,605145749,16965,3481,225
605152670,605149882,605166551,16669,3482,225
605173357,605170785,605187850,17065,3483,225
605194772,605191983,605208970,16987,3484,225
605215891,605213103,605229730,16627,3485,225
605236652,605233863,605248930,15067,3486,225
605255852,605253063,605269376,16313,3487,225
605276296,605273509,605292395,18886,3488,225
605299318,605296528,605311574,15046,3489,225
605318495,605315707,605331384,15677,3490,225
605338305,605335517,605350878,15361,3491,225
605357800,605355011,605372632,17621,3492,225
605379433,605376862,605393925,17063,3493,225
605400846,605398058,605413420,15362,3494,225
605420342,605417553,605434517,16964,3495,225
605441438,605438650,605455298,16648,3496,225
605462220,605459432,605476714,17282,3497,225
605483635,605480847,605499415,18568,3498,225
605506237,605503665,605518811,15146,3499,225
605525732,605522944,605539592,16648,3500,225
605546513,605543725,605559425,15700,3501,225
605566346,605563557,605580840,17283,3502,225
605587761,605584973,605602256,17283,3503,225
605609177,605606389,605624643,18254,3504,225
605631565,605628776,605644772,15996,3505,225
605651574,605649002,605666067,17065,3506,225
605672889,605670318,605687699,17381,3507,225
605694505,605691933,605708682,16749,3508,225
605715604,605712815,605729486,16671,3509,225
605736406,605733619,605751217,17598,3510,225
605758019,605755446,605772852,17406,3511,225
605779773,605776985,605792051,15066,3512,225
605798850,605796278,605813345,17067,3513,225
605820266,605817478,605835415,17937,3514,225
605842337,605839548,605856515,16967,3515,225
605863437,605860648,605875695,15047,3516,225
605882616,605879828,605898714,18886,3517,225
605905637,605902848,605920447,17599,3518,225
605927368,605924580,605941524,16944,3519,225
605948446,605945657,605962623,16966,3520,225
605969545,605966756,605983068,16312,3521,225
605989989,605987201,606004166,16965,3522,225
606011088,606008299,606026215,17916,3523,225
606033136,606030348,606045710,15362,3524,225
606052631,606049843,606065205,15362,3525,225
606072125,606069337,606085648,16311,3526,225
606092569,606089781,606106746,16965,3527,225
606113667,606110879,606126557,15678,3528,225
606133478,606130689,606147655,16966,3529,225
606154576,606151788,606170020,18232,3530,225
606176942,606174153,606190803,16650,3531,225
606197725,606194936,606212220,17284,3532,225
606219141,606216353,606234268,17915,3533,225
606241189,606238401,606253763,15362,3534,225
606260683,606257895,606274545,16650,3535,225
606281467,606278678,606296595,17917,3536,225
606303517,606300728,606317695,16967,3537,225
606324617,606321828,606339745,17917,3538,225
606346666,606343878,606360528,16650,3539,225
606367449,606364661,606382260,17599,3540,225
606389183,606386393,606403045,16652,3541,225
606409967,606407178,606426065,18887,3542,225
606432986,606430198,606447818,17620,3543,225
606454740,606451951,606468602,16651,3544,225
606475523,606472735,606490967,18232,3545,225
606497888,606495100,606512065,16965,3546,225
606518987,606516198,606533163,16965,3547,225
606540084,606537296,606554261,16965,3548,225
606561059,606558488,606574266,15778,3549,225
606581186,606578398,606595680,17282,3550,225
606602601,606599813,606616146,16333,3551,225
606622948,606620376,606638729,18353,3552,225
606645650,606642862,606659194,16332,3553,225
606666115,606663327,606680609,17282,3554,225
606687531,606684742,606702026,17284,3555,225
606708947,606706159,606722512,16353,3556,225
606729433,606726645,606743611,16966,3557,225
606750533,606747744,606765344,17600,3558,225
606772265,606769477,606787097,17620,3559,225
606793905,606791334,606806795,15461,3560,225
606813717,606810927,606826291,15364,3561,225
606833210,606830423,606848337,17914,3562,225
606855258,606852470,606868781,16311,3563,225
606875702,606872914,606890195,17281,3564,225
606897115,606894328,606911609,17281,3565,225
606918531,606915742,606932055,16313,3566,225
606938977,606936188,606953788,17600,3567,225
606960607,606958035,606974445,16410,3568,225
606981243,606978672,606996054,17382,3569,225
607002975,607000187,607017153,16966,3570,225
607023955,607021383,607036528,15145,3571,225
607043450,607040661,607055390,14729,3572,225
607062310,607059522,607076488,16966,3573,225
607083409,607080621,607096953,16332,3574,225
607103874,607101086,607117417,16331,3575,225
607124338,607121550,607138198,16648,3576,225
607145119,607142331,607158346,16015,3577,225
607165267,607162479,607179445,16966,3578,225
607186365,607183578,607202779,19201,3579,225
607209700,607206912,607223878,16966,3580,225
607230799,607228011,607244977,16966,3581,225
607251899,607249110,607263861,14751,3582,225
607270781,607267994,607284641,16647,3583,225
607291562,607288774,607305086,16312,3584,225
607311902,607309330,607326734,17404,3585,225
607333554,607330983,607348047,17064,3586,225
607354968,607352180,607368829,16649,3587,225
607375751,607372962,607391195,18233,3588,225
607398117,607395328,607411978,16650,3589,225
607418900,607416111,607432127,16016,3590,225
607439049,607436260,607453544,17284,3591,225
607460466,607457677,607474643,16966,3592,225
607481564,607478776,607496375,17599,3593,225
607503181,607500609,607517338,16729,3594,225
607524261,607521472,607538439,16967,3595,225
607545361,607542572,607558885,16313,3596,225
607565806,607563018,607577747,14729,3597,225
607584667,607581879,607597874,15995,3598,225
607604796,607602007,607618636,16629,3599,225
607625559,607622769,607639736,16967,3600,225
607646656,607643869,607661151,17282,3601,225
607668074,607665285,607682569,17284,3602,225
607689490,607686702,607704934,18232,3603,225
607711856,607709067,607726666,17599,3604,225
607733587,607730799,607748081,17282,3605,225
607755003,607752214,607766965,14751,3606,225
607773778,607771206,607787301,16095,3607,225
607794124,607791553,607807986,16433,3608,225
607814909,607812120,607831325,19205,3609,225
607838247,607835458,607853374,17916,3610,225
607860295,607857507,607874790,17283,3611,225
607881607,607879035,607897071,18036,3612,225
607903993,607901204,607917221,16017,3613,225
607924143,607921354,607938004,16650,3614,225
607944832,607942260,607958714,16454,3615,225
607965637,607962848,607978211,15363,3616,225
607985132,607982344,607999942,17598,3617,225
608006864,608004076,608020429,16353,3618,225
608027231,608024659,608040438,15779,3619,225
608047358,608044570,608060902,16332,3620,225
608067824,608065035,608081981,16946,3621,225
608088804,608086231,608104586,18355,3622,225
608111507,608108719,608125684,16965,3623,225
608132606,608129817,608148072,18255,3624,225
608154994,608152205,608168537,16332,3625,225
608175458,608172670,608188663,15993,3626,225
608195583,608192795,608210077,17282,3627,225
608216998,608214209,608230205,15996,3628,225
608237126,608234337,608253224,18887,3629,225
608260145,608257357,608272719,15362,3630,225
608279640,608276851,608293817,16966,3631,225
608300738,608297950,608314915,16965,3632,225
608321837,608319048,608335361,16313,3633,225
608342281,608339494,608354855,15361,3634,225
608361775,608358987,608376268,17281,3635,225
608383189,608380401,608398970,18569,3636,225
608405891,608403103,608419413,16310,3637,225
608426334,608423546,608441799,18253,3638,225
608448721,608445932,608462899,16967,3639,225
608469821,608467032,608483660,16628,3640,225
608490582,608487793,608506680,18887,3641,225
608513491,608510920,608528322,17402,3642,225
608535243,608532455,608549420,16965,3643,225
608556342,608553553,608569550,15997,3644,225
608576470,608573682,608590330,16648,3645,225
608597251,608594463,608613031,18568,3646,225
608619951,608617164,608634446,17282,3647,225
608641367,608638579,608655860,17281,3648,225
608662781,608659993,608677276,17283,3649,225
608684197,608681409,608698375,16966,3650,225
608705297,608702508,608718840,16332,3651,225
608725762,608722973,608739602,16629,3652,225
608746524,608743735,608760702,16967,3653,225
608767624,608764835,608781486,16651,3654,225
608788290,608785717,608802468,16751,3655,225
608809389,608806601,608821963,15362,3656,225
608828884,608826095,608843378,17283,3657,225
608850299,608847511,608863188,15677,3658,225
608870109,608867320,608884919,17599,3659,225
608891743,608889171,608905603,16432,3660,225
608912524,608909736,608927018,17282,3661,225
608933940,608931151,608948751,17600,3662,225
608955672,608952884,608968879,15995,3663,225
608975799,608973011,608991263,18252,3664,225
608998185,608995396,609012067,16671,3665,225
609018890,609016318,609033699,17381,3666,225
609040620,609037832,609054460,16628,3667,225
609061380,609058593,609075873,17280,3668,225
609082795,609080006,609097290,17284,3669,225
609104212,609101423,609119023,17600,3670,225
609125830,609123259,609139691,16432,3671,225
609146611,609143824,609159502,15678,3672,225
609166423,609163635,609179334,15699,3673,225
609186255,609183466,609199461,15995,3674,225
609206382,609203594,609219589,15995,3675,225
609226510,609223721,609240688,16967,3676,225
609247609,609244821,609260181,15360,3677,225
609267101,609264313,609280940,16627,3678,225
609287862,609285073,609300752,15679,3679,225
609307673,609304884,609320246,15362,3680,225
609327167,609324378,609342631,18253,3681,225
609349552,609346764,609365334,18570,3682,225
609372255,609369467,609388037,18570,3683,225
609394958,609392170,609411054,18884,3684,225
609417975,609415187,609432131,16944,3685,225
609439051,609436264,609454199,17935,3686,225
609461120,609458332,609474010,15678,3687,225
609480931,609478143,609497345,19202,3688,225
609504266,609501478,609519076,17598,3689,225
609525997,609523209,609540489,17280,3690,225
609547412,609544622,609563193,18571,3691,225
609570115,609567326,609583977,16651,3692,225
609590898,609588110,609604736,16626,3693,225
609611657,609608868,609627756,18888,3694,225
609634678,609631889,609647906,16017,3695,225
609654828,609652039,609666768,14729,3696,225
609673688,609670900,609688182,17282,3697,225
609695102,609692315,609710545,18230,3698,225
609717467,609714678,609730061,15383,3699,225
609736982,609734193,609749555,15362,3700,225
609756475,609753687,609770314,16627,3701,225
609777236,609774447,609790779,16332,3702,225
609797701,609794912,609812512,17600,3703,225
609819434,609816645,609833611,16966,3704,225
609840533,609837744,609854710,16966,3705,225
609861631,609858843,609875809,16966,3706,225
609882730,609879942,609898512,18570,3707,225
609905433,609902645,609920265,17620,3708,225
609927082,609924510,609939340,14830,3709,225
609946260,609943472,609960754,17282,3710,225
609967675,609964887,609979933,15046,3711,225
609986854,609984065,610002635,18570,3712,225
610009556,610006768,610023417,16649,3713,225
610030339,610027550,610045466,17916,3714,225
610052280,610049707,610067429,17722,3715,225
610074350,610071562,610089160,17598,3716,225
610096083,610093294,610109943,16649,3717,225
610116865,610114076,610129755,15679,3718,225
610136676,610133888,610152457,18569,3719,225
610159378,610156590,610173872,17282,3720,225
610180794,610178005,610194972,16967,3721,225
610201893,610199105,610216387,17282,3722,225
610223308,610220520,610237168,16648,3723,225
610244090,610241301,610257635,16334,3724,225
610264556,610261768,610279704,17936,3725,225
610286625,610283837,610300486,16649,3726,225
610307407,610304619,610321584,16965,3727,225
610328505,610325717,610341100,15383,3728,225
610347919,610345347,610364016,18669,3729,225
610370937,610368149,610386718,18569,3730,225
610393639,610390851,610409418,18567,3731,225
610416340,610413551,610432121,18570,3732,225
610439042,610436254,610453853,17599,3733,225
610460774,610457986,610476239,18253,3734,225
610483161,610480372,610497653,17281,3735,225
610504574,610501786,610517147,15361,3736,225
610524068,610521280,610538878,17598,3737,225
610545800,610543011,610561265,18254,3738,225
610568067,610565495,610580956,15461,3739,225
610587875,610585088,610603023,17935,3740,225
610609839,610607267,610624967,17700,3741,225
610631889,610629100,610645433,16333,3742,225
610652355,610649566,610666215,16649,3743,225
610673137,610670348,610687948,17600,3744,225
610694870,610692082,610707761,15679,3745,225
610714582,610712010,610730025,18015,3746,225
610736947,610734158,610750471,16313,3747,225
610757274,610754702,610772085,17383,3748,225
610778903,610776331,610792110,15779,3749,225
610799031,610796242,610814497,18255,3750,225
610821419,610818630,610833993,15363,3751,225
610840822,610838251,610854999,16748,3752,225
610861921,610859132,610876732,17600,3753,225
610883554,610880982,610896444,15462,3754,225
610903365,610900576,610919146,18570,3755,225
610926067,610923279,610940899,17620,3756,225
610947821,610945032,610961344,16312,3757,225
610968265,610965477,610984045,18568,3758,225
610990966,610988178,611005144,16966,3759,225
611012065,611009277,611025272,15995,3760,225
611032093,611029521,611046904,17383,3761,225
611053826,611051037,611068636,17599,3762,225
611075558,611072769,611091339,18570,3763,225
611098260,611095472,611112754,17282,3764,225
611119577,611117005,611132487,15482,3765,225
611139408,611136619,611151665,15046,3766,225
611158587,611155798,611172132,16334,3767,225
611179053,611176265,611194835,18570,3768,225
611201758,611198968,611215936,16968,3769,225
611222857,611220069,611238004,17935,3770,225
611244828,611242258,611259638,17380,3771,225
611266559,611263771,611279448,15677,3772,225
611286369,611283581,611299598,16017,3773,225
611306520,611303731,611320697,16966,3774,225
611327618,611324830,611343716,18886,3775,225
611350638,611347849,611364815,16966,3776,225
611371737,611368948,611386865,17917,3777,225
611393786,611390998,611407308,16310,3778,225
611414107,611411536,611426363,14827,3779,225
611433284,611430495,611448433,17938,3780,225
611455354,611452566,611469848,17282,3781,225
611476770,611473981,611490314,16333,3782,225
611497235,611494447,611512698,18251,3783,225
611519619,611516831,611531897,15066,3784,225
611538820,611536030,611551077,15047,3785,225
611557998,611555209,611578991,23782,3786,225
611585913,611583124,611602159,19035,3787,225
611608963,611606391,611622822,16431,3788,225
611629745,611626956,611643921,16965,3789,225
611650841,611648054,611665019,16965,3790,225
611671941,611669152,611686434,17282,3791,225
611693356,611690567,611707850,17283,3792,225
611714772,611711983,611730870,18887,3793,225
611737791,611735003,611752939,17936,3794,225
611759860,611757072,611773089,16017,3795,225
611780010,611777222,611793872,16650,3796,225
611800793,611798005,611814971,16966,3797,225
611821892,611819104,611837357,18253,3798,225
611844279,611841491,611857484,15993,3799,225
611864403,611861616,611878262,16646,3800,225
611885183,611882395,611899043,16648,3801,225
611905869,611903297,611920362,17065,3802,225
611927283,611924495,611942430,17935,3803,225
611949351,611946563,611964500,17937,3804,225
611971421,611968633,611984310,15677,3805,225
611991231,611988442,612006042,17600,3806,225
612012964,612010175,612026803,16628,3807,225
612033724,612030936,612048873,17937,3808,225
612055795,612053006,612068686,15680,3809,225
612075608,612072819,612089786,16967,3810,225
612096598,612094026,612111092,17066,3811,225
612117913,612115341,612131437,16096,3812,225
612138257,612135685,612152118,16433,3813,225
612159040,612156251,612173556,17305,3814,225
612180478,612177689,612194317,16628,3815,225
612201131,612198559,612214358,15799,3816,225
612221279,612218491,612234169,15678,3817,225
612241090,612238302,612254614,16312,3818,225
612261535,612258747,612275396,16649,3819,225
612282318,612279529,612297128,17599,3820,225
612304051,612301262,612317258,15996,3821,225
612324178,612321390,612339305,17915,3822,225
612346228,612343439,612359751,16312,3823,225
612366672,612363884,612381188,17304,3824,225
612388109,612385321,612400998,15677,3825,225
612407920,612405131,612420811,15680,3826,225
612427731,612424943,612440620,15677,3827,225
612447541,612444752,612463638,18886,3828,225
612470560,612467772,612483788,16016,3829,225
612490602,612488030,612503809,15779,3830,225
612510730,612507942,612523324,15382,3831,225
612530245,612527456,612545372,17916,3832,225
612552293,612549505,612566152,16647,3833,225
612573073,612570285,612586912,16627,3834,225
612593834,612591045,612609300,18255,3835,225
612616122,612613551,612629667,16116,3836,225
612636486,612633914,612651613,17699,3837,225
612658535,612655746,612673684,17938,3838,225
612680605,612677817,612695732,17915,3839,225
612702655,612699866,612715229,15363,3840,225
612722151,612719362,612736012,16650,3841,225
612742934,612740145,612757111,16966,3842,225
612764033,612761244,612778211,16967,3843,225
612785032,612782460,612797923,15463,3844,225
612804843,612802055,612821258,19203,3845,225
612828181,612825391,612841386,15995,3846,225
612848307,612845519,612863118,17599,3847,225
612870039,612867251,612885483,18232,3848,225
612892405,612889616,612906267,16651,3849,225
612913188,612910400,612927365,16965,3850,225
612934185,612931614,612948047,16433,3851,225
612954968,612952180,612967542,15362,3852,225
612974463,612971674,612989610,17936,3853,225
612996531,612993743,613011994,18251,3854,225
613018916,613016127,613033410,17283,3855,225
613040215,613037644,613054372,16728,3856,225
613061294,613058505,613074818,16313,3857,225
613081740,613078951,613095263,16312,3858,225
613102185,613099396,613116994,17598,3859,225
613123917,613121127,613138094,16967,3860,225
613145015,613142227,613159509,17282,3861,225
613166326,613163752,613181453,17701,3862,225
613188374,613185586,613201896,16310,3863,225
613208819,613206029,613222680,16651,3864,225
613229601,613226813,613243441,16628,3865,225
613250362,613247574,613263251,15677,3866,225
613270172,613267384,613285299,17915,3867,225
613292220,613289432,613306398,16966,3868,225
613313218,613310647,613326424,15777,3869,225
613333345,613330557,613349444,18887,3870,225
613356366,613353578,613371199,17621,3871,225
613378026,613375455,613392181,16726,3872,225
613399103,613396315,613412964,16649,3873,225
613419886,613417097,613434380,17283,3874,225
613441302,613438513,613455162,16649,3875,225
613462083,613459295,613476894,17599,3876,225
613483815,613481027,613497360,16333,3877,225
613504282,613501493,613518460,16967,3878,225
613525381,613522593,613538271,15678,3879,225
613545192,613542404,613560634,18230,3880,225
613567556,613564767,613583022,18255,3881,225
613589945,613587156,613603469,16313,3882,225
613610391,613607602,613622965,15363,3883,225
613629885,613627097,613644379,17282,3884,225
613651184,613648611,613665383,16772,3885,225
613672194,613669622,613684451,14829,3886,225
613691371,613688583,613706520,17937,3887,225
613713442,613710653,613728569,17916,3888,225
613735491,613732703,613750638,17935,3889,225
613757560,613754771,613770451,15680,3890,225
613777373,613774584,613791551,16967,3891,225
613798473,613795684,613812333,16649,3892,225
613819255,613816466,613831829,15363,3893,225
613838749,613835961,613851640,15679,3894,225
613858562,613855773,613874658,18885,3895,225
613881582,613878792,613896076,17284,3896,225
613902998,613900209,613917154,16945,3897,225
613924076,613921287,613940174,18887,3898,225
613947095,613944307,613961272,16965,3899,225
613968193,613965405,613982687,17282,3900,225
613989495,613986923,614003673,16750,3901,225
614010596,614007806,614023824,16018,3902,225
614030630,614028059,614046075,18016,3903,225
614052998,614050209,614067807,17598,3904,225
614074729,614071941,614087937,15996,3905,225
614094858,614092070,614109036,16966,3906,225
614115957,614113169,614131085,17916,3907,225
614138008,614135219,614153134,17915,3908,225
614160055,614157267,614174232,16965,3909,225
614181154,614178365,614194043,15678,3910,225
614200964,614198176,614214171,15995,3911,225
614221092,614218304,614237191,18887,3912,225
614244113,614241325,614258607,17282,3913,225
614265410,614262839,614279902,17063,3914,225
614286720,614284148,614301867,17719,3915,225
614308788,614306001,614323283,17282,3916,225
614330204,614327416,614345647,18231,3917,225
614352568,614349781,614365775,15994,3918,225
614372695,614369908,614387505,17597,3919,225
614394428,614391639,614408290,16651,3920,225
614415211,614412423,614431310,18887,3921,225
614438231,614435442,614452409,16967,3922,225
614459331,614456541,614472558,16017,3923,225
614479477,614476690,614494288,17598,3924,225
614501208,614498421,614514098,15677,3925,225
614521019,614518230,614535829,17599,3926,225
614542751,614539962,614556296,16334,3927,225
614563217,614560429,614578048,17619,3928,225
614584970,614582180,614599147,16967,3929,225
614606069,614603280,614618958,15678,3930,225
614625776,614623203,614641241,18038,3931,225
614648162,614645374,614660735,15361,3932,225
614667655,614664867,614680882,16015,3933,225
614687803,614685015,614701644,16629,3934,225
614708566,614705777,614722744,16967,3935,225
614729664,614726877,614746079,19202,3936,225
614753000,614750212,614765888,15676,3937,225
614772809,614770020,614785698,15678,3938,225
614792618,614789830,614805844,16014,3939,225
614812766,614809977,614825340,15363,3940,225
614832259,614829472,614846436,16964,3941,225
614853244,614850671,614865499,14828,3942,225
614872420,614869631,614886281,16650,3943,225
614893202,614890414,614906093,15679,3944,225
614913013,614910225,614926852,16627,3945,225
614933774,614930985,614947635,16650,3946,225
614954557,614951768,614967783,16015,3947,225
614974704,614971916,614987277,15361,3948,225
614994198,614991409,615009979,18570,3949,225
615016900,615014112,615032028,17916,3950,225
615038949,615036161,615053759,17598,3951,225
615060681,615057892,615075830,17938,3952,225
615082751,615079963,615097898,17935,3953,225
615104820,615102031,615119946,17915,3954,225
615126762,615124191,615140623,16432,3955,225
615147545,615144756,615160751,15995,3956,225
615167672,615164883,615180877,15994,3957,225
615187797,615185009,615200687,15678,3958,225
615207607,615204819,615220496,15677,3959,225
615227416,615224628,615241909,17281,3960,225
615248830,615246042,615263007,16965,3961,225
615269928,615267140,615285710,18570,3962,225
615292631,615289843,615308096,18253,3963,225
615315017,615312229,615327908,15679,3964,225
615334829,615332040,615349639,17599,3965,225
615356560,615353772,615372659,18887,3966,225
615379580,615376792,615394391,17599,3967,225
615401312,615398524,615416439,17915,3968,225
615423360,615420572,615437221,16649,3969,225
615444143,615441354,615458320,16966,3970,225
615465241,615462453,615479079,16626,3971,225
615486000,615483212,615501149,17937,3972,225
615508071,615505282,615523220,17938,3973,225
615530141,615527353,615544319,16966,3974,225
615551241,615548452,615567023,18571,3975,225
615573945,615571156,615589727,18571,3976,225
615596648,615593860,615612746,18886,3977,225
615619668,615616879,615635132,18253,3978,225
615642053,615639265,615656548,17283,3979,225
615663469,615660681,615676993,16312,3980,225
615683914,615681126,615699694,18568,3981,225
615706616,615703827,615719505,15678,3982,225
615726425,615723637,615741553,17916,3983,225
615748474,615745686,615763285,17599,3984,225
615770206,615767418,615784046,16628,3985,225
615790967,615788179,615805461,17282,3986,225
615812383,615809594,615824324,14730,3987,225
615831245,615828456,615844769,16313,3988,225
615851691,615848902,615865551,16649,3989,225
615872473,615869684,615886314,16630,3990,225
615893235,615890447,615906125,15678,3991,225
615913046,615910257,615926252,15995,3992,225
615933173,615930384,615945114,14730,3993,225
615952034,615949246,615967182,17936,3994,225
615974104,615971315,615987964,16649,3995,225
615994886,615992097,616009380,17283,3996,225
616016302,616013513,616029508,15995,3997,225
616036429,616033641,616050605,16964,3998,225
616057527,616054738,616072022,17284,3999,225
616078942,616076155,616091199,15044,4000,225
616098120,616095331,616112614,17283,4001,225
616119410,616116839,616133249,16410,4002,225
616140169,616137381,616153692,16311,4003,225
616160613,616157825,616173187,15362,4004,225
616180007,616177435,616194185,16750,4005,225
616201106,616198318,616216550,18232,4006,225
616223472,616220683,616237650,16967,4007,225
616244571,616241783,616259066,17283,4008,225
616265986,616263198,616279529,16331,4009,225
616286450,616283662,616299024,15362,4010,225
616305944,616303156,616317885,14729,4011,225
616324806,616322017,616340588,18571,4012,225
616347509,616344721,616361032,16311,4013,225
616367953,616365165,616382784,17619,4014,225
616389706,616386917,616402913,15996,4015,225
616409834,616407045,616423041,15996,4016,225
616429845,616427272,616445309,18037,4017,225
616452230,616449442,616468009,18567,4018,225
616474930,616472142,616489107,16965,4019,225
616496028,616493240,616510839,17599,4020,225
616517760,616514972,616532254,17282,4021,225
616539174,616536386,616551431,15045,4022,225
616558350,616555563,616570626,15063,4023,225
616577547,616574758,616590753,15995,4024,225
616597674,616594885,616613117,18232,4025,225
616619917,616617345,616633145,15800,4026,225
616640065,616637277,616655531,18254,4027,225
616662452,616659664,616675974,16310,4028,225
616682896,616680107,616696757,16650,4029,225
616703679,616700890,616717203,16313,4030,225
616724125,616721336,616737648,16312,4031,225
616744568,616741780,616758746,16966,4032,225
616765667,616762879,616778873,15994,4033,225
616785793,616783005,616799021,16016,4034,225
616805943,616803154,616819782,16628,4035,225
616826704,616823915,616840564,16649,4036,225
616847486,616844697,616862929,18232,4037,225
616869850,616867062,616884344,17282,4038,225
616891264,616888477,616907046,18569,4039,225
616913968,616911179,616927513,16334,4040,225
616934434,616931646,616948929,17283,4041,225
616955850,616953062,616969709,16647,4042,225
616976631,616973842,616991124,17282,4043,225
616998045,616995257,617013191,17934,4044,225
617020112,617017324,617034289,16965,4045,225
617041211,617038422,617054418,15996,4046,225
617061240,617058669,617075734,17065,4047,225
617082655,617079867,617096832,16965,4048,225
617103754,617100965,617117594,16629,4049,225
617124515,617121727,617139326,17599,4050,225
617146144,617143573,617160322,16749,4051,225
617167243,617164455,617182371,17916,4052,225
617189293,617186504,617202182,15678,4053,225
617209104,617206314,617223913,17599,4054,225
617230834,617228046,617245011,16965,4055,225
617251933,617249144,617264190,15046,4056,225
617271110,617268322,617286575,18253,4057,225
617293497,617290708,617308962,18254,4058,225
617315882,617313095,617330060,16965,4059,225
617336980,617334193,617350841,16648,4060,225
617357656,617355085,617372782,17697,4061,225
617379704,617376915,617393566,16651,4062,225
617400488,617397699,617414981,17282,4063,225
617421902,617419114,617436713,17599,4064,225
617443634,617440846,617457179,16333,4065,225
617464100,617461312,617477962,16650,4066,225
617484883,617482095,617499378,17283,4067,225
617506300,617503511,617520162,16651,4068,225
617527084,617524295,617541261,16966,4069,225
617548080,617545508,617562256,16748,4070,225
617569177,617566389,617581751,15362,4071,225
617588671,617585883,617605086,19203,4072,225
617612007,617609219,617625530,16311,4073,225
617632451,617629663,617646291,16628,4074,225
617653093,617650522,617667250,16728,4075,225
617674172,617671383,617688983,17600,4076,225
617695905,617693116,617710082,16966,4077,225
617717003,617714215,617731495,17280,4078,225
617738415,617735628,617751960,16332,4079,225
617758882,617756093,617773039,16946,4080,225
617779961,617777172,617793167,15995,4081,225
617800088,617797299,617814899,17600,4082,225
617821821,617819032,617835998,16966,4083,225
617842919,617840131,617858700,18569,4084,225
617865622,617862833,617880433,17600,4085,225
617887353,617884566,617900558,15992,4086,225
617907376,617904804,617922504,17700,4087,225
617929426,617926637,617943921,17284,4088,225
617950843,617948054,617964703,16649,4089,225
617971528,617968956,617985705,16749,4090,225
617992626,617989838,618007436,17598,4091,225
618014359,618011569,618028852,17283,4092,225
618035678,618033106,618050173,17067,4093,225
618057095,618054306,618072561,18255,4094,225
618079383,618076811,618092273,15462,4095,225
618099193,618096405,618112716,16311,4096,225
618119638,618116849,618132845,15996,4097,225
618139765,618136977,618154259,17282,4098,225
618161180,618158392,618176328,17936,4099,225
618183248,618180461,618197741,17280,4100,225
618204662,618201874,618220761,18887,4101,225
618227682,618224894,618243463,18569,4102,225
618250384,618247596,618264878,17282,4103,225
618271801,618269011,618287245,18234,4104,225
618294167,618291378,618307394,16016,4105,225
618314315,618311527,618326887,15360,4106,225
618333807,618331019,618346065,15046,4107,225
618352986,618350197,618366214,16017,4108,225
618373136,618370347,618386976,16629,4109,225
618393897,618391109,618408707,17598,4110,225
618415515,618412943,618429058,16115,4111,225
618435981,618433191,618450476,17285,4112,225
618457398,618454609,618473178,18569,4113,225
618480099,618477311,618493305,15994,4114,225
618500226,618497438,618515354,17916,4115,225
618522275,618519487,618536769,17282,4116,225
618543690,618540902,618557552,16650,4117,225
618564473,618561685,618578968,17283,4118,225
618585889,618583101,618599434,16333,4119,225
618606355,618603567,618620850,17283,4120,225
618627660,618625088,618641817,16729,4121,225
618648738,618645950,618663548,17598,4122,225
618670469,618667681,618684962,17281,4123,225
618691884,618689095,618704162,15067,4124,225
618711082,618708294,618726230,17936,4125,225
618733152,618730363,618748596,18233,4126,225
618755403,618752831,618770552,17721,4127,225
618777473,618774685,618792283,17598,4128,225
618799204,618796416,618813380,16964,4129,225
618820301,618817513,618835429,17916,4130,225
618842350,618839562,618855239,15677,4131,225
618862160,618859371,618874438,15067,4132,225
618881359,618878570,618896505,17935,4133,225
618903426,618900638,618918236,17598,4134,225
618925158,618922369,618939336,16967,4135,225
618946257,618943469,618959485,16016,4136,225
618966406,618963618,618978345,14727,4137,225
618985155,618982582,618998383,15801,4138,225
619005305,619002515,619018850,16335,4139,225
619025771,619022983,619041235,18252,4140,225
619048157,619045368,619064572,19204,4141,225
619071494,619068705,619084701,15996,4142,225
619091623,619088834,619106117,17283,4143,225
619113038,619110250,619125296,15046,4144,225
619132093,619129521,619144350,14829,4145,225
619151271,619148483,619164499,16016,4146,225
619171420,619168632,619185915,17283,4147,225
619192837,619190048,619206044,15996,4148,225
619212964,619210177,619227141,16964,4149,225
619234063,619231274,619248874,17600,4150,225
619255795,619253007,619270606,17599,4151,225
619277528,619274739,619292972,18233,4152,225
619299894,619297105,619313437,16332,4153,225
619320358,619317570,619334535,16965,4154,225
619341457,619338668,619356267,17599,4155,225
619363188,619360400,619377366,16966,4156,225
619384287,619381499,619400068,18569,4157,225
619406894,619404322,619423309,18987,4158,225
619430231,619427442,619445696,18254,4159,225
619452617,619449829,619465191,15362,4160,225
619472111,619469323,619486606,17283,4161,225
619493431,619490859,619507292,16433,4162,225
619514213,619511425,619530312,18887,4163,225
619537234,619534445,619551095,16650,4164,225
619558016,619555228,619573481,18253,4165,225
619580403,619577614,619594264,16650,4166,225
619601185,619598397,619615363,16966,4167,225
619622284,619619496,619637749,18253,4168,225
619644670,619641882,619657561,15679,4169,225
619664481,619661693,619678974,17281,4170,225
619685895,619683107,619699419,16312,4171,225
619706341,619703552,619720519,16967,4172,225
619727440,619724652,619740963,16311,4173,225
619747884,619745096,619762061,16965,4174,225
619768886,619766313,619783695,17382,4175,225
619790617,619787828,619805428,17600,4176,225
619812246,619809674,619826403,16729,4177,225
619833231,619830658,619847071,16413,4178,225
619853992,619851204,619869118,17914,4179,225
619876039,619873251,619890533,17282,4180,225
619897454,619894666,619913235,18569,4181,225
619920157,619917368,619932731,15363,4182,225
619939653,619936863,619952860,15997,4183,225
619959683,619957112,619972256,15144,4184,225
619979177,619976389,619993987,17598,4185,225
620000910,619998120,620013801,15681,4186,225
620020721,620017933,620036186,18253,4187,225
620043107,620040319,620058571,18252,4188,225
620065492,620062704,620080302,17598,4189,225
620087223,620084435,620101400,16965,4190,225
620108212,620105641,620123021,17380,4191,225
620129941,620127154,620144435,17281,4192,225
620151356,620148568,620164246,15678,4193,225
620171165,620168378,620186314,17936,4194,225
620193235,620190447,620207413,16966,4195,225
620214335,620211546,620228491,16945,4196,225
620235318,620232746,620249158,16412,4197,225
620256079,620253291,620270573,17282,4198,225
620277399,620274827,620292548,17721,4199,225
620299470,620296681,620312697,16016,4200,225
620319515,620316944,620331476,14532,4201,225
620338397,620335608,620352573,16965,4202,225
620359373,620356802,620372263,15461,4203,225
620379184,620376395,620392707,16312,4204,225
620399629,620396840,620412520,15680,4205,225
620419336,620416764,620434462,17698,4206,225
620441383,620438595,620455878,17283,4207,225
620462800,620460011,620477947,17936,4208,225
620484867,620482080,620499699,17619,4209,225
620506619,620503832,620520797,16965,4210,225
620527718,620524931,620543182,18251,4211,225
620550105,620547316,620564283,16967,4212,225
620571204,620568416,620586015,17599,4213,225
620592936,620590148,620608064,17916,4214,225
620614985,620612197,620629141,16944,4215,225
620636063,620633274,620650556,17282,4216,225
620657477,620654689,620671655,16966,4217,225
620678576,620675788,620693070,17282,4218,225
620699990,620697203,620713196,15993,4219,225
620720117,620717328,620734611,17283,4220,225
620741533,620738744,620757946,19202,4221,225
620764772,620762201,620779266,17065,4222,225
620786187,620783399,620801335,17936,4223,225
620808257,620805468,620824039,18571,4224,225
620830960,620828172,620843532,15360,4225,225
620850346,620847775,620862919,15144,4226,225
620869841,620867052,620884019,16967,4227,225
620890941,620888152,620906385,18233,4228,225
620913306,620910518,620928433,17915,4229,225
620935355,620932566,620949215,16649,4230,225
620956136,620953348,620970947,17599,4231,225
620977868,620975080,620991728,16648,4232,225
620998650,620995861,621012511,16650,4233,225
621019432,621016644,621033610,16966,4234,225
621040530,621037743,621054707,16964,4235,225
621061528,621058956,621074418,15462,4236,225
621081339,621078550,621093597,15047,4237,225
621100517,621097729,621115665,17936,4238,225
621122587,621119798,621136110,16312,4239,225
621143031,621140243,621157842,17599,4240,225
621164765,621161976,621178943,16967,4241,225
621185865,621183076,621201645,18569,4242,225
621208451,621205879,621222945,17066,4243,225
621229759,621227187,621243619,16432,4244,225
621250541,621247752,621265352,17600,4245,225
621272273,621269485,621286768,17283,4246,225
621293688,621290901,621307866,16965,4247,225
621314787,621311999,621330569,18570,4248,225
621337491,621334702,621351669,16967,4249,225
621358592,621355802,621371799,15997,4250,225
621378612,621376040,621393740,17700,4251,225
621400660,621397873,621415787,17914,4252,225
621422709,621419920,621438806,18886,4253,225
621445727,621442939,621460222,17283,4254,225
621467033,621464462,621482814,18352,4255,225
621489736,621486947,621505516,18569,4256,225
621512438,621509649,621527248,17599,4257,225
621534169,621531381,621547375,15994,4258,225
621554188,621551617,621570285,18668,4259,225
621577207,621574418,621592016,17598,4260,225
621598937,621596149,621613114,16965,4261,225
621620036,621617247,621634530,17283,4262,225
621641450,621638663,621654023,15360,4263,225
621660944,621658155,621674488,16333,4264,225
621681408,621678621,621695903,17282,4265,225
621702824,621700036,621715714,15678,4266,225
621722536,621719964,621737347,17383,4267,225
621744268,621741480,621759100,17620,4268,225
621766023,621763234,621782119,18885,4269,225
621789040,621786252,621804165,17913,4270,225
621811087,621808298,621823977,15679,4271,225
621830898,621828110,621844105,15995,4272,225
621851026,621848237,621866492,18255,4273,225
621873414,621870625,621887275,16650,4274,225
621894197,621891408,621908691,17283,4275,225
621915612,621912824,621928841,16017,4276,225
621935761,621932974,621950889,17915,4277,225
621957701,621955129,621971879,16750,4278,225
621978800,621976012,621992977,16965,4279,225
621999898,621997110,622015026,17916,4280,225
622021948,622019160,622036443,17283,4281,225
622043365,622040576,622056888,16312,4282,225
622063809,622061021,622077669,16648,4283,225
622084591,622081802,622097481,15679,4284,225
622104402,622101613,622119530,17917,4285,225
622126452,622123663,622142233,18570,4286,225
622149154,622146366,622163332,16966,4287,225
622170253,622167465,622185380,17915,4288,225
622192301,622189513,622206163,16650,4289,225
622213084,622210296,622226607,16311,4290,225
622233529,622230740,622249628,18888,4291,225
622256550,622253762,622271699,17937,4292,225
622278621,622275832,622293114,17282,4293,225
622300034,622297247,622314844,17597,4294,225
622321766,622318977,622336574,17597,4295,225
622343495,622340707,622357673,16966,4296,225
622364595,622361806,622378772,16966,4297,225
622385693,622382905,622401159,18254,4298,225
622408081,622405292,622420972,15680,4299,225
622427892,622425104,622441119,16015,4300,225
622447916,622445345,622462726,17381,4301,225
622469648,622466859,622484458,17599,4302,225
622491380,622488591,622507479,18888,4303,225
622514402,622511613,622528559,16946,4304,225
622535379,622532808,622551476,18668,4305,225
622558398,622555610,622572892,17282,4306,225
622579814,622577026,622595256,18230,4307,225
622602177,622599389,622615384,15995,4308,225
622622304,622619516,622634878,15362,4309,225
622641798,622639010,622654688,15678,4310,225
622661609,622658820,622675450,16630,4311,225
622682371,622679583,622697203,17620,4312,225
622704125,622701336,622717332,15996,4313,225
622724252,622721464,622737459,15995,4314,225
622744380,622741592,622758874,17282,4315,225
622765794,622763007,622779317,16310,4316,225
622786238,622783450,622799127,15677,4317,225
622805937,622803365,622822035,18670,4318,225
622828840,622826268,622842680,16412,4319,225
622849601,622846813,622862174,15361,4320,225
622868984,622866413,622881241,14828,4321,225
622888161,622885373,622904259,18886,4322,225
622911180,622908392,622924408,16016,4323,225
622931329,622928541,622947742,19201,4324,225
622954663,622951875,622968839,16964,4325,225
622975760,622972972,622989937,16965,4326,225
622996858,622994070,623012007,17937,4327,225
623018928,623016140,623032452,16312,4328,225
623039374,623036585,623053552,16967,4329,225
623060473,623057685,623073364,15679,4330,225
623080284,623077496,623094777,17281,4331,225
623101699,623098910,623117144,18234,4332,225
623124065,623121277,623138222,16945,4333,225
623145144,623142356,623157083,14727,4334,225
623164004,623161216,623177864,16648,4335,225
623184785,623181997,623198309,16312,4336,225
623205231,623202443,623221013,18570,4337,225
623227935,623225146,623243062,17916,4338,225
623249984,623247195,623265449,18254,4339,225
623272256,623269684,623285800,16116,4340,225
623292721,623289933,623307532,17599,4341,225
623314453,623311665,623328631,16966,4342,225
623335553,623332764,623350680,17916,4343,225
623357602,623354813,623372097,17284,4344,225
623379018,623376230,623393512,17282,4345,225
623400434,623397645,623415581,17936,4346,225
623422502,623419714,623435708,15994,4347,225
623442628,623439840,623456466,16626,4348,225
623463293,623460722,623476500,15778,4349,225
623483319,623480747,623496526,15779,4350,225
623503446,623500658,623518255,17597,4351,225
623525177,623522388,623540642,18254,4352,225
623547565,623544775,623561743,16968,4353,225
623568666,623565877,623583160,17283,4354,225
623589987,623587416,623605113,17697,4355,225
623612034,623609246,623626844,17598,4356,225
623633765,623630977,623647942,16965,4357,225
623654863,623652075,623667437,15362,4358,225
623674357,623671569,623688218,16649,4359,225
623695139,623692351,623708662,16311,4360,225
623715583,623712795,623731363,18568,4361,225
623738285,623735496,623753434,17938,4362,225
623760242,623757670,623772499,14829,4363,225
623779419,623776631,623795834,19203,4364,225
623802650,623800078,623817461,17383,4365,225
623824383,623821595,623837906,16311,4366,225
623844828,623842039,623857402,15363,4367,225
623864322,623861534,623877846,16312,4368,225
623884769,623881980,623899580,17600,4369,225
623906501,623903713,623920384,16671,4370,225
623927305,623924517,623941145,16628,4371,225
623948067,623945278,623960640,15362,4372,225
623967560,623964772,623980133,15361,4373,225
623987055,623984266,624001549,17283,4374,225
624008470,624005682,624021994,16312,4375,225
624028915,624026127,624042460,16333,4376,225
624049382,624046593,624063876,17283,4377,225
624070797,624068009,624085925,17916,4378,225
624092847,624090058,624107024,16966,4379,225
624113946,624111157,624128755,17598,4380,225
624135676,624132888,624149853,16965,4381,225
624156774,624153986,624170951,16965,4382,225
624177873,624175084,624192683,17599,4383,225
624199604,624196816,624215703,18887,4384,225
624222624,624219836,624236802,16966,4385,225
624243725,624240935,624257586,16651,4386,225
624264507,624261719,624278368,16649,4387,225
624285290,624282501,624298495,15994,4388,225
624305416,624302627,624321513,18886,4389,225
624328434,624325646,624341661,16015,4390,225
624348583,624345794,624361471,15677,4391,225
624368392,624365603,624382569,16966,4392,225
624389492,624386703,624403669,16966,4393,225
624410590,624407802,624426055,18253,4394,225
624432976,624430188,624447469,17281,4395,225
624454390,624451602,624467596,15994,4396,225
624474517,624471728,624487407,15679,4397,225
624494327,624491539,624507216,15677,4398,225
624514136,624511348,624526393,15045,4399,225
624533213,624530641,624548340,17699,4400,225
624555260,624552473,624569143,16670,4401,225
624575963,624573392,624590141,16749,4402,225
624597061,624594274,624611237,16963,4403,225
624618158,624615370,624632020,16650,4404,225
624638941,624636153,624652486,16333,4405,225
624659306,624656735,624674453,17718,4406,225
624681374,624678585,624695236,16651,4407,225
624702157,624699369,624715679,16310,4408,225
624722600,624719812,624739013,19201,4409,225
624745934,624743146,624758191,15045,4410,225
624765111,624762323,624779289,16966,4411,225
624786092,624783519,624799615,16096,4412,225
624806536,624803748,624819426,15678,4413,225
624826346,624823558,624839572,16014,4414,225
624846493,624843705,624862275,18570,4415,225
624869081,624866511,624882287,15776,4416,225
624889087,624886515,624901364,14849,4417,225
624908169,624905597,624922030,16433,4418,225
624928844,624926272,624944626,18354,4419,225
624951548,624948759,624965724,16965,4420,225
624972645,624969857,624987138,17281,4421,225
624994059,624991271,625008236,16965,4422,225
625015157,625012369,625029968,17599,4423,225
625036889,625034101,625052353,18252,4424,225
625059275,625056486,625074738,18252,4425,225
625081547,625078976,625096674,17698,4426,225
625103595,625100807,625116169,15362,4427,225
625122979,625120407,625136524,16117,4428,225
625143445,625140657,625157940,17283,4429,225
625164861,625162073,625177433,15360,4430,225
625184353,625181565,625199185,17620,4431,225
625206106,625203318,625219966,16648,4432,225
625226887,625224099,625241065,16966,4433,225
625247987,625245198,625260878,15680,4434,225
625267798,625265010,625282293,17283,4435,225
625289102,625286531,625302940,16409,4436,225
625309742,625307169,625322949,15780,4437,225
625329869,625327081,625344047,16966,4438,225
625350752,625348180,625368469,20289,4439,225
625375391,625372602,625388936,16334,4440,225
625395857,625393069,625411005,17936,4441,225
625417926,625415138,625431133,15995,4442,225
625438054,625435266,625453182,17916,4443,225
625460103,625457315,625472360,15045,4444,225
625479279,625476492,625494723,18231,4445,225
625501644,625498856,625515505,16649,4446,225
625522426,625519638,625537236,17598,4447,225
625544159,625541370,625558337,16967,4448,225
625565259,625562470,625580069,17599,4449,225
625586868,625584297,625601362,17065,4450,225
625608283,625605495,625620856,15361,4451,225
625627777,625624988,625643559,18571,4452,225
625650376,625647805,625663266,15461,4453,225
625670188,625667399,625685316,17917,4454,225
625692238,625689449,625705129,15680,4455,225
625711954,625709383,625726449,17066,4456,225
625733370,625730582,625747210,16628,4457,225
625754027,625751456,625767550,16094,4458,225
625774473,625771683,625788967,17284,4459,225
625795888,625793100,625811016,17916,4460,225
625817938,625815150,625830829,15679,4461,225
625837750,625834961,625852877,17916,4462,225
625859696,625857123,625872270,15147,4463,225
625879191,625876402,625901451,25049,4464,225
625908374,625905585,625922235,16650,4465,225
625929157,625926368,625944282,17914,4466,225
625951203,625948415,625963461,15046,4467,225
625970283,625967712,625984461,16749,4468,225
625991383,625988594,626005561,16967,4469,225
626012483,626009694,626026028,16334,4470,225
626032949,626030161,626046809,16648,4471,225
626053732,626050942,626067592,16650,4472,225
626074513,626071725,626087086,15361,4473,225
626094006,626091219,626108183,16964,4474,225
626115105,626112316,626128965,16649,4475,225
626135887,626133098,626150380,17282,4476,225
626157302,626154513,626170825,16312,4477,225
626177747,626174959,626190637,15678,4478,225
626197558,626194770,626211102,16332,4479,225
626218023,626215235,626231546,16311,4480,225
626238467,626235679,626252962,17283,4481,225
626259883,626257095,626272774,15679,4482,225
626279694,626276907,626293534,16627,4483,225
626300455,626297667,626312713,15046,4484,225
626319516,626316944,626331772,14828,4485,225
626338694,626335905,626352871,16966,4486,225
626359793,626357004,626373317,16313,4487,225
626380238,626377450,626395050,17600,4488,225
626401972,626399183,626417438,18255,4489,225
626424359,626421571,626437565,15994,4490,225
626444486,626441697,626458662,16965,4491,225
626465583,626462795,626480076,17281,4492,225
626486997,626484209,626500521,16312,4493,225
626507443,626504654,626521620,16966,4494,225
626528444,626525871,626542938,17067,4495,225
626549859,626547071,626564353,17282,4496,225
626571274,626568486,626587373,18887,4497,225
626594294,626591506,626610393,18887,4498,225
626617315,626614527,626632463,17936,4499,225
626639385,626636596,626653562,16966,4500,225
626660483,626657695,626675315,17620,4501,225
626682141,626679569,626696319,16750,4502,225
626703241,626700452,626719338,18886,4503,225
626726163,626723592,626740657,17065,4504,225
626747480,626744909,626761657,16748,4505,225
626768578,626765790,626782439,16649,4506,225
626789360,626786572,626802250,15678,4507,225
626809170,626806382,626822693,16311,4508,225
626829615,626826826,626843793,16967,4509,225
626850715,626847926,626863922,15996,4510,225
626870843,626868055,626886307,18252,4511,225
626893228,626890440,626909010,18570,4512,225
626915932,626913143,626930742,17599,4513,225
626937662,626934875,626951207,16332,4514,225
626958129,626955340,626971990,16650,4515,225
626978911,626976123,626992771,16648,4516,225
626999693,626996904,627014186,17282,4517,225
627021108,627018320,627034315,15995,4518,225
627041237,627038448,627057017,18569,4519,225
627063938,627061150,627077482,16332,4520,225
627084403,627081615,627099868,18253,4521,225
627106789,627104001,627120966,16965,4522,225
627127888,627125099,627142361,17262,4523,225
627149283,627146495,627164114,17619,4524,225
627170937,627168364,627184796,16432,4525,225
627191717,627188929,627204943,16014,4526,225
627211863,627209076,627225724,16648,4527,225
627232645,627229857,627248744,18887,4528,225
627255666,627252877,627271110,18233,4529,225
627278032,627275243,627293498,18255,4530,225
627300420,627297631,627314597,16966,4531,225
627321517,627318730,627336982,18252,4532,225
627343803,627341232,627357010,15778,4533,225
627363932,627361143,627379397,18254,4534,225
627386207,627383635,627401356,17721,4535,225
627408277,627405489,627420534,15045,4536,225
627427456,627424667,627440346,15679,4537,225
627447267,627444479,627461106,16627,4538,225
627467931,627465360,627482107,16747,4539,225
627489028,627486240,627503205,16965,4540,225
627510126,627507338,627522699,15361,4541,225
627529498,627526927,627544941,18014,4542,225
627551862,627549074,627567643,18569,4543,225
627574566,627571776,627589377,17601,4544,225
627596299,627593510,627608240,14730,4545,225
627615160,627612372,627628387,16015,4546,225
627635308,627632520,627647566,15046,4547,225
627654372,627651801,627668867,17066,4548,225
627675789,627673000,627689967,16967,4549,225
627696889,627694100,627710096,15996,4550,225
627717017,627714229,627731195,16966,4551,225
627738115,627735328,627753896,18568,4552,225
627760818,627758029,627775629,17600,4553,225
627782550,627779762,627797698,17936,4554,225
627804620,627801831,627819768,17937,4555,225
627826689,627823901,627840846,16945,4556,225
627847768,627844979,627860342,15363,4557,225
627867262,627864474,627883041,18567,4558,225
627889963,627887174,627902536,15362,4559,225
627909457,627906669,627924268,17599,4560,225
627931189,627928401,627947286,18885,4561,225
627954207,627951419,627967434,16015,4562,225
627974355,627971567,627989819,18252,4563,225
627996740,627993952,628009968,16016,4564,225
628016889,628014101,628032355,18254,4565,225
628039276,628036488,628052799,16311,4566,225
628059721,628056932,628075186,18254,4567,225
628082107,628079319,628095650,16331,4568,225
628102573,628099784,628116117,16333,4569,225
628123038,628120250,628136877,16627,4570,225
628143798,628141010,628158609,17599,4571,225
628165531,628162743,628179391,16648,4572,225
628186313,628183524,628201145,17621,4573,225
628208067,628205278,628224165,18887,4574,225
628231088,628228298,628245265,16967,4575,225
628252187,628249398,628266365,16967,4576,225
628273287,628270498,628287464,16966,4577,225
628294385,628291597,628306348,14751,4578,225
628313269,628310481,628326160,15679,4579,225
628333081,628330293,628347575,17282,4580,225
628354497,628351708,628369963,18255,4581,225
628376885,628374097,628391063,16966,4582,225
628397984,628395196,628413766,18570,4583,225
628420688,628417900,628432946,15046,4584,225
628439650,628437079,628463235,26156,4585,225
628470043,628467471,628483566,16095,4586,225
628490378,628487807,628505188,17381,4587,225
628512111,628509322,628526288,16966,4588,225
628533210,628530421,628545467,15046,4589,225
628552387,628549599,628564644,15045,4590,225
628571564,628568776,628584793,16017,4591,225
628591714,628588926,628605891,16965,4592,225
628612813,628610024,628627623,17599,4593,225
628634546,628631757,628648406,16649,4594,225
628655327,628652539,628668534,15995,4595,225
628675456,628672667,628688977,16310,4596,225
628695899,628693110,628710077,16967,4597,225
628716999,628714211,628732148,17937,4598,225
628739070,628736282,628751961,15679,4599,225
628758881,628756093,628772740,16647,4600,225
628779560,628776989,628795975,18986,4601,225
628802896,628800108,628816736,16628,4602,225
628823658,628820869,628837498,16629,4603,225
628844419,628841631,628857943,16312,4604,225
628864864,628862076,628879021,16945,4605,225
628885943,628883154,628899466,16312,4606,225
628906388,628903600,628919277,15677,4607,225
628926197,628923409,628941008,17599,4608,225
628947929,628945141,628961770,16629,4609,225
628968691,628965903,628981265,15362,4610,225
628988186,628985398,629002363,16965,4611,225
629009285,629006496,629022808,16312,4612,225
629029729,629026941,629043907,16966,4613,225
629050829,629048040,629064374,16334,4614,225
629071295,629068507,629084501,15994,4615,225
629091422,629088634,629107204,18570,4616,225
629114125,629111337,629129905,18568,4617,225
629136721,629134148,629151868,17720,4618,225
629158790,629156001,629172630,16629,4619,225
629179434,629176862,629192008,15146,4620,225
629198928,629196140,629211819,15679,4621,225
629218739,629215951,629231966,16015,4622,225
629238886,629236099,629254350,18251,4623,225
629261271,629258483,629274795,16312,4624,225
629281716,629278927,629293973,15046,4625,225
629300893,629298105,629313784,15679,4626,225
629320704,629317916,629333593,15677,4627,225
629340513,629337725,629352454,14729,4628,225
629359374,629356586,629373551,16965,4629,225
629380472,629377684,629395282,17598,4630,225
629402103,629399532,629415964,16432,4631,225
629422884,629420097,629435457,15360,4632,225
629442379,629439590,629456873,17283,4633,225
629463794,629461006,629478921,17915,4634,225
629485842,629483054,629500019,16965,4635,225
629506940,629504152,629520463,16311,4636,225
629527385,629524596,629540591,15995,4637,225
629547511,629544723,629562638,17915,4638,225
629569559,629566771,629584686,17915,4639,225
629591607,629588819,629605468,16649,4640,225
629612389,629609601,629626566,16965,4641,225
629633487,629630699,629646715,16016,4642,225
629653636,629650848,629667812,16964,4643,225
629674735,629671945,629688258,16313,4644,225
629695180,629692391,629709675,17284,4645,225
629716490,629713918,629732588,18670,4646,225
629739510,629736721,629753034,16313,4647,225
629759955,629757167,629773816,16649,4648,225
629780738,629777949,629796203,18254,4649,225
629803028,629800456,629816235,15779,4650,225
629823155,629820367,629837333,16966,4651,225
629844255,629841466,629859382,17916,4652,225
629866304,629863515,629880799,17284,4653,225
629887721,629884932,629902848,17916,4654,225
629909770,629906981,629922659,15678,4655,225
629929579,629926791,629942469,15678,4656,225
629949390,629946601,629964854,18253,4657,225
629971776,629968987,629983717,14730,4658,225
629990638,629987849,630005132,17283,4659,225
630012053,630009265,630025576,16311,4660,225
630032497,630029709,630047308,17599,4661,225
630054116,630051545,630068293,16748,4662,225
630075214,630072426,630088104,15678,4663,225
630095024,630092236,630109518,17282,4664,225
630116439,630113651,630130934,17283,4665,225
630137855,630135067,630152664,17597,4666,225
630159584,630156797,630173106,16309,4667,225
630180027,630177239,630195808,18569,4668,225
630202623,630200051,630218721,18670,4669,225
630225643,630222854,630239504,16650,4670,225
630246426,630243637,630260288,16651,4671,225
630267210,630264421,630282337,17916,4672,225
630289258,630286470,630303752,17282,4673,225
630310673,630307885,630325800,17915,4674,225
630332723,630329933,630345614,15681,4675,225
630352535,630349746,630367030,17284,4676,225
630373951,630371163,630390049,18886,4677,225
630396970,630394182,630411148,16966,4678,225
630418070,630415281,630432564,17283,4679,225
630439485,630436697,630453346,16649,4680,225
630460267,630457479,630473811,16332,4681,225
630480733,630477944,630495227,17283,4682,225
630502148,630499360,630515354,15994,4683,225
630522274,630519486,630535165,15679,4684,225
630542086,630539297,630555925,16628,4685,225
630562847,630560058,630579262,19204,4686,225
630586183,630583395,630599707,16312,4687,225
630606629,630603840,630619541,15701,4688,225
630626462,630623673,630642243,18570,4689,225
630649165,630646376,630662371,15995,4690,225
630669293,630666504,630684441,17937,4691,225
630691363,630688574,630706490,17916,4692,225
630713411,630710623,630725985,15362,4693,225
630732906,630730118,630747083,16965,4694,225
630754004,630751216,630766894,15678,4695,225
630773814,630771026,630787992,16966,4696,225
630794914,630792125,630807487,15362,4697,225
630814407,630811619,630826980,15361,4698,225
630833900,630831112,630849365,18253,4699,225
630856183,630853612,630870677,17065,4700,225
630877600,630874810,630891144,16334,4701,225
630898065,630895277,630910005,14728,4702,225
630916925,630914137,630932707,18570,4703,225
630939628,630936840,630953806,16966,4704,225
630960728,630957939,630973935,15996,4705,225
630980739,630978169,630993945,15776,4706,225
631000866,630998077,631015044,16967,4707,225
631021964,631019177,631034537,15360,4708,225
631041345,631038772,631054868,16096,4709,225
631061677,631059106,631075221,16115,4710,225
631082143,631079354,631096637,17283,4711,225
631103447,631100874,631118258,17384,4712,225
631125179,631122391,631139357,16966,4713,225
631146278,631143490,631161426,17936,4714,225
631168347,631165559,631181890,16331,4715,225
631188811,631186023,631201384,15361,4716,225
631208304,631205516,631222164,16648,4717,225
631229085,631226297,631242609,16312,4718,225
631249529,631246742,631262103,15361,4719,225
631268928,631266356,631281502,15146,4720,225
631288422,631285634,631302600,16966,4721,225
631309522,631306733,631323362,16629,4722,225
631330283,631327495,631345093,17598,4723,225
631351910,631349339,631367692,18353,4724,225
631374614,631371825,631390078,18253,4725,225
631396999,631394211,631410859,16648,4726,225
631417780,631414992,631432907,17915,4727,225
631439724,631437153,631453586,16433,4728,225
631460507,631457719,631475000,17281,4729,225
631481922,631479133,631497704,18571,4730,225
631504625,631501837,631519120,17283,4731,225
631526043,631523253,631539248,15995,4732,225
631546168,631543380,631560979,17599,4733,225
631567683,631565112,631585506,20394,4734,225
631592211,631589640,631608092,18452,4735,225
631615014,631612225,631628876,16651,4736,225
631635797,631633009,631649974,16965,4737,225
631656896,631654107,631670757,16650,4738,225
631677679,631674890,631691223,16333,4739,225
631698144,631695356,631712005,16649,4740,225
631718927,631716138,631733738,17600,4741,225
631740659,631737871,631755787,17916,4742,225
631762709,631759921,631776886,16965,4743,225
631783807,631781019,631798302,17283,4744,225
631805224,631802435,631819719,17284,4745,225
631826640,631823852,631840817,16965,4746,225
631847739,631844950,631861599,16649,4747,225
631868521,631865732,631883984,18252,4748,225
631890905,631888117,631906370,18253,4749,225
631913291,631910503,631926520,16017,4750,225
631933441,631930653,631949223,18570,4751,225
631956145,631953356,631972243,18887,4752,225
631979164,631976376,631994629,18253,4753,225
632001551,631998762,632017016,18254,4754,225
632023938,632021149,632036215,15066,4755,225
632043135,632040347,632058579,18232,4756,225
632065501,632062712,632079339,16627,4757,225
632086262,632083472,632098835,15363,4758,225
632105661,632103089,632118573,15484,4759,225
632125493,632122705,632138065,15360,4760,225
632144871,632142299,632159049,16750,4761,225
632165850,632163279,632178424,15145,4762,225
632185346,632182557,632199206,16649,4763,225
632206005,632203433,632219550,16117,4764,225
632226471,632223683,632240333,16650,4765,225
632247254,632244466,632259849,15383,4766,225
632266769,632263981,632280312,16331,4767,225
632287234,632284445,632299807,15362,4768,225
632306728,632303939,632322826,18887,4769,225
632329748,632326959,632345212,18253,4770,225
632352012,632349440,632366823,17383,4771,225
632373744,632370956,632388555,17599,4772,225
632395476,632392688,632409020,16332,4773,225
632415943,632413153,632429804,16651,4774,225
632436725,632433937,632450565,16628,4775,225
632457374,632454803,632471531,16728,4776,225
632478453,632475664,632491976,16312,4777,225
632498898,632496109,632513392,17283,4778,225
632520314,632517525,632536413,18888,4779,225
632543334,632540546,632559748,19202,4780,225
632566670,632563881,632579877,15996,4781,225
632586691,632584120,632599265,15145,4782,225
632606185,632603397,632620047,16650,4783,225
632626969,632624180,632640176,15996,4784,225
632647096,632644308,632659036,14728,4785,225
632665955,632663168,632680766,17598,4786,225
632687688,632684899,632702181,17282,4787,225
632708996,632706424,632722520,16096,4788,225
632729441,632726653,632744272,17619,4789,225
632751194,632748405,632765689,17284,4790,225
632772495,632769925,632786335,16410,4791,225
632793256,632790468,632806780,16312,4792,225
632813701,632810913,632828512,17599,4793,225
632835327,632832755,632848218,15463,4794,225
632855138,632852350,632870287,17937,4795,225
632877208,632874420,632890752,16332,4796,225
632897673,632894885,632913137,18252,4797,225
632920058,632917270,632933920,16650,4798,225
632940840,632938053,632955333,17280,4799,225
632962154,632959582,632977301,17719,4800,225
632984107,632981536,632997969,16433,4801,225
633004777,633002205,633018637,16432,4802,225
633025559,633022770,633038766,15996,4803,225
633045686,633042898,633057944,15046,4804,225
633064864,633062076,633079358,17282,4805,225
633086176,633083605,633101304,17699,4806,225
633108226,633105437,633123036,17599,4807,225
633129958,633127169,633141899,14730,4808,225
633148820,633146031,633162681,16650,4809,225
633169603,633166814,633183759,16945,4810,225
633190680,633187892,633205491,17599,4811,225
633212413,633209624,633225620,15996,4812,225
633232445,633229872,633247889,18017,4813,225
633254811,633252022,633269938,17916,4814,225
633276861,633274071,633291037,16966,4815,225
633297958,633295170,633313422,18252,4816,225
633320344,633317555,633334205,16650,4817,225
633341010,633338438,633354871,16433,4818,225
633361793,633359004,633375634,16630,4819,225
633382556,633379767,633396733,16966,4820,225
633403654,633400866,633417178,16312,4821,225
633423994,633421421,633437517,16096,4822,225
633444438,633441650,633458932,17282,4823,225
633465853,633463065,633478744,15679,4824,225
633485664,633482876,633499841,16965,4825,225
633506762,633503974,633521890,17916,4826,225
633528811,633526023,633543958,17935,4827,225
633550878,633548091,633564738,16647,4828,225
633571659,633568871,633584232,15361,4829,225
633591153,633588365,633606934,18569,4830,225
633613856,633611067,633628666,17599,4831,225
633635587,633632799,633650081,17282,4832,225
633657003,633654214,633670209,15995,4833,225
633677129,633674341,633691306,16965,4834,225
633698227,633695439,633713692,18253,4835,225
633720614,633717825,633733840,16015,4836,225
633740761,633737973,633752701,14728,4837,225
633759620,633756833,633774746,17913,4838,225
633781668,633778879,633795190,16311,4839,225
633802111,633799323,633816921,17598,4840,225
633823843,633821054,633837682,16628,4841,225
633844604,633841815,633859435,17620,4842,225
633866254,633863682,633881064,17382,4843,225
633887868,633885296,633901391,16095,4844,225
633908312,633905524,633920886,15362,4845,225
633927700,633925129,633943799,18670,4846,225
633950625,633948053,633965773,17720,4847,225
633972695,633969906,633986239,16333,4848,225
633993161,633990372,634008627,18255,4849,225
634015549,634012760,634030360,17600,4850,225
634037281,634034493,634051458,16965,4851,225
634058379,634055591,634072220,16629,4852,225
634079141,634076353,634094606,18253,4853,225
634101431,634098859,634113688,14829,4854,225
634120609,634117820,634135736,17916,4855,225
634142658,634139869,634157469,17600,4856,225
634164390,634161602,634178568,16966,4857,225
634185489,634182701,634200954,18253,4858,225
634207876,634205087,634222369,17282,4859,225
634229290,634226502,634244755,18253,4860,225
634251677,634248888,634265538,16650,4861,225
634272460,634269671,634286638,16967,4862,225
634293560,634290771,634307737,16966,4863,225
634314658,634311870,634326915,15045,4864,225
634333836,634331048,634348331,17283,4865,225
634355253,634352464,634371668,19204,4866,225
634378476,634375905,634393309,17404,4867,225
634400230,634397442,634415694,18252,4868,225
634422615,634419827,634437743,17916,4869,225
634444665,634441876,634459792,17916,4870,225
634466714,634463926,634481862,17936,4871,225
634488681,634486110,634503176,17066,4872,225
634510097,634507309,634525225,17916,4873,225
634532146,634529358,634546640,17282,4874,225
634553562,634550773,634567424,16651,4875,225
634574345,634571557,634588205,16648,4876,225
634595127,634592338,634608650,16312,4877,225
634615570,634612783,634628459,15676,4878,225
634635380,634632592,634649874,17282,4879,225
634656795,634654007,634670318,16311,4880,225
634677239,634674451,634691078,16627,4881,225
634697999,634695211,634711860,16649,4882,225
634718781,634715993,634732641,16648,4883,225
634739562,634736774,634752452,15678,4884,225
634759372,634756584,634774520,17936,4885,225
634781442,634778653,634795302,16649,4886,225
634802222,634799435,634815112,15677,4887,225
634822033,634819245,634836211,16966,4888,225
634843132,634840344,634858914,18570,4889,225
634865835,634863047,634878091,15044,4890,225
634885012,634882224,634898536,16312,4891,225
634905457,634902669,634920584,17915,4892,225
634927504,634924717,634942968,18251,4893,225
634949767,634947195,634964577,17382,4894,225
634971498,634968710,634985338,16628,4895,225
634992260,634989471,635007091,17620,4896,225
635014012,635011224,635030111,18887,4897,225
635037031,635034244,635051524,17280,4898,225
635058445,635055657,635072307,16650,4899,225
635079228,635076440,635093069,16629,4900,225
635099990,635097202,635114168,16966,4901,225
635121088,635118301,635136552,18251,4902,225
635143353,635140782,635157193,16411,4903,225
635164114,635161326,635179241,17915,4904,225
635186162,635183374,635200972,17598,4905,225
635207775,635205203,635222585,17382,4906,225
635229506,635226718,635244972,18254,4907,225
635251894,635249105,635266388,17283,4908,225
635273309,635270521,635286199,15678,4909,225
635293119,635290331,635307296,16965,4910,225
635314110,635311539,635326684,15145,4911,225
635333604,635330816,635346832,16016,4912,225
635353753,635350965,635367615,16650,4913,225
635374536,635371748,635388058,16310,4914,225
635394980,635392191,635409474,17283,4915,225
635416395,635413607,635431206,17599,4916,225
635438128,635435339,635453909,18570,4917,225
635460831,635458042,635475008,16966,4918,225
635481814,635479243,635494072,14829,4919,225
635500993,635498204,635513883,15679,4920,225
635520804,635518016,635534960,16944,4921,225
635541882,635539093,635556693,17600,4922,225
635563614,635560826,635578446,17620,4923,225
635585258,635582687,635600385,17698,4924,225
635607307,635604518,635621485,16967,4925,225
635628406,635625618,635644505,18887,4926,225
635651426,635648638,635666890,18252,4927,225
635673812,635671023,635686702,15679,4928,225
635693624,635690835,635707168,16333,4929,225
635714090,635711301,635726368,15067,4930,225
635733289,635730500,635746179,15679,4931,225
635753100,635750311,635765672,15361,4932,225
635772593,635769804,635788375,18571,4933,225
635795296,635792508,635808820,16312,4934,225
635815625,635813054,635829149,16095,4935,225
635836070,635833282,635849930,16648,4936,225
635856851,635854063,635870395,16332,4937,225
635877212,635874642,635889786,15144,4938,225
635896706,635893918,635910229,16311,4939,225
635917150,635914362,635931960,17598,4940,225
635938882,635936093,635951454,15361,4941,225
635958374,635955586,635972550,16964,4942,225
635979471,635976683,635993331,16648,4943,225
636000252,635997464,636014111,16647,4944,225
636021031,636018244,636036179,17935,4945,225
636043101,636040312,636055042,14730,4946,225
636061858,636059287,636076647,17360,4947,225
636083568,636080780,636097430,16650,4948,225
636104351,636101563,636116291,14728,4949,225
636123212,636120423,636136756,16333,4950,225
636143580,636141008,636156787,15779,4951,225
636163708,636160919,636176281,15362,4952,225
636183201,636180413,636197061,16648,4953,225
636203983,636201194,636218159,16965,4954,225
636225081,636222292,636237970,15678,4955,225
636244890,636242102,636260332,18230,4956,225
636267254,636264465,636281115,16650,4957,225
636288036,636285248,636301559,16311,4958,225
636308480,636305692,636322975,17283,4959,225
636329794,636327224,636343318,16094,4960,225
636350132,636347561,636363677,16116,4961,225
636370598,636367810,636386062,18252,4962,225
636392881,636390309,636407376,17067,4963,225
636414297,636411509,636427186,15677,4964,225
636434106,636431318,636446995,15677,4965,225
636453917,636451128,636466808,15680,4966,225
636473728,636470940,636486935,15995,4967,225
636493857,636491068,636506431,15363,4968,225
636513352,636510564,636528797,18233,4969,225
636535618,636533047,636548846,15799,4970,225
636555767,636552978,636568024,15046,4971,225
636574945,636572156,636589439,17283,4972,225
636596360,636593572,636609884,16312,4973,225
636616708,636614136,636630886,16750,4974,225
636637807,636635019,636651985,16966,4975,225
636658907,636656118,636672113,15995,4976,225
636679033,636676245,636692578,16333,4977,225
636699404,636696832,636712632,15800,4978,225
636719553,636716765,636732443,15678,4979,225
636739365,636736576,636755146,18570,4980,225
636762068,636759279,636775591,16312,4981,225
636782512,636779724,636798294,18570,4982,225
636805217,636802427,636820028,17601,4983,225
636826841,636824269,636840364,16095,4984,225
636847285,636844497,636859859,15362,4985,225
636866779,636863991,636881907,17916,4986,225
636888831,636886041,636903326,17285,4987,225
636910247,636907459,636923452,15993,4988,225
636930375,636927585,636944868,17283,4989,225
636951789,636949001,636964996,15995,4990,225
636971917,636969128,636986728,17600,4991,225
636993556,636990984,637006782,15798,4992,225
637013702,637010915,637027880,16965,4993,225
637034802,637032013,637047692,15679,4994,225
637054613,637051824,637067819,15995,4995,225
637074739,637071951,637090837,18886,4996,225
637097758,637094970,637111936,16966,4997,225
637118858,637116069,637133035,16966,4998,225
637139855,637137283,637154033,16750,4999,225
637160859,637158288,637175035,16747,5000,225
637182113,637179168,637195717,16549,1,250
637202526,637199581,637217101,17520,2,250
637223909,637220964,637238167,17203,3,250
637244758,637242030,637260499,18469,4,250
637267309,637264363,637282834,18471,5,250
637289644,637286698,637304851,18153,6,250
637311660,637308714,637323998,15284,7,250
637330807,637327861,637344727,16866,8,250
637351536,637348590,637364190,15600,9,250
637370998,637368053,637385257,17204,10,250
637392155,637389209,637405443,16234,11,250
637412339,637409395,637426598,17203,12,250
637433279,637430550,637449359,18809,13,250
637456256,637453311,637471127,17816,14,250
637478024,637475079,637491944,16865,15,250
637498843,637495896,637514706,18810,16,250
637521604,637518658,637535840,17182,17,250
637542736,637539792,637557311,17519,18,250
637564209,637561263,637579417,18154,19,250
637586314,637583369,637599918,16549,20,250
637606815,637603871,637621052,17181,21,250
637627950,637625004,637644129,19125,22,250
637651028,637648082,637663048,14966,23,250
637669945,637667000,637684498,17498,24,250
637691396,637688450,637705633,17183,25,250
637712532,637709586,637728057,18471,26,250
637734739,637732010,637749509,17499,27,250
637756408,637753462,637771617,18155,28,250
637778516,637775570,637794041,18471,29,250
637800939,637797994,637816464,18470,30,250
637823362,637820417,637837620,17203,31,250
637844518,637841572,637858121,16549,32,250
637865020,637862074,637878623,16549,33,250
637885522,637882576,637901700,19124,34,250
637908599,637905653,637923153,17500,35,250
637930051,637927106,637944605,17499,36,250
637951504,637948558,637964158,15600,37,250
637971057,637968110,637985948,17838,38,250
637992846,637989901,638006133,16232,39,250
638013031,638010086,638027606,17520,40,250
638034505,638031559,638050366,18807,41,250
638057264,638054319,638071501,17182,42,250
638078399,638075454,638093291,17837,43,250
638100190,638097244,638114426,17182,44,250
638121326,638118379,638135562,17183,45,250
638142460,638139515,638157035,17520,46,250
638163935,638160988,638177539,16551,47,250
638184438,638181492,638198042,16550,48,250
638204941,638201995,638218229,16234,49,250
638225126,638222182,638239385,17203,50,250
638246283,638243338,638259571,16233,51,250
638266469,638263524,638281043,17519,52,250
638287941,638284996,638300911,15915,53,250
638307808,638304863,638322067,17204,54,250
638328965,638326020,638343856,17836,55,250
638350755,638347809,638364676,16867,56,250
638371357,638368629,638385831,17202,57,250
638392729,638389784,638406965,17181,58,250
638413864,638410918,638427469,16551,59,250
638434367,638431422,638447991,16569,60,250
638454889,638451944,638469148,17204,61,250
638476048,638473101,638489674,16573,62,250
638496572,638493627,638510176,16549,63,250
638517075,638514129,638530363,16234,64,250
638537261,638534316,638551837,17521,65,250
638558735,638555790,638571388,15598,66,250
638578286,638575340,638591891,16551,67,250
638598789,638595844,638613363,17519,68,250
638620261,638617316,638634520,17204,69,250
638641419,638638473,638655339,16866,70,250
638662237,638659292,638675525,16233,71,250
638682424,638679478,638695712,16234,72,250
638702610,638699665,638717501,17836,73,250
638724399,638721454,638738658,17204,74,250
638745557,638742611,638758527,15916,75,250
638765424,638762479,638780632,18153,76,250
638787530,638784585,638803054,18469,77,250
638809736,638807007,638824526,17519,78,250
638831425,638828479,638846949,18470,79,250
638853847,638850902,638866502,15600,80,250
638873399,638870454,638888268,17814,81,250
638894950,638892221,638910374,18153,82,250
638917272,638914327,638931530,17203,83,250
638938428,638935483,638952348,16865,84,250
638959247,638956301,638972218,15917,85,250
638979115,638976171,638992739,16568,86,250
638999638,638996691,639014507,17816,87,250
639021406,639018459,639034693,16234,88,250
639041591,639038646,639056482,17836,89,250
639063380,639060435,639076983,16548,90,250
639083881,639080936,639100058,19122,91,250
639106956,639104011,639120560,16549,92,250
639127459,639124513,639140747,16234,93,250
639147428,639144700,639161566,16866,94,250
639168465,639165518,639182406,16888,95,250
639189303,639186358,639202274,15916,96,250
639209172,639206226,639223747,17521,97,250
639230646,639227700,639245221,17521,98,250
639252120,639249174,639265745,16571,99,250
639272427,639269698,639287850,18152,100,250
639294837,639291891,639307174,15283,101,250
639314161,639311215,639326183,14968,102,250
639333168,639330224,639346771,16547,103,250
639353757,639350813,639367678,16865,104,250
639374665,639371720,639388585,16865,105,250
639395571,639392626,639408542,15916,106,250
639415312,639412583,639430736,18153,107,250
639437723,639434778,639451644,16866,108,250
639458630,639455685,639471918,16233,109,250
639478905,639475960,639493142,17182,110,250
639499913,639497184,639515021,17837,111,250
639522008,639519063,639535611,16548,112,250
639542598,639539653,639558143,18490,113,250
639565131,639562185,639577152,14967,114,250
639584139,639581193,639599346,18153,115,250
639606333,639603388,639619621,16233,116,250
639626609,639623663,639641817,18154,117,250
639648805,639645859,639663380,17521,118,250
639670366,639667421,639684625,17204,119,250
639691612,639688667,639705532,16865,120,250
639712518,639709573,639725173,15600,121,250
639732160,639729214,639748021,18807,122,250
639755006,639752062,639767027,14965,123,250
639774015,639771068,639787934,16866,124,250
639794922,639791976,639810130,18154,125,250
639816900,639814172,639831037,16865,126,250
639838024,639835079,639851628,16549,127,250
639858616,639855670,639872557,16887,128,250
639879544,639876598,639893149,16551,129,250
639900135,639897190,639915343,18153,130,250
639922331,639919385,639935301,15916,131,250
639942288,639939342,639957495,18153,132,250
639964483,639961537,639979691,18154,133,250
639986679,639983733,640001571,17838,134,250
640008557,640005612,640022161,16549,135,250
640029148,640026201,640045325,19124,136,250
640052311,640049366,640068173,18807,137,250
640075158,640072214,640088444,16230,138,250
640095431,640092485,640111608,19123,139,250
640118594,640115649,640132535,16886,140,250
640139521,640136576,640154075,17499,141,250
640161062,640158116,640174350,16234,142,250
640181119,640178391,640197197,18806,143,250
640204183,640201238,640218736,17498,144,250
640225505,640222777,640240613,17836,145,250
640247600,640244654,640260885,16231,146,250
640267873,640264926,640281160,16234,147,250
640288147,640285201,640303671,18470,148,250
640310659,640307712,640325212,17500,149,250
640331982,640329253,640345170,15917,150,250
640352155,640349210,640366391,17181,151,250
640373378,640370432,640387951,17519,152,250
640394937,640391992,640409196,17204,153,250
640416183,640413237,640430103,16866,154,250
640437089,640434144,640449744,15600,155,250
640456729,640453784,640472254,18470,156,250
640479240,640476295,640494763,18468,157,250
640501750,640498804,640515353,16549,158,250
640522338,640519394,640537230,17836,159,250
640544217,640541271,640558791,17520,160,250
640565779,640562833,640581641,18808,161,250
640588629,640585683,640602886,17203,162,250
640609873,640606928,640623160,16232,163,250
640630149,640627202,640643120,15918,164,250
640650106,640647161,640663076,15915,165,250
640669845,640667117,640685249,18132,166,250
640692238,640689291,640708417,19126,167,250
640715187,640712459,640728057,15598,168,250
640735043,640732098,640749934,17836,169,250
640756922,640753976,640770525,16549,170,250
640777512,640774566,640793036,18470,171,250
640800023,640797077,640816200,19123,172,250
640823188,640820242,640838057,17815,173,250
640845045,640842099,640858986,16887,174,250
640865974,640863028,640878945,15917,175,250
640885931,640882986,640900823,17837,176,250
640907810,640904865,640923018,18153,177,250
640930006,640927060,640944895,17835,178,250
640951882,640948937,640965169,16232,179,250
640972156,640969210,640985760,16550,180,250
640992747,640989801,641008270,18469,181,250
641015259,641012312,641029201,16889,182,250
641036188,641033242,641051375,18133,183,250
641058362,641055416,641074223,18807,184,250
641081211,641078265,641096418,18153,185,250
641103405,641100460,641118612,18152,186,250
641125600,641122654,641139857,17203,187,250
641146844,641143899,641161101,17202,188,250
641168089,641165143,641180743,15600,189,250
641187513,641184784,641202282,17498,190,250
641209269,641206324,641222894,16570,191,250
641229665,641226936,641244773,17837,192,250
641251760,641248815,641266018,17203,193,250
641273005,641270060,641287874,17814,194,250
641294859,641291915,641309413,17498,195,250
641316400,641313455,641330004,16549,196,250
641336992,641334046,641350595,16549,197,250
641357582,641354637,641372767,18130,198,250
641379754,641376809,641393992,17183,199,250
641400978,641398033,641417156,19123,200,250
641424144,641421198,641437431,16233,201,250
641444418,641441473,641459310,17837,202,250
641466080,641463352,641482159,18807,203,250
641489147,641486201,641504038,17837,204,250
641511024,641508080,641524312,16232,205,250
641531084,641528354,641546171,17817,206,250
641553158,641550213,641568682,18469,207,250
641575670,641572724,641591511,18787,208,250
641598498,641595553,641614992,19439,209,250
641621979,641619034,641638474,19440,210,250
641645245,641642516,641660351,17835,211,250
641667338,641664393,641682207,17814,212,250
641689195,641686249,641702799,16550,213,250
641709786,641706841,641725310,18469,214,250
641732298,641729353,641748476,19123,215,250
641755465,641752519,641768435,15916,216,250
641775422,641772477,641789026,16549,217,250
641796014,641793068,641810905,17837,218,250
641817893,641814947,641831813,16866,219,250
641838801,641835856,641854324,18468,220,250
641861097,641858367,641882082,23715,221,250
641889071,641886125,641903646,17521,222,250
641910634,641907689,641923604,15915,223,250
641930592,641927646,641943878,16232,224,250
641950866,641947920,641964786,16866,225,250
641971556,641968828,641985060,16232,226,250
641991830,641989102,642007572,18470,227,250
642014559,642011614,642029111,17497,228,250
642036098,642033153,642049068,15915,229,250
642055838,642053109,642068710,15601,230,250
642075481,642072752,642089302,16550,231,250
642096289,642093344,642110230,16886,232,250
642117217,642114272,642131138,16866,233,250
642138126,642135181,642152046,16865,234,250
642159033,642156088,642172954,16866,235,250
642179725,642176996,642193861,16865,236,250
642200633,642197903,642213504,15601,237,250
642220492,642217546,642235066,17520,238,250
642242053,642239108,642256606,17498,239,250
642263594,642260648,642277515,16867,240,250
642284502,642281557,642298422,16865,241,250
642305410,642302464,642319351,16887,242,250
642326122,642323393,642342833,19440,243,250
642349821,642346875,642363423,16548,244,250
642370410,642367465,642383063,15598,245,250
642390050,642387105,642402703,15598,246,250
642409689,642406744,642422344,15600,247,250
642429332,642426385,642441986,15601,248,250
642448972,642446027,642464158,18131,249,250
642470928,642468200,642485403,17203,250,250
642492391,642489445,642506629,17184,251,250
642513400,642510671,642527538,16867,252,250
642534526,642531580,642548446,16866,253,250
642555434,642552488,642569037,16549,254,250
642576024,642573079,642589966,16887,255,250
642596953,642594008,642611190,17182,256,250
642618178,642615232,642633067,17835,257,250
642640055,642637109,642653342,16233,258,250
642660331,642657384,642674252,16868,259,250
642681239,642678294,642696764,18470,260,250
642703751,642700806,642715771,14965,261,250
642722759,642719812,642736046,16234,262,250
642743033,642740088,642756953,16865,263,250
642763941,642760995,642780119,19124,264,250
642787107,642784161,642801661,17500,265,250
642808648,642805703,642824489,18786,266,250
642831478,642828532,642846053,17521,267,250
642853040,642850095,642865694,15599,268,250
642872680,642869736,642885651,15915,269,250
642892421,642889692,642906875,17183,270,250
642913647,642910917,642928734,17817,271,250
642935722,642932776,642948376,15600,272,250
642955364,642952417,642968019,15602,273,250
642975005,642972060,642990191,18131,274,250
642997178,642994233,643011437,17204,275,250
643018424,643015479,643030761,15282,276,250
643037748,643034803,643052957,18154,277,250
643059946,643057000,643073233,16233,278,250
643080004,643077275,643096082,18807,279,250
643103070,643100124,643117960,17836,280,250
643124948,643122002,643140155,18153,281,250
643146926,643144197,643160745,16548,282,250
643167515,643164787,643180702,15915,283,250
643187690,643184744,643201949,17205,284,250
643208719,643205991,643223173,17182,285,250
643230161,643227215,643243132,15917,286,250
643250118,643247173,643265009,17836,287,250
643271995,643269051,643286886,17835,288,250
643293875,643290928,643307817,16889,289,250
643314805,643311859,643330328,18469,290,250
643337316,643334370,643351869,17499,291,250
643358857,643355911,643373749,17838,292,250
643380520,643377791,643395312,17521,293,250
643402300,643399354,643414637,15283,294,250
643421624,643418679,643437803,19124,295,250
643444790,643441845,643459682,17837,296,250
643466453,643463724,643479956,16232,297,250
643486943,643483998,643501833,17835,298,250
643508607,643505876,643524031,18155,299,250
643530801,643528073,643545254,17181,300,250
643552242,643549296,643566161,16865,301,250
643573148,643570203,643587701,17498,302,250
643594689,643591743,643608293,16550,303,250
643615280,643612335,643629201,16866,304,250
643636190,643633243,643649476,16233,305,250
643656464,643653518,643672326,18808,306,250
643679313,643676368,643694522,18154,307,250
643701510,643698564,643716402,17838,308,250
643723389,643720444,643736677,16233,309,250
643743666,643740720,643759844,19124,310,250
643766832,643763887,643780773,16886,311,250
643787762,643784816,643801367,16551,312,250
643808139,643805409,643821327,15918,313,250
643828315,643825369,643842889,17520,314,250
643849877,643846931,643865401,18470,315,250
643872389,643869443,643885993,16550,316,250
643892765,643890035,643907556,17521,317,250
643914543,643911598,643929118,17520,318,250
643936106,643933160,643950680,17520,319,250
643957667,643954722,643971269,16547,320,250
643978256,643975311,643992175,16864,321,250
643999163,643996217,644012768,16551,322,250
644019756,644016810,644034648,17838,323,250
644041636,644038690,644056528,17838,324,250
644063299,644060570,644075853,15283,325,250
644082840,644079894,644097078,17184,326,250
644104067,644101120,644118008,16888,327,250
644124996,644122050,644139571,17521,328,250
644146560,644143613,644161431,17818,329,250
644168419,644165473,644181390,15917,330,250
644188377,644185432,644202297,16865,331,250
644209286,644206339,644223543,17204,332,250
644230530,644227585,644244134,16549,333,250
644251122,644248176,644266329,18153,334,250
644273318,644270372,644288209,17837,335,250
644295197,644292252,644310405,18153,336,250
644317393,644314447,644330364,15917,337,250
644337351,644334406,644350954,16548,338,250
644357941,644354996,644373487,18491,339,250
644380258,644377529,644395683,18154,340,250
644402670,644399725,644416927,17202,341,250
644423698,644420969,644436568,15599,342,250
644443555,644440610,644459417,18807,343,250
644466404,644463459,644480324,16865,344,250
644487311,644484366,644500915,16549,345,250
644507904,644504958,644522163,17205,346,250
644529151,644526205,644544042,17837,347,250
644551031,644548085,644565921,17836,348,250
644572908,644569963,644588771,18808,349,250
644595758,644592813,644609362,16549,350,250
644616350,644613404,644630608,17204,351,250
644637596,644634650,644652486,17836,352,250
644659474,644656528,644672444,15916,353,250
644679215,644676486,644693691,17205,354,250
644700679,644697734,644713967,16233,355,250
644720954,644718009,644734895,16886,356,250
644741884,644738938,644757409,18471,357,250
644764179,644761451,644777365,15914,358,250
644784352,644781407,644798272,16865,359,250
644805044,644802315,644818865,16550,360,250
644825852,644822907,644840089,17182,361,250
644847076,644844131,644862937,18806,362,250
644869924,644866979,644881945,14966,363,250
644888932,644885987,644903506,17519,364,250
644910494,644907548,644925068,17520,365,250
644932055,644929110,644946946,17836,366,250
644953933,644950988,644969141,18153,367,250
644976130,644973183,644991675,18492,368,250
644998663,644995717,645012267,16550,369,250
645019253,645016309,645033827,17518,370,250
645040814,645037869,645055389,17520,371,250
645062377,645059431,645077266,17835,372,250
645084255,645081308,645099800,18492,373,250
645106788,645103843,645121046,17203,374,250
645128034,645125088,645142924,17836,375,250
645149911,645146966,645162880,15914,376,250
645169867,645166921,645184442,17521,377,250
645191213,645188484,645205983,17499,378,250
645212970,645210025,645226888,16863,379,250
645233876,645230930,645246846,15916,380,250
645253834,645250888,645269041,18153,381,250
645275811,645273083,645290582,17499,382,250
645297570,645294624,645313748,19124,383,250
645320735,645317790,645334994,17204,384,250
645341982,645339037,645356874,17837,385,250
645363863,645360917,645376834,15917,386,250
645383821,645380875,645399028,18153,387,250
645405798,645403070,645418036,14966,388,250
645425023,645422078,645438627,16549,389,250
645445616,645442670,645460191,17521,390,250
645466962,645464233,645481416,17183,391,250
645488186,645485458,645503611,18153,392,250
645510599,645507654,645526144,18490,393,250
645533132,645530186,645547685,17499,394,250
645554672,645551727,645569880,18153,395,250
645576867,645573922,645591758,17836,396,250
645598747,645595800,645613006,17206,397,250
645619994,645617049,645635834,18785,398,250
645642822,645639876,645656109,16233,399,250
645663096,645660151,645676701,16550,400,250
645683689,645680743,645699213,18470,401,250
645706200,645703255,645719487,16232,402,250
645726474,645723529,645740078,16549,403,250
645747065,645744120,645761957,17837,404,250
645768945,645765999,645782864,16865,405,250
645789852,645786907,645806030,19123,406,250
645813018,645810073,645827256,17183,407,250
645834244,645831298,645846897,15599,408,250
645853884,645850939,645867824,16885,409,250
645874594,645871866,645889702,17836,410,250
645896688,645893744,645910945,17201,411,250
645917932,645914987,645933457,18470,412,250
645940445,645937500,645955652,18152,413,250
645962639,645959694,645974977,15283,414,250
645981964,645979018,645994935,15917,415,250
646001923,645998977,646014261,15284,416,250
646021249,646018303,646037109,18806,417,250
646044096,646041151,646058987,17836,418,250
646065976,646063030,646080530,17500,419,250
646087518,646084572,646101459,16887,420,250
646108446,646105501,646121101,15600,421,250
646128088,646125143,646141693,16550,422,250
646148464,646145736,646163256,17520,423,250
646170243,646167298,646185766,18468,424,250
646192754,646189809,646207962,18153,425,250
646214950,646212004,646229525,17521,426,250
646236514,646233568,646249800,16232,427,250
646256787,646253842,646270391,16549,428,250
646277380,646274434,646291955,17521,429,250
646298943,646295997,646312548,16551,430,250
646319535,646316590,646333793,17203,431,250
646340783,646337836,646355357,17521,432,250
646362345,646359399,646376919,17520,433,250
646383908,646380962,646396878,15916,434,250
646403866,646400920,646418103,17183,435,250
646425091,646422145,646438377,16232,436,250
646445364,646442419,646458018,15599,437,250
646465004,646462059,646480526,18467,438,250
646487514,646484568,646500167,15599,439,250
646507156,646504209,646520760,16551,440,250
646527530,646524802,646541665,16863,441,250
646548435,646545707,646563205,17498,442,250
646570192,646567247,646583479,16232,443,250
646590467,646587521,646605020,17499,444,250
646612007,646609062,646625949,16887,445,250
646632937,646629991,646648461,18470,446,250
646655448,646652503,646669684,17181,447,250
646676672,646673726,646692851,19125,448,250
646699840,646696894,646714414,17520,449,250
646721401,646718457,646735955,17498,450,250
646742944,646739997,646757203,17206,451,250
646763975,646761246,646778766,17520,452,250
646785753,646782808,646800328,17520,453,250
646807317,646804371,646822208,17837,454,250
646829196,646826251,646841850,15599,455,250
646848837,646845891,646863074,17183,456,250
646870063,646867117,646884617,17500,457,250
646891605,646888659,646905546,16887,458,250
646912534,646909589,646926138,16549,459,250
646933126,646930181,646945146,14965,460,250
646952134,646949188,646964787,15599,461,250
646971774,646968829,646984112,15283,462,250
646991101,646988154,647004389,16235,463,250
647011376,647008431,647024347,15916,464,250
647031334,647028389,647046859,18470,465,250
647053846,647050901,647068738,17837,466,250
647075725,647072780,647088695,15915,467,250
647095682,647092737,647108970,16233,468,250
647115960,647113013,647129880,16867,469,250
647136868,647133923,647151443,17520,470,250
647158432,647155486,647171403,15917,471,250
647178391,647175445,647194231,18786,472,250
647201219,647198273,647216110,17837,473,250
647223097,647220152,647237037,16885,474,250
647244025,647241079,647258895,17816,475,250
647265883,647262937,647280774,17837,476,250
647287761,647284816,647302969,18153,477,250
647309956,647307011,647322294,15283,478,250
647329281,647326336,647341301,14965,479,250
647348072,647345343,647361913,16570,480,250
647368901,647365955,647382526,16571,481,250
647389515,647386568,647403119,16551,482,250
647410106,647407161,647425947,18786,483,250
647432935,647429990,647447826,17836,484,250
647454815,647451869,647467785,15916,485,250
647474555,647471827,647487110,15283,486,250
647494096,647491152,647507700,16548,487,250
647514470,647511742,647530212,18470,488,250
647536983,647534254,647550486,16232,489,250
647557474,647554528,647572682,18154,490,250
647579669,647576724,647594877,18153,491,250
647601865,647598920,647614201,15281,492,250
647621190,647618243,647635764,17521,493,250
647642752,647639806,647657325,17519,494,250
647664313,647661367,647678888,17521,495,250
647685875,647682930,647701400,18470,496,250
647708387,647705442,647722306,16864,497,250
647729293,647726348,647742581,16233,498,250
647749570,647746623,647766065,19442,499,250
647773053,647770107,647787607,17500,500,250
647794596,647791650,647808200,16550,501,250
647815189,647812243,647829425,17182,502,250
647836196,647833467,647849383,15916,503,250
647856370,647853424,647871577,18153,504,250
647878565,647875620,647893140,17520,505,250
647900128,647897182,647912466,15284,506,250
647919452,647916507,647932740,16233,507,250
647939728,647936783,647952698,15915,508,250
647959685,647956740,647974260,17520,509,250
647981247,647978302,647994217,15915,510,250
648000987,647998258,648016411,18153,511,250
648023398,648020453,648038289,17836,512,250
648045276,648042331,648061137,18806,513,250
648067908,648065179,648082383,17204,514,250
648089371,648086425,648102658,16233,515,250
648109646,648106700,648122299,15599,516,250
648129288,648126341,648142574,16233,517,250
648149562,648146617,648162847,16230,518,250
648169835,648166890,648181856,14966,519,250
648188843,648185898,648203418,17520,520,250
648210405,648207460,648224959,17499,521,250
648231947,648229002,648245235,16233,522,250
648252223,648249277,648266461,17184,523,250
648273448,648270503,648287705,17202,524,250
648294694,648291748,648308951,17203,525,250
648315939,648312993,648331464,18471,526,250
648338452,648335507,648352372,16865,527,250
648359144,648356415,648372015,15600,528,250
648379001,648376056,648393890,17834,529,250
648400879,648397933,648416066,18133,530,250
648423053,648420108,648438894,18786,531,250
648445881,648442936,648460772,17836,532,250
648467759,648464814,648481046,16232,533,250
648488034,648485088,648504212,19124,534,250
648511200,648508255,648526408,18153,535,250
648533396,648530450,648547315,16865,536,250
648554305,648551358,648569176,17818,537,250
648576164,648573219,648589134,15915,538,250
648596121,648593176,648611666,18490,539,250
648618655,648615709,648634517,18808,540,250
648641504,648638559,648653842,15283,541,250
648660829,648657884,648675402,17518,542,250
648682390,648679444,648697914,18470,543,250
648704904,648701957,648720744,18787,544,250
648727732,648724787,648743910,19123,545,250
648750681,648747953,648766106,18153,546,250
648773094,648770149,648786065,15916,547,250
648793052,648790107,648806657,16550,548,250
648813645,648810700,648827249,16549,549,250
648834238,648831292,648850101,18809,550,250
648856871,648854143,648872610,18467,551,250
648879597,648876652,648892252,15600,552,250
648899239,648896294,648913179,16885,553,250
648920167,648917222,648935059,17837,554,250
648941831,648939102,648958227,19125,555,250
648964999,648962270,648979135,16865,556,250
648986123,648983177,648998776,15599,557,250
649005763,649002818,649019368,16550,558,250
649026357,649023410,649040593,17183,559,250
649047581,649044636,649060866,16230,560,250
649067853,649064908,649082427,17519,561,250
649089415,649086470,649103673,17203,562,250
649110660,649107715,649125869,18154,563,250
649132856,649129911,649147431,17520,564,250
649154419,649151473,649168677,17204,565,250
649175666,649172720,649188320,15600,566,250
649195307,649192362,649209545,17183,567,250
649216316,649213588,649232712,19124,568,250
649239483,649236754,649254253,17499,569,250
649261240,649258295,649277082,18787,570,250
649284069,649281124,649298623,17499,571,250
649305611,649302666,649318899,16233,572,250
649325888,649322941,649340441,17500,573,250
649347428,649344483,649361052,16569,574,250
649368040,649365094,649382614,17520,575,250
649389602,649386656,649404176,17520,576,250
649410948,649408219,649426057,17838,577,250
649433045,649430100,649447282,17182,578,250
649454270,649451325,649468528,17203,579,250
649475517,649472571,649490409,17838,580,250
649497396,649494451,649511315,16864,581,250
649518303,649515357,649534145,18788,582,250
649541133,649538188,649556341,18153,583,250
649563328,649560383,649578537,18154,584,250
649585525,649582579,649599151,16572,585,250
649605921,649603193,649620080,16887,586,250
649627068,649624122,649641009,16887,587,250
649647997,649645051,649661916,16865,588,250
649668904,649665958,649683142,17184,589,250
649690130,649687184,649704051,16867,590,250
649711038,649708093,649724326,16233,591,250
649731314,649728368,649746859,18491,592,250
649753847,649750901,649768421,17520,593,250
649775191,649772463,649790615,18152,594,250
649797603,649794658,649811840,17182,595,250
649818827,649815882,649831164,15282,596,250
649838151,649835206,649852072,16866,597,250
649859061,649856115,649872032,15917,598,250
649879017,649876073,649893591,17518,599,250
649900579,649897633,649912917,15284,600,250
649919904,649916959,649935766,18807,601,250
649942755,649939809,649957646,17837,602,250
649964635,649961689,649976972,15283,603,250
649983959,649981014,649998534,17520,604,250
650005523,650002577,650018177,15600,605,250
650025166,650022219,650040710,18491,606,250
650047699,650044753,650062907,18154,607,250
650069896,650066950,650083501,16551,608,250
650090490,650087544,650103777,16233,609,250
650110764,650107819,650125023,17204,610,250
650132012,650129066,650144667,15601,611,250
650151654,650148709,650166545,17836,612,250
650173534,650170588,650188742,18154,613,250
650195730,650192785,650210621,17836,614,250
650217609,650214664,650232163,17499,615,250
650239151,650236206,650254043,17837,616,250
650261031,650258085,650274317,16232,617,250
650281304,650278359,650295856,17497,618,250
650302627,650299898,650316448,16550,619,250
650323435,650320490,650338326,17836,620,250
650345313,650342368,650361490,19122,621,250
650368478,650365533,650383369,17836,622,250
650390358,650387412,650405249,17837,623,250
650412238,650409292,650425843,16551,624,250
650432614,650429885,650447383,17498,625,250
650454370,650451425,650468608,17183,626,250
650475596,650472650,650491774,19124,627,250
650498544,650495816,650512364,16548,628,250
650519136,650516406,650531374,14968,629,250
650538360,650535415,650551964,16549,630,250
650558735,650556006,650574159,18153,631,250
650581146,650578201,650594749,16548,632,250
650601738,650598792,650615024,16232,633,250
650622013,650619067,650636904,17837,634,250
650643891,650640946,650658464,17518,635,250
650665452,650662507,650679056,16549,636,250
650686043,650683098,650700911,17813,637,250
650707899,650704953,650722157,17204,638,250
650729145,650726200,650742433,16233,639,250
650749421,650746475,650763025,16550,640,250
650770012,650767067,650785558,18491,641,250
650792546,650789600,650806150,16550,642,250
650813138,650810193,650827397,17204,643,250
650834384,650831439,650848643,17204,644,250
650855630,650852685,650871153,18468,645,250
650878141,650875196,650891428,16232,646,250
650898416,650895470,650912020,16550,647,250
650919008,650916062,650931979,15917,648,250
650938967,650936021,650954175,18154,649,250
650961163,650958218,650974788,16570,650,250
650981775,650978830,650997636,18806,651,250
651004623,651001678,651020147,18469,652,250
651026918,651024189,651040739,16550,653,250
651047727,651044781,651060381,15600,654,250
651067368,651064423,651080339,15916,655,250
651087326,651084380,651101584,17204,656,250
651108571,651105626,651122513,16887,657,250
651129500,651126555,651143737,17182,658,250
651150724,651147779,651162744,14965,659,250
651169732,651166786,651185257,18471,660,250
651192246,651189300,651206167,16867,661,250
651213155,651210210,651227413,17203,662,250
651234401,651231455,651247054,15599,663,250
651254042,651251096,651267646,16550,664,250
651274633,651271688,651289525,17837,665,250
651296513,651293567,651310117,16550,666,250
651317103,651314159,651331993,17834,667,250
651338764,651336036,651351319,15283,668,250
651358306,651355361,651372227,16866,669,250
651379214,651376269,651394105,17836,670,250
651401092,651398147,651415646,17499,671,250
651422633,651419688,651435605,15917,672,250
651442592,651439647,651457483,17836,673,250
651464471,651461525,651477757,16232,674,250
651484745,651481799,651498983,17184,675,250
651505971,651503026,651518941,15915,676,250
651525929,651522983,651539532,16549,677,250
651546520,651543574,651558541,14967,678,250
651565528,651562583,651577866,15283,679,250
651584854,651581908,651602763,20855,680,250
651609535,651606806,651624327,17521,681,250
651631315,651628369,651646186,17817,682,250
651653174,651650229,651667728,17499,683,250
651674716,651671770,651688319,16549,684,250
651695307,651692361,651709543,17182,685,250
651716531,651713585,651732077,18492,686,250
651739064,651736119,651753617,17498,687,250
651760604,651757659,651774207,16548,688,250
651781196,651778250,651796404,18154,689,250
651803393,651800447,651819256,18809,690,250
651826244,651823298,651840818,17520,691,250
651847805,651844860,651861410,16550,692,250
651868181,651865452,651882318,16866,693,250
651889306,651886360,651903543,17183,694,250
651910531,651907585,651924156,16571,695,250
651931144,651928199,651944114,15915,696,250
651951102,651948156,651967596,19440,697,250
651974368,651971639,651988188,16549,698,250
651995176,651992231,652008464,16233,699,250
652015452,652012507,652028423,15916,700,250
652035409,652032465,652049013,16548,701,250
652056000,652053055,652071207,18152,702,250
652078195,652075250,652091819,16569,703,250
652098807,652095862,652113064,17202,704,250
652119836,652117106,652133657,16551,705,250
652140645,652137700,652154586,16886,706,250
652161574,652158628,652175515,16887,707,250
652182502,652179557,652197076,17519,708,250
652204063,652201118,652217984,16866,709,250
652224754,652222026,652237940,15914,710,250
652244711,652241982,652257582,15600,711,250
652264570,652261624,652278827,17203,712,250
652285816,652282870,652299420,16550,713,250
652306409,652303463,652320330,16867,714,250
652327317,652324373,652339970,15597,715,250
652346957,652344012,652361194,17182,716,250
652367966,652365236,652382440,17204,717,250
652389429,652386483,652405292,18809,718,250
652412281,652409335,652427173,17838,719,250
652434162,652431216,652448398,17182,720,250
652455385,652452440,652468989,16549,721,250
652475978,652473032,652490869,17837,722,250
652497858,652494912,652512117,17205,723,250
652519105,652516159,652531759,15600,724,250
652538746,652535801,652551401,15600,725,250
652558387,652555443,652572941,17498,726,250
652579931,652576984,652593852,16868,727,250
652600841,652597895,652616366,18471,728,250
652623137,652620409,652637929,17520,729,250
652644917,652641972,652659490,17518,730,250
652666479,652663533,652680716,17183,731,250
652687703,652684759,652703882,19123,732,250
652710870,652707925,652726394,18469,733,250
652733383,652730437,652748591,18154,734,250
652755581,652752634,652771759,19125,735,250
652778748,652775802,652793324,17522,736,250
652800313,652797367,652813283,15916,737,250
652820270,652817325,652833874,16549,738,250
652840861,652837916,652856724,18808,739,250
652863713,652860767,652876050,15283,740,250
652883039,652880092,652896960,16868,741,250
652903946,652901002,652918203,17201,742,250
652925191,652922245,652939133,16888,743,250
652946120,652943175,652958774,15599,744,250
652965761,652962816,652979997,17181,745,250
652986984,652984039,653001222,17183,746,250
653008208,653005264,653021179,15915,747,250
653028166,653025221,653043690,18469,748,250
653050461,653047733,653065251,17518,749,250
653072023,653069294,653087765,18471,750,250
653094753,653091807,653106774,14967,751,250
653113761,653110816,653128652,17836,752,250
653135423,653132694,653149876,17182,753,250
653156864,653153918,653171437,17519,754,250
653178208,653175479,653194265,18786,755,250
653201254,653198308,653214540,16232,756,250
653221527,653218582,653235469,16887,757,250
653242456,653239511,653257665,18154,758,250
653264653,653261708,653278889,17181,759,250
653285877,653282932,653301402,18470,760,250
653308390,653305445,653322628,17183,761,250
653329617,653326671,653343537,16866,762,250
653350525,653347579,653365733,18154,763,250
653372721,653369776,653386663,16887,764,250
653393651,653390706,653407593,16887,765,250
653414581,653411636,653427235,15599,766,250
653434220,653431276,653446874,15598,767,250
653453862,653450916,653467803,16887,768,250
653474790,653471845,653488710,16865,769,250
653495697,653492752,653510250,17498,770,250
653517020,653514292,653531157,16865,771,250
653538147,653535200,653554008,18808,772,250
653560997,653558050,653575572,17522,773,250
653582561,653579615,653597768,18153,774,250
653604755,653601810,653618041,16231,775,250
653625028,653622083,653640553,18470,776,250
653647541,653644596,653662431,17835,777,250
653669418,653666473,653682706,16233,778,250
653689695,653686749,653705218,18469,779,250
653712207,653709261,653726463,17202,780,250
653733234,653730506,653746737,16231,781,250
653753726,653750780,653767013,16233,782,250
653773783,653771055,653788237,17182,783,250
653795225,653792279,653809463,17184,784,250
653816235,653813506,653829740,16234,785,250
653836730,653833783,653850651,16868,786,250
653857639,653854693,653870927,16234,787,250
653877916,653874970,653892806,17836,788,250
653899579,653896849,653913084,16235,789,250
653919855,653917127,653932409,15282,790,250
653939396,653936451,653954286,17835,791,250
653961274,653958328,653975532,17204,792,250
653982521,653979575,653997729,18154,793,250
654004716,654001772,654018320,16548,794,250
654025308,654022363,654039567,17204,795,250
654046556,654043610,654060814,17204,796,250
654067803,654064857,654082377,17520,797,250
654089366,654086420,654102337,15917,798,250
654109325,654106379,654124195,17816,799,250
654131182,654128237,654146389,18152,800,250
654153378,654150432,654167299,16867,801,250
654174287,654171341,654187890,16549,802,250
654194877,654191932,654210085,18153,803,250
654217073,654214128,654232598,18470,804,250
654239587,654236641,654253191,16550,805,250
654260179,654257234,654275387,18153,806,250
654282375,654279430,654296296,16866,807,250
654303283,654300338,654318808,18470,808,250
654325796,654322851,654340055,17204,809,250
654346828,654344098,654361599,17501,810,250
654368588,654365642,654383479,17837,811,250
654390467,654387522,654405021,17499,812,250
654411791,654409063,654426878,17815,813,250
654433865,654430921,654447152,16231,814,250
654454140,654451195,654468060,16865,815,250
654475047,654472102,654489939,17837,816,250
654496926,654493981,654510867,16886,817,250
654517854,654514909,654533063,18154,818,250
654540051,654537106,654553021,15915,819,250
654560009,654557063,654573929,16866,820,250
654580918,654577972,654593255,15283,821,250
654600244,654597297,654614186,16889,822,250
654621173,654618228,654634778,16550,823,250
654641767,654638821,654656976,18155,824,250
654663963,654661018,654678220,17202,825,250
654685208,654682263,654699128,16865,826,250
654706117,654703171,654719404,16233,827,250
654726392,654723447,654741917,18470,828,250
654748904,654745959,654764449,18490,829,250
654771437,654768492,654785042,16550,830,250
654791814,654789085,654805971,16886,831,250
654812960,654810014,654826880,16866,832,250
654833867,654830923,654847809,16886,833,250
654854798,654851852,654866819,14967,834,250
654873807,654870861,654888064,17203,835,250
654895053,654892107,654910577,18470,836,250
654917566,654914620,654932773,18153,837,250
654939761,654936816,654954652,17836,838,250
654961641,654958695,654976532,17837,839,250
654983304,654980575,654998413,17838,840,250
655005402,655002456,655019322,16866,841,250
655026310,655023365,655038965,15600,842,250
655045952,655043007,655061160,18153,843,250
655068149,655065203,655081754,16551,844,250
655088742,655085797,655103316,17519,845,250
655110304,655107359,655123274,15915,846,250
655130261,655127316,655144815,17499,847,250
655151803,655148858,655165090,16232,848,250
655172080,655169133,655187943,18810,849,250
655194932,655191986,655209507,17521,850,250
655216496,655213550,655229783,16233,851,250
655236773,655233826,655251032,17206,852,250
655258021,655255075,655270359,15284,853,250
655277347,655274401,655291585,17184,854,250
655298357,655295628,655312833,17205,855,250
655319820,655316876,655334712,17836,856,250
655341701,655338755,655354672,15917,857,250
655361660,655358714,655376552,17838,858,250
655383542,655380596,655398116,17520,859,250
655405104,655402159,655418709,16550,860,250
655425698,655422752,655440274,17522,861,250
655447264,655444318,655462472,18154,862,250
655469460,655466515,655482748,16233,863,250
655489737,655486792,655503974,17182,864,250
655510963,655508018,655524906,16888,865,250
655531895,655528949,655546786,17837,866,250
655553775,655550830,655567717,16887,867,250
655574706,655571761,655590252,18491,868,250
655597241,655594295,655611815,17520,869,250
655618804,655615859,655638950,23091,870,250
655645940,655642995,655660199,17204,871,250
655667188,655664243,655683049,18806,872,250
655690039,655687093,655705268,18175,873,250
655712257,655709312,655725228,15916,874,250
655732217,655729271,655745188,15917,875,250
655752176,655749231,655768356,19125,876,250
655775346,655772400,655788317,15917,877,250
655795306,655792360,655808910,16550,878,250
655815898,655812954,655832077,19123,879,250
655839067,655836121,655851722,15601,880,250
655858710,655855765,655873286,17521,881,250
655880276,655877329,655895147,17818,882,250
655902136,655899190,655915740,16550,883,250
655922730,655919784,655935386,15602,884,250
655942375,655939429,655958553,19124,885,250
655965543,655962597,655980751,18154,886,250
655987740,655984795,656000712,15917,887,250
656007701,656004755,656023226,18471,888,250
656030215,656027270,656043186,15916,889,250
656050176,656047229,656065384,18155,890,250
656072373,656069428,656087920,18492,891,250
656094910,656091964,656110772,18808,892,250
656117761,656114816,656132652,17836,893,250
656139641,656136696,656154850,18154,894,250
656161839,656158894,656174493,15599,895,250
656181482,656178536,656196373,17837,896,250
656203364,656200417,656217623,17206,897,250
656224611,656221666,656238216,16550,898,250
656245204,656242260,656259780,17520,899,250
656266769,656263824,656281026,17202,900,250
656288014,656285070,656301934,16864,901,250
656308925,656305978,656323479,17501,902,250
656330469,656327523,656345361,17838,903,250
656352351,656349405,656365322,15917,904,250
656372310,656369365,656384966,15601,905,250
656391954,656389009,656406214,17205,906,250
656413204,656410258,656425860,15602,907,250
656432632,656429903,656447107,17204,908,250
656454096,656451151,656467384,16233,909,250
656474374,656471428,656488949,17521,910,250
656495721,656492993,656510175,17182,911,250
656517165,656514219,656530135,15916,912,250
656537123,656534178,656551044,16866,913,250
656558034,656555088,656571323,16235,914,250
656578313,656575367,656590969,15602,915,250
656597957,656595012,656611877,16865,916,250
656618866,656615921,656634708,18787,917,250
656641697,656638752,656655956,17204,918,250
656662945,656660000,656676866,16866,919,250
656683856,656680910,656697459,16549,920,250
656704450,656701503,656718371,16868,921,250
656725360,656722415,656741539,19124,922,250
656748530,656745583,656762450,16867,923,250
656769225,656766494,656782729,16235,924,250
656789719,656786773,656804928,18155,925,250
656811918,656808972,656824572,15600,926,250
656831560,656828615,656843582,14967,927,250
656850570,656847625,656863542,15917,928,250
656870531,656867585,656883502,15917,929,250
656890491,656887545,656903779,16234,930,250
656910768,656907823,656926948,19125,931,250
656933939,656930992,656947860,16868,932,250
656954849,656951904,656967504,15600,933,250
656974494,656971548,656989070,17522,934,250
656996059,656993114,657010001,16887,935,250
657016991,657014045,657030913,16868,936,250
657037687,657034957,657050875,15918,937,250
657057862,657054918,657072755,17837,938,250
657079745,657076799,657094637,17838,939,250
657101626,657098681,657115547,16866,940,250
657122537,657119591,657136141,16550,941,250
657143131,657140185,657158656,18471,942,250
657165428,657162700,657181190,18490,943,250
657188181,657185234,657202102,16868,944,250
657209091,657206146,657223350,17204,945,250
657230339,657227394,657243628,16234,946,250
657250400,657247672,657266140,18468,947,250
657273130,657270184,657286418,16234,948,250
657293189,657290462,657307643,17181,949,250
657314415,657311687,657327921,16234,950,250
657334911,657331965,657349486,17521,951,250
657356476,657353530,657371051,17521,952,250
657378040,657375095,657391011,15916,953,250
657398000,657395054,657412893,17839,954,250
657419882,657416937,657435745,18808,955,250
657442732,657439788,657456989,17201,956,250
657463762,657461033,657478871,17838,957,250
657485860,657482915,657501069,18154,958,250
657507842,657505113,657523267,18154,959,250
657530040,657527311,657544495,17184,960,250
657551268,657548539,657564140,15601,961,250
657571129,657568183,657583468,15285,962,250
657590456,657587511,657604399,16888,963,250
657611389,657608443,657626597,18154,964,250
657633586,657630641,657646873,16232,965,250
657653862,657650917,657667466,16549,966,250
657674239,657671510,657689664,18154,967,250
657696653,657693708,657712199,18491,968,250
657719189,657716243,657732160,15917,969,250
657739149,657736203,657752437,16234,970,250
657759426,657756481,657772712,16231,971,250
657779700,657776756,657792355,15599,972,250
657799344,657796398,657812630,16232,973,250
657819619,657816674,657834490,17816,974,250
657841479,657838534,657853817,15283,975,250
657860806,657857860,657875382,17522,976,250
657882372,657879426,657895027,15601,977,250
657902016,657899070,657916592,17522,978,250
657923582,657920636,657938790,18154,979,250
657945780,657942834,657959722,16888,980,250
657966495,657963766,657980315,16549,981,250
657987305,657984359,658000276,15917,982,250
658007264,658004319,658022472,18153,983,250
658029460,658026515,658044984,18469,984,250
658051757,658049028,658066866,17838,985,250
658073856,658070910,658088748,17838,986,250
658095739,658092792,658111285,18493,987,250
658118275,658115329,658132851,17522,988,250
658139624,658136895,658154395,17500,989,250
658161384,658158439,658177562,19123,990,250
658184551,658181606,658198494,16888,991,250
658205483,658202538,658220375,17837,992,250
658227364,658224419,658242572,18153,993,250
658249562,658246616,658262218,15602,994,250
658268990,658266261,658283782,17521,995,250
658290772,658287826,658305347,17521,996,250
658312336,658309391,658327544,18153,997,250
658334534,658331588,658348793,17205,998,250
658355782,658352837,658369704,16867,999,250
658376693,658373748,658392534,18786,1000,250
658399612,658396667,658411951,15284,1001,250
658419028,658416083,658431049,14966,1002,250
658438127,658435181,658452385,17204,1003,250
658459247,658456518,658473386,16868,1004,250
658480465,658477518,658494069,16551,1005,250
658501148,658498202,658515703,17501,1006,250
658522564,658519836,658536702,16866,1007,250
658543782,658540835,658557069,16234,1008,250
658564147,658561202,658579039,17837,1009,250
658586117,658583172,658601980,18808,1010,250
658609059,658606113,658622347,16234,1011,250
658629425,658626480,658643052,16572,1012,250
658650130,658647185,658665654,18469,1013,250
658672731,658669786,658688257,18471,1014,250
658695334,658692389,658710859,18470,1015,250
658717937,658714992,658731542,16550,1016,250
658738620,658735675,658752539,16864,1017,250
658759617,658756672,658775480,18808,1018,250
658782559,658779613,658795846,16233,1019,250
658802923,658799979,658816212,16233,1020,250
658823290,658820345,658837211,16866,1021,250
658844288,658841343,658859497,18154,1022,250
658866575,658863630,658878596,14966,1023,250
658885673,658882728,658901536,18808,1024,250
658908397,658905669,658924794,19125,1025,250
658931874,658928927,658946133,17206,1026,250
658953212,658950266,658966500,16234,1027,250
658973363,658970633,658986233,15600,1028,250
658993310,658990365,659006936,16571,1029,250
659014015,659011069,659027304,16235,1030,250
659034381,659031436,659048324,16888,1031,250
659055402,659052457,659071581,19124,1032,250
659078660,659075714,659091949,16235,1033,250
659098812,659096082,659113604,17522,1034,250
659120682,659117737,659133654,15917,1035,250
659140732,659137786,659155287,17501,1036,250
659162366,659159420,659176941,17521,1037,250
659184020,659181074,659199566,18492,1038,250
659206644,659203699,659220903,17204,1039,250
659227981,659225036,659241903,16867,1040,250
659248981,659246036,659264188,18152,1041,250
659271267,659268321,659285524,17203,1042,250
659292602,659289657,659305889,16232,1043,250
659312968,659310022,659328493,18471,1044,250
659335571,659332625,659348226,15601,1045,250
659355305,659352358,659369564,17206,1046,250
659376642,659373697,659391216,17519,1047,250
659398294,659395349,659410948,15599,1048,250
659418025,659415080,659433571,18491,1049,250
659440433,659437704,659456176,18472,1050,250
659463254,659460309,659476225,15916,1051,250
659483303,659480357,659497541,17184,1052,250
659504620,659501674,659517276,15602,1053,250
659524353,659521408,659537325,15917,1054,250
659544402,659541457,659557058,15601,1055,250
659564136,659561190,659577107,15917,1056,250
659584185,659581239,659598125,16886,1057,250
659604987,659602258,659618807,16549,1058,250
659625669,659622940,659640777,17837,1059,250
659647855,659644910,659663064,18154,1060,250
659670144,659667197,659683116,15919,1061,250
659690194,659687248,659702215,14967,1062,250
659709293,659706347,659723868,17521,1063,250
659730947,659728001,659746156,18155,1064,250
659753234,659750289,659765890,15601,1065,250
659772967,659770022,659787522,17500,1066,250
659794601,659791655,659809788,18133,1067,250
659816866,659813921,659830471,16550,1068,250
659837549,659834604,659852758,18154,1069,250
659859836,659856891,659874729,17838,1070,250
659881589,659878862,659897015,18153,1071,250
659904093,659901148,659918646,17498,1072,250
659925724,659922779,659940933,18154,1073,250
659948011,659945066,659962587,17521,1074,250
659969666,659966720,659984241,17521,1075,250
659991319,659988374,660004606,16232,1076,250
660011685,660008739,660027211,18472,1077,250
660034290,660031344,660048549,17205,1078,250
660055627,660052682,660069231,16549,1079,250
660076309,660073364,660091835,18471,1080,250
660098914,660095968,660111568,15600,1081,250
660118646,660115700,660131617,15917,1082,250
660138694,660135749,660154219,18470,1083,250
660161298,660158352,660176844,18492,1084,250
660183923,660180977,660198814,17837,1085,250
660205893,660202947,660220152,17205,1086,250
660227230,660224285,660242438,18153,1087,250
660249301,660246571,660263438,16867,1088,250
660270515,660267571,660284140,16569,1089,250
660291217,660288273,660306405,18132,1090,250
660313484,660310538,660327089,16551,1091,250
660334167,660331222,660348404,17182,1092,250
660355483,660352537,660370353,17816,1093,250
660377215,660374486,660391037,16551,1094,250
660398115,660395170,660412058,16888,1095,250
660419137,660416191,660433713,17522,1096,250
660440791,660437846,660457286,19440,1097,250
660464363,660461419,660478622,17203,1098,250
660485484,660482755,660501248,18493,1099,250
660508327,660505381,660523536,18155,1100,250
660530399,660527669,660545170,17501,1101,250
660552249,660549303,660567141,17838,1102,250
660574219,660571274,660587191,15917,1103,250
660594050,660591323,660608842,17519,1104,250
660615921,660612975,660631447,18472,1105,250
660638525,660635580,660651179,15599,1106,250
660658256,660655311,660672830,17519,1107,250
660679910,660676963,660694802,17839,1108,250
660701881,660698935,660716117,17182,1109,250
660723197,660720250,660737118,16868,1110,250
660744196,660741251,660760375,19124,1111,250
660767453,660764508,660780741,16233,1112,250
660787820,660784874,660802078,17204,1113,250
660809156,660806211,660822127,15916,1114,250
660828987,660826259,660844095,17836,1115,250
660851175,660848228,660866067,17839,1116,250
660873147,660870200,660888671,18471,1117,250
660895749,660892804,660909037,16233,1118,250
660916114,660913170,660930352,17182,1119,250
660937431,660934485,660950720,16235,1120,250
660957799,660954853,660973007,18154,1121,250
660981020,660977140,660997341,20201,1122,250
661004420,661001474,661019312,17838,1123,250
661026173,661023445,661040944,17499,1124,250
661048023,661045077,661063887,18810,1125,250
661070966,661068020,661083938,15918,1126,250
661090798,661088070,661105591,17521,1127,250
661112670,661109724,661127878,18154,1128,250
661134956,661132011,661148581,16570,1129,250
661155660,661152714,661169580,16866,1130,250
661176658,661173712,661191866,18154,1131,250
661198728,661195999,661215124,19125,1132,250
661222202,661219257,661235491,16234,1133,250
661242568,661239623,661258115,18492,1134,250
661265193,661262248,661280740,18492,1135,250
661287818,661284873,661300789,15916,1136,250
661307867,661304921,661322126,17205,1137,250
661328988,661326259,661343443,17184,1138,250
661350306,661347576,661362545,14969,1139,250
661369622,661366677,661382594,15917,1140,250
661389672,661386726,661402010,15284,1141,250
661409088,661406142,661423031,16889,1142,250
661430108,661427164,661443395,16231,1143,250
661450474,661447528,661465683,18155,1144,250
661472761,661469816,661487633,17817,1145,250
661494712,661491766,661509921,18155,1146,250
661516999,661514054,661531553,17499,1147,250
661538632,661535686,661553839,18153,1148,250
661560917,661557972,661575787,17815,1149,250
661582865,661579920,661604742,24822,1150,250
661611822,661608876,661626714,17838,1151,250
661633793,661630847,661647397,16550,1152,250
661654476,661651530,661668418,16888,1153,250
661675497,661672551,661689755,17204,1154,250
661696833,661693888,661710438,16550,1155,250
661717516,661714571,661732409,17838,1156,250
661739488,661736542,661751827,15285,1157,250
661758689,661755959,661772195,16236,1158,250
661779273,661776328,661793531,17203,1159,250
661800610,661797664,661815184,17520,1160,250
661822262,661819317,661837154,17837,1161,250
661844233,661841287,661857860,16573,1162,250
661864938,661861993,661880147,18154,1163,250
661887225,661884280,661901167,16887,1164,250
661908246,661905300,661922822,17522,1165,250
661929901,661926955,661945109,18154,1166,250
661952188,661949242,661968368,19126,1167,250
661975446,661972501,661990655,18154,1168,250
661997734,661994788,662010388,15600,1169,250
662017465,662014520,662030753,16233,1170,250
662037831,662034886,662053356,18470,1171,250
662060218,662057489,662075644,18155,1172,250
662082722,662079777,662095694,15917,1173,250
662102772,662099826,662116692,16866,1174,250
662123770,662120825,662139633,18808,1175,250
662146712,662143765,662160970,17205,1176,250
662168048,662165103,662183573,18470,1177,250
662190652,662187706,662207149,19443,1178,250
662214228,662211282,662228804,17522,1179,250
662235883,662232937,662248538,15601,1180,250
662255399,662252670,662270191,17521,1181,250
662277271,662274324,662292795,18471,1182,250
662299874,662296928,662313796,16868,1183,250
662320874,662317929,662335766,17837,1184,250
662342844,662339899,662357399,17500,1185,250
662364479,662361532,662378738,17206,1186,250
662385817,662382871,662399759,16888,1187,250
662406838,662403892,662420443,16551,1188,250
662427521,662424576,662440177,15601,1189,250
662447254,662444309,662460543,16234,1190,250
662467621,662464676,662481563,16887,1191,250
662488641,662485696,662502561,16865,1192,250
662509641,662506694,662522930,16236,1193,250
662530008,662527063,662543296,16233,1194,250
662550375,662547429,662565268,17839,1195,250
662572347,662569401,662586585,17184,1196,250
662593664,662590718,662608217,17499,1197,250
662615296,662612350,662629239,16889,1198,250
662636318,662633372,662652159,18787,1199,250
662659237,662656292,662674761,18469,1200,250
662681839,662678894,662696098,17204,1201,250
662703176,662700231,662718384,18153,1202,250
662725462,662722517,662739721,17204,1203,250
662746799,662743854,662761689,17835,1204,250
662768550,662765822,662783027,17205,1205,250
662790105,662787160,662805629,18469,1206,250
662812708,662809762,662825996,16234,1207,250
662833074,662830129,662848600,18471,1208,250
662855462,662852733,662872174,19441,1209,250
662879252,662876307,662892223,15916,1210,250
662899300,662896355,662914191,17836,1211,250
662921270,662918324,662934558,16234,1212,250
662941636,662938691,662955557,16866,1213,250
662962418,662959690,662977843,18153,1214,250
662984921,662981976,662997259,15283,1215,250
663004336,663001391,663017625,16234,1216,250
663024704,663021758,663039259,17501,1217,250
663046338,663043392,663060913,17521,1218,250
663067992,663065046,663080964,15918,1219,250
663088041,663085096,663102934,17838,1220,250
663110012,663107067,663125221,18154,1221,250
663132299,663129354,663146537,17183,1222,250
663153616,663150670,663168190,17520,1223,250
663175269,663172323,663190140,17817,1224,250
663197218,663194273,663213060,18787,1225,250
663220140,663217193,663234715,17522,1226,250
663241793,663238848,663256031,17183,1227,250
663263110,663260164,663276082,15918,1228,250
663282943,663280214,663295499,15285,1229,250
663302577,663299631,663316499,16868,1230,250
663323361,663320632,663337499,16867,1231,250
663344578,663341632,663358817,17185,1232,250
663365895,663362950,663380153,17203,1233,250
663387232,663384286,663402124,17838,1234,250
663409204,663406257,663424097,17840,1235,250
663431177,663428230,663444780,16550,1236,250
663451643,663448913,663465802,16889,1237,250
663472881,663469935,663487772,17837,1238,250
663494850,663491905,663509087,17182,1239,250
663516165,663513220,663530720,17500,1240,250
663537799,663534853,663553641,18788,1241,250
663560720,663557774,663574641,16867,1242,250
663581720,663578774,663594690,15916,1243,250
663601769,663598822,663615690,16868,1244,250
663622768,663619823,663637660,17837,1245,250
663644739,663641793,663658977,17184,1246,250
663665840,663663110,663679662,16552,1247,250
663686740,663683795,663700344,16549,1248,250
663707422,663704477,663722609,18132,1249,250
663729688,663726742,663742977,16235,1250,250
663750055,663747110,663764292,17182,1251,250
663771154,663768425,663784659,16234,1252,250
663791738,663788792,663807580,18788,1253,250
663814658,663811713,663828263,16550,1254,250
663835341,663832396,663850233,17837,1255,250
663857311,663854366,663873151,18785,1256,250
663880229,663877284,663894487,17203,1257,250
663901564,663898620,663914536,15916,1258,250
663921613,663918668,663935851,17183,1259,250
663942713,663939984,663954951,14967,1260,250
663962029,663959083,663975001,15918,1261,250
663982078,663979133,663997288,18155,1262,250
664004367,664001421,664018288,16867,1263,250
664025366,664022421,664038971,16550,1264,250
664045832,664043104,664060941,17837,1265,250
664068019,664065074,664082911,17837,1266,250
664089989,664087044,664103931,16887,1267,250
664111009,664108064,664126871,18807,1268,250
664133949,664131004,664149474,18470,1269,250
664156553,664153607,664171444,17837,1270,250
664178521,664175577,664191490,15913,1271,250
664198569,664195623,664211857,16234,1272,250
664218935,664215990,664232222,16232,1273,250
664239301,664236355,664254509,18154,1274,250
664261588,664258642,664276143,17501,1275,250
664283222,664280276,664296827,16551,1276,250
664303905,664300960,664317193,16233,1277,250
664324271,664321326,664338193,16867,1278,250
664345055,664342326,664360162,17836,1279,250
664367241,664364295,664381499,17204,1280,250
664388577,664385632,664400915,15283,1281,250
664407993,664405047,664421936,16889,1282,250
664429014,664426069,664441670,15601,1283,250
664448747,664445802,664464272,18470,1284,250
664471351,664468405,664485589,17184,1285,250
664492668,664489722,664506587,16865,1286,250
664513664,664510720,664527268,16548,1287,250
664534346,664531401,664547952,16551,1288,250
664554814,664552085,664567686,15601,1289,250
664574765,664571818,664587419,15601,1290,250
664594496,664591551,664609367,17816,1291,250
664616445,664613499,664630386,16887,1292,250
664637464,664634519,664653642,19123,1293,250
664660504,664657775,664673692,15917,1294,250
664680769,664677824,664694690,16866,1295,250
664701768,664698823,664717293,18470,1296,250
664724371,664721426,664738630,17204,1297,250
664745709,664742763,664759652,16889,1298,250
664766730,664763785,664780990,17205,1299,250
664788068,664785123,664802306,17183,1300,250
664809384,664806439,664823960,17521,1301,250
664830822,664828093,664843378,15285,1302,250
664850455,664847510,664865348,17838,1303,250
664872426,664869481,664888289,18808,1304,250
664895367,664892422,664910259,17837,1305,250
664917339,664914392,664930309,15917,1306,250
664937387,664934441,664951012,16571,1307,250
664958090,664955145,664973636,18491,1308,250
664980714,664977769,664995923,18154,1309,250
665003001,665000056,665018864,18808,1310,250
665025726,665022997,665040201,17204,1311,250
665047279,665044334,665062171,17837,1312,250
665069250,665066304,665085112,18808,1313,250
665092191,665089245,665105480,16235,1314,250
665112560,665109613,665127451,17838,1315,250
665134529,665131584,665146867,15283,1316,250
665153945,665151000,665167887,16887,1317,250
665174966,665172020,665190492,18472,1318,250
665197572,665194625,665214068,19443,1319,250
665221147,665218201,665234118,15917,1320,250
665241195,665238250,665257038,18788,1321,250
665264116,665261171,665277405,16234,1322,250
665284267,665281538,665300662,19124,1323,250
665307740,665304795,665321997,17202,1324,250
665329077,665326130,665343314,17184,1325,250
665350391,665347447,665364629,17182,1326,250
665371707,665368762,665385966,17204,1327,250
665393045,665390099,665406987,16888,1328,250
665414065,665411120,665429273,18153,1329,250
665436352,665433406,665451245,17839,1330,250
665458322,665455378,665473214,17836,1331,250
665480292,665477347,665494212,16865,1332,250
665501074,665498345,665513945,15600,1333,250
665521023,665518077,665534966,16889,1334,250
665542046,665539100,665556284,17184,1335,250
665563362,665560417,665577305,16888,1336,250
665584384,665581438,665599277,17839,1337,250
665606356,665603410,665619960,16550,1338,250
665627038,665624092,665642564,18472,1339,250
665649641,665646696,665665820,19124,1340,250
665672681,665669953,665688106,18153,1341,250
665694967,665692238,665709760,17522,1342,250
665716840,665713893,665730783,16890,1343,250
665737861,665734916,665753387,18471,1344,250
665760465,665757520,665773436,15916,1345,250
665780513,665777568,665795089,17521,1346,250
665802167,665799222,665814822,15600,1347,250
665821683,665818954,665837762,18808,1348,250
665844841,665841895,665858130,16235,1349,250
665864991,665862263,665881388,19125,1350,250
665888468,665885521,665902071,16550,1351,250
665909150,665906204,665924041,17837,1352,250
665931121,665928174,665945064,16890,1353,250
665952143,665949196,665964798,15602,1354,250
665971875,665968930,665985817,16887,1355,250
665992897,665989950,666005869,15919,1356,250
666012945,666010001,666029124,19123,1357,250
666036204,666033257,666052066,18809,1358,250
666059144,666056199,666074353,18154,1359,250
666081432,666078486,666096324,17838,1360,250
666103403,666100457,666117978,17521,1361,250
666125057,666122110,666140583,18473,1362,250
666147662,666144716,666160631,15915,1363,250
666167491,666164763,666182263,17500,1364,250
666189340,666186395,666202945,16550,1365,250
666210025,666207078,666225233,18155,1366,250
666232312,666229366,666244967,15601,1367,250
666252044,666249099,666267252,18153,1368,250
666274331,666271385,666289222,17837,1369,250
666296300,666293355,666308955,15600,1370,250
666316033,666313087,666330609,17522,1371,250
666337688,666334742,666350975,16233,1372,250
666358052,666355108,666370706,15598,1373,250
666377783,666374838,666393624,18786,1374,250
666400703,666397757,666415574,17817,1375,250
666422435,666419707,666437544,17837,1376,250
666444621,666441676,666458859,17183,1377,250
666465938,666462992,666481146,18154,1378,250
666488225,666485279,666503751,18472,1379,250
666510829,666507884,666525086,17202,1380,250
666532163,666529218,666544818,15600,1381,250
666551895,666548950,666565499,16549,1382,250
666572577,666569632,666587786,18154,1383,250
666594865,666591919,666608151,16232,1384,250
666615229,666612284,666630755,18471,1385,250
666637832,666634888,666650486,15598,1386,250
666657563,666654618,666672138,17520,1387,250
666679217,666676271,666692822,16551,1388,250
666699901,666696955,666715742,18787,1389,250
666722820,666719875,666737690,17815,1390,250
666744768,666741823,666758056,16233,1391,250
666765136,666762189,666778741,16552,1392,250
666785820,666782874,666801345,18471,1393,250
666808423,666805478,666821079,15601,1394,250
666827940,666825211,666842733,17522,1395,250
666849595,666846866,666863099,16233,1396,250
666870179,666867232,666882517,15285,1397,250
666889595,666886649,666904488,17839,1398,250
666911568,666908621,666925806,17185,1399,250
666932668,666929939,666946171,16232,1400,250
666953250,666950304,666967507,17203,1401,250
666974586,666971640,666989795,18155,1402,250
666996873,666993928,667012734,18806,1403,250
667019813,667016867,667035992,19125,1404,250
667043071,667040125,667057309,17184,1405,250
667064387,667061442,667079912,18470,1406,250
667086773,667084045,667099960,15915,1407,250
667107038,667104093,667121298,17205,1408,250
667128160,667125431,667143903,18472,1409,250
667150981,667148036,667165873,17837,1410,250
667172953,667170006,667185292,15286,1411,250
667192370,667189424,667205658,16234,1412,250
667212737,667209791,667226994,17203,1413,250
667234073,667231127,667247360,16233,1414,250
667254438,667251493,667267410,15917,1415,250
667274488,667271542,667288093,16551,1416,250
667295170,667292226,667308141,15915,1417,250
667315218,667312273,667329477,17204,1418,250
667336555,667333610,667350496,16886,1419,250
667357573,667354628,667373752,19124,1420,250
667380831,667377885,667394774,16889,1421,250
667401853,667398907,667416405,17498,1422,250
667423483,667420538,667437088,16550,1423,250
667444166,667441221,667456189,14968,1424,250
667463266,667460321,667476237,15916,1425,250
667483098,667480369,667497869,17500,1426,250
667504947,667502002,667521443,19441,1427,250
667528522,667525576,667541810,16234,1428,250
667548672,667545943,667562832,16889,1429,250
667569910,667566965,667583853,16888,1430,250
667590932,667587986,667605824,17838,1431,250
667612903,667609957,667626507,16550,1432,250
667633585,667630640,667648478,17838,1433,250
667655340,667652611,667669162,16551,1434,250
667676241,667673295,667691132,17837,1435,250
667698210,667695265,667713734,18469,1436,250
667720596,667717867,667735050,17183,1437,250
667742129,667739183,667755099,15916,1438,250
667762177,667759231,667778355,19124,1439,250
667785433,667782488,667799354,16866,1440,250
667806432,667803487,667822926,19439,1441,250
667830004,667827059,667844263,17204,1442,250
667851341,667848396,667863997,15601,1443,250
667871074,667868129,667886621,18492,1444,250
667893699,667890754,667906987,16233,1445,250
667914065,667911120,667928957,17837,1446,250
667935818,667933090,667949640,16550,1447,250
667956719,667953773,667969691,15918,1448,250
667976769,667973823,667990711,16888,1449,250
667997789,667994844,668012363,17519,1450,250
668019440,668016496,668033677,17181,1451,250
668040756,668037810,668053410,15600,1452,250
668060487,668057542,668074724,17182,1453,250
668081803,668078857,668097983,19126,1454,250
668105061,668102116,668118350,16234,1455,250
668125430,668122483,668137452,14969,1456,250
668144530,668141584,668157501,15917,1457,250
668164577,668161633,668177547,15914,1458,250
668184624,668181679,668199200,17521,1459,250
668206277,668203332,668220219,16887,1460,250
668227297,668224352,668242188,17836,1461,250
668249266,668246321,668262238,15917,1462,250
668269099,668266370,668282603,16233,1463,250
668289683,668286736,668304891,18155,1464,250
668311968,668309024,668324940,15916,1465,250
668332019,668329072,668346574,17502,1466,250
668353653,668350707,668369495,18788,1467,250
668376574,668373628,668389863,16235,1468,250
668396941,668393996,668409597,15601,1469,250
668416674,668413729,668432200,18471,1470,250
668439279,668436333,668453833,17500,1471,250
668460912,668457966,668475804,17838,1472,250
668482882,668479937,668497774,17837,1473,250
668504852,668501907,668521030,19123,1474,250
668528110,668525163,668542664,17501,1475,250
668549743,668546797,668563031,16234,1476,250
668570110,668567164,668583397,16233,1477,250
668590476,668587530,668605684,18154,1478,250
668612762,668609817,668627655,17838,1479,250
668634515,668631788,668647386,15598,1480,250
668654464,668651518,668669672,18154,1481,250
668676750,668673805,668691326,17521,1482,250
668698404,668695459,668711376,15917,1483,250
668718453,668715508,668733028,17520,1484,250
668740106,668737161,668754681,17520,1485,250
668761760,668758814,668776334,17520,1486,250
668783413,668780467,668797987,17520,1487,250
668805065,668802120,668819006,16886,1488,250
668825868,668823139,668840661,17522,1489,250
668847739,668844794,668860393,15599,1490,250
668867472,668864526,668881731,17205,1491,250
668888810,668885864,668902098,16234,1492,250
668909176,668906231,668923750,17519,1493,250
668930828,668927883,668945087,17204,1494,250
668952166,668949220,668966404,17184,1495,250
668973483,668970537,668985822,15285,1496,250
668992899,668989954,669008107,18153,1497,250
669015185,669012240,669028788,16548,1498,250
669035866,669032921,669050125,17204,1499,250
669057203,669054258,669069858,15600,1500,250
669076935,669073990,669091510,17520,1501,250
669098588,669095643,669110926,15283,1502,250
669117787,669115058,669131290,16232,1503,250
669138368,669135423,669151340,15917,1504,250
669158418,669155472,669172973,17501,1505,250
669180052,669177106,669194628,17522,1506,250
669201706,669198761,669216282,17521,1507,250
669223360,669220415,669238231,17816,1508,250
669245309,669242364,669259567,17203,1509,250
669266646,669263700,669279302,15602,1510,250
669286163,669283434,669301589,18155,1511,250
669308667,669305722,669322926,17204,1512,250
669330004,669327059,669343629,16570,1513,250
669350708,669347762,669363362,15600,1514,250
669370439,669367494,669385985,18491,1515,250
669393064,669390118,669406034,15916,1516,250
669413112,669410166,669428638,18472,1517,250
669435717,669432771,669448688,15917,1518,250
669455765,669452820,669470023,17203,1519,250
669477102,669474156,669491657,17501,1520,250
669498519,669495790,669513945,18155,1521,250
669521023,669518078,669534964,16886,1522,250
669542044,669539097,669556937,17840,1523,250
669564015,669561070,669578568,17498,1524,250
669585646,669582701,669599588,16887,1525,250
669606666,669603721,669621873,18152,1526,250
669628951,669626006,669644815,18809,1527,250
669651893,669648948,669666152,17204,1528,250
669673231,669670285,669688756,18471,1529,250
669695835,669692889,669710389,17500,1530,250
669717468,669714522,669730440,15918,1531,250
669737518,669734572,669751777,17205,1532,250
669758856,669755910,669773431,17521,1533,250
669780510,669777564,669793164,15600,1534,250
669800242,669797296,669813847,16551,1535,250
669820708,669817980,669836134,18154,1536,250
669843213,669840267,669858105,17838,1537,250
669865184,669862238,669879442,17204,1538,250
669886521,669883575,669902701,19126,1539,250
669909780,669906834,669922751,15917,1540,250
669929829,669926883,669943433,16550,1541,250
669950512,669947566,669965087,17521,1542,250
669972165,669969220,669988344,19124,1543,250
669995423,669992477,670008712,16235,1544,250
670015791,670012845,670029397,16552,1545,250
670036475,670033530,670051050,17520,1546,250
670058129,670055183,670073020,17837,1547,250
670080098,670077153,670093703,16550,1548,250
670100781,670097836,670114386,16550,1549,250
670121465,670118519,670134119,15600,1550,250
670141196,670138251,670156721,18470,1551,250
670163800,670160854,670178672,17818,1552,250
670185750,670182805,670200958,18153,1553,250
670208036,670205091,670221006,15915,1554,250
670228084,670225139,670242026,16887,1555,250
670249105,670246159,670262393,16234,1556,250
670269471,670266526,670284047,17521,1557,250
670291125,670288180,670306650,18470,1558,250
670313728,670310783,670329253,18470,1559,250
670336115,670333386,670351856,18470,1560,250
670358937,670355990,670373808,17818,1561,250
670380886,670377941,670396747,18806,1562,250
670403608,670400880,670417111,16231,1563,250
670424190,670421244,670438132,16888,1564,250
670445210,670442265,670461050,18785,1565,250
670468128,670465183,670481731,16548,1566,250
670488810,670485864,670504018,18154,1567,250
670510880,670508151,670525355,17204,1568,250
670532434,670529488,670546673,17185,1569,250
670553752,670550806,670567673,16867,1570,250
670574535,670571806,670589307,17501,1571,250
670596385,670593440,670611910,18470,1572,250
670618988,670616043,670632910,16867,1573,250
670639990,670637044,670654248,17204,1574,250
670661109,670658381,670674930,16549,1575,250
670682008,670679063,670696584,17521,1576,250
670703663,670700717,670719505,18788,1577,250
670726368,670723639,670740190,16551,1578,250
670747268,670744323,670762793,18470,1579,250
670769872,670766926,670784764,17838,1580,250
670791843,670788897,670806734,17837,1581,250
670813813,670810867,670827101,16234,1582,250
670834180,670831234,670850021,18787,1583,250
670857100,670854154,670871359,17205,1584,250
670878436,670875492,670890774,15282,1585,250
670897852,670894907,670911141,16234,1586,250
670918220,670915274,670932141,16867,1587,250
670939220,670936274,670953141,16867,1588,250
670960219,670957274,670973507,16233,1589,250
670980369,670977640,670993874,16234,1590,250
671000953,670998007,671015508,17501,1591,250
671022587,671019641,671037459,17818,1592,250
671044538,671041592,671058480,16888,1593,250
671065558,671062613,671078528,15915,1594,250
671085388,671082660,671101784,19124,1595,250
671108646,671105917,671123417,17500,1596,250
671130496,671127550,671143785,16235,1597,250
671150864,671147918,671165122,17204,1598,250
671171984,671169255,671185173,15918,1599,250
671192034,671189305,671206826,17521,1600,250
671213687,671210959,671227192,16233,1601,250
671234053,671231325,671249478,18153,1602,250
671256558,671253612,671270795,17183,1603,250
671277873,671274929,671292766,17837,1604,250
671299846,671296900,671313451,16551,1605,250
671320313,671317584,671333818,16234,1606,250
671340897,671337952,671355451,17499,1607,250
671362529,671359585,671377738,18153,1608,250
671384817,671381872,671399077,17205,1609,250
671406155,671403210,671420412,17202,1610,250
671427491,671424546,671442065,17519,1611,250
671449143,671446198,671461798,15600,1612,250
671468876,671465931,671481848,15917,1613,250
671488927,671485981,671503482,17501,1614,250
671510346,671507616,671524189,16573,1615,250
671531268,671528322,671547132,18810,1616,250
671554210,671551265,671574357,23092,1617,250
671581437,671578491,671594725,16234,1618,250
671601804,671598858,671615724,16866,1619,250
671622587,671619858,671636408,16550,1620,250
671643487,671640542,671658356,17814,1621,250
671665435,671662490,671680327,17837,1622,250
671687406,671684461,671702952,18491,1623,250
671709815,671707086,671724270,17184,1624,250
671731349,671728404,671747529,19125,1625,250
671754608,671751662,671768527,16865,1626,250
671775389,671772660,671789844,17184,1627,250
671796923,671793977,671811182,17205,1628,250
671818260,671815315,671832498,17183,1629,250
671839577,671836631,671855103,18472,1630,250
671862182,671859236,671874203,14967,1631,250
671881280,671878335,671894905,16570,1632,250
671901983,671899038,671915271,16233,1633,250
671922133,671919404,671938191,18787,1634,250
671945272,671942325,671957294,14969,1635,250
671964373,671961427,671976711,15284,1636,250
671983789,671980844,671996128,15284,1637,250
672003206,672000261,672018415,18154,1638,250
672025493,672022548,672040068,17520,1639,250
672047145,672044201,672061404,17203,1640,250
672068482,672065537,672082740,17203,1641,250
672089818,672086873,672102156,15283,1642,250
672109234,672106288,672122523,16235,1643,250
672129601,672126656,672144809,18153,1644,250
672151887,672148942,672165492,16550,1645,250
672172352,672169625,672188431,18806,1646,250
672195293,672192564,672210063,17499,1647,250
672217142,672214196,672232688,18492,1648,250
672239548,672236821,672253369,16548,1649,250
672260447,672257502,672275339,17837,1650,250
672282417,672279472,672296338,16866,1651,250
672303416,672300471,672317653,17182,1652,250
672324514,672321786,672338652,16866,1653,250
672345731,672342785,672359336,16551,1654,250
672366414,672363469,672379701,16232,1655,250
672386563,672383834,672399752,15918,1656,250
672406830,672403885,672420772,16887,1657,250
672427634,672424905,672442404,17499,1658,250
672449482,672446537,672462769,16232,1659,250
672469849,672466902,672484720,17818,1660,250
672491798,672488853,672504136,15283,1661,250
672511214,672508268,672526422,18154,1662,250
672533500,672530555,672547420,16865,1663,250
672554499,672551554,672569686,18132,1664,250
672576765,672573819,672592607,18788,1665,250
672599685,672596740,672614240,17500,1666,250
672621318,672618373,672633972,15599,1667,250
672640833,672638105,672655625,17520,1668,250
672662703,672659758,672675040,15282,1669,250
672682117,672679172,672695403,16231,1670,250
672702481,672699536,672714502,14966,1671,250
672721362,672718634,672736471,17837,1672,250
672743549,672740604,672758757,18153,1673,250
672765834,672762890,672781359,18469,1674,250
672788437,672785492,672802358,16866,1675,250
672809437,672806491,672823990,17499,1676,250
672831070,672828123,672845329,17206,1677,250
672852407,672849462,672865062,15600,1678,250
672872140,672869194,672886399,17205,1679,250
672893477,672890532,672907082,16550,1680,250
672914159,672911215,672927129,15914,1681,250
672934208,672931262,672946864,15602,1682,250
672953942,672950996,672969151,18155,1683,250
672976013,672973284,672991755,18471,1684,250
672998834,672995888,673012438,16550,1685,250
673019301,673016571,673033123,16552,1686,250
673040201,673037256,673056379,19123,1687,250
673063457,673060512,673075796,15284,1688,250
673082874,673079928,673099053,19125,1689,250
673106131,673103186,673120706,17520,1690,250
673127785,673124839,673142994,18155,1691,250
673150072,673147127,673166568,19441,1692,250
673173646,673170701,673187904,17203,1693,250
673194984,673192038,673207640,15602,1694,250
673214718,673211773,673229609,17836,1695,250
673236689,673233743,673251560,17817,1696,250
673258640,673255694,673273194,17500,1697,250
673280272,673277328,673295797,18469,1698,250
673302877,673299931,673318719,18788,1699,250
673325797,673322852,673339402,16550,1700,250
673346481,673343535,673361372,17837,1701,250
673368450,673365505,673383658,18153,1702,250
673390737,673387791,673405945,18154,1703,250
673412806,673410078,673425676,15598,1704,250
673432754,673429809,673448280,18471,1705,250
673455359,673452413,673468986,16573,1706,250
673476064,673473119,673490639,17520,1707,250
673497717,673494772,673512292,17520,1708,250
673519154,673516425,673532975,16550,1709,250
673539835,673537108,673554943,17835,1710,250
673562021,673559076,673577230,18154,1711,250
673584308,673581363,673599201,17838,1712,250
673606280,673603335,673622460,19125,1713,250
673629538,673626593,673643774,17181,1714,250
673650852,673647907,673667348,19441,1715,250
673674427,673671481,673687082,15601,1716,250
673694160,673691215,673707447,16232,1717,250
673714309,673711580,673728128,16548,1718,250
673735206,673732261,673751384,19123,1719,250
673758462,673755517,673774642,19125,1720,250
673781721,673778776,673795009,16233,1721,250
673802087,673799142,673816956,17814,1722,250
673824035,673821089,673837639,16550,1723,250
673844717,673841772,673859293,17521,1724,250
673866156,673863426,673881265,17839,1725,250
673888126,673885399,673902601,17202,1726,250
673909680,673906734,673925205,18471,1727,250
673932066,673929338,673945252,15914,1728,250
673952329,673949384,673966905,17521,1729,250
673973767,673971038,673986322,15284,1730,250
673993401,673990455,674007006,16551,1731,250
674014085,674011139,674028345,17206,1732,250
674035424,674032478,674049027,16549,1733,250
674056105,674053160,674069392,16232,1734,250
674076471,674073525,674090392,16867,1735,250
674097471,674094526,674111728,17202,1736,250
674118807,674115861,674132728,16867,1737,250
674139806,674136861,674153093,16232,1738,250
674160171,674157226,674174113,16887,1739,250
674181191,674178246,674196063,17817,1740,250
674203143,674200197,674217380,17183,1741,250
674224243,674221513,674238065,16552,1742,250
674245145,674242199,674259382,17183,1743,250
674266460,674263515,674280380,16865,1744,250
674287460,674284514,674301064,16550,1745,250
674308144,674305198,674323668,18470,1746,250
674330746,674327801,674346271,18470,1747,250
674353350,674350405,674367926,17521,1748,250
674375005,674372059,674387343,15284,1749,250
674394420,674391475,674409291,17816,1750,250
674416369,674413424,674431895,18471,1751,250
674438976,674436029,674453214,17185,1752,250
674460293,674457348,674472315,14967,1753,250
674479393,674476448,674493314,16866,1754,250
674500393,674497448,674514314,16866,1755,250
674521393,674518448,674535631,17183,1756,250
674542711,674539765,674555050,15285,1757,250
674562128,674559183,674577337,18154,1758,250
674584416,674581471,674599625,18154,1759,250
674606704,674603758,674620308,16550,1760,250
674627386,674624441,674643248,18807,1761,250
674650326,674647381,674665871,18490,1762,250
674672951,674670005,674687190,17185,1763,250
674694269,674691324,674709816,18492,1764,250
674716679,674713950,674732422,18472,1765,250
674739502,674736556,674753127,16571,1766,250
674760206,674757260,674775731,18471,1767,250
674782812,674779865,674795784,15919,1768,250
674802862,674799917,674817417,17500,1769,250
674824496,674821551,674839050,17499,1770,250
674846129,674843183,674861021,17838,1771,250
674868101,674865155,674882339,17184,1772,250
674889418,674886473,674903992,17519,1773,250
674910856,674908126,674924677,16551,1774,250
674931756,674928811,674946964,18153,1775,250
674954043,674951097,674968302,17205,1776,250
674975382,674972436,674989936,17500,1777,250
674997015,674994070,675012224,18154,1778,250
675019302,675016358,675032906,16548,1779,250
675039986,675037040,675055195,18155,1780,250
675062273,675059328,675076533,17205,1781,250
675083394,675080666,675098502,17836,1782,250
675105582,675102636,675120473,17837,1783,250
675127554,675124607,675144049,19442,1784,250
675151127,675148182,675165385,17203,1785,250
675172464,675169518,675188306,18788,1786,250
675195168,675192440,675207407,14967,1787,250
675214485,675211540,675227773,16233,1788,250
675234636,675231906,675249112,17206,1789,250
675256190,675253245,675271397,18152,1790,250
675278476,675275530,675291763,16233,1791,250
675298842,675295896,675315337,19441,1792,250
675322416,675319471,675336675,17204,1793,250
675343754,675340809,675356724,15915,1794,250
675363804,675360857,675376457,15600,1795,250
675383535,675380590,675395557,14967,1796,250
675402634,675399689,675416872,17183,1797,250
675423734,675421006,675439813,18807,1798,250
675446676,675443947,675462419,18472,1799,250
675469499,675466552,675484392,17840,1800,250
675491470,675488525,675506362,17837,1801,250
675513441,675510495,675528333,17838,1802,250
675535196,675532466,675548384,15918,1803,250
675555463,675552517,675569385,16868,1804,250
675576464,675573518,675591355,17837,1805,250
675598219,675595489,675614615,19126,1806,250
675621695,675618749,675634983,16234,1807,250
675642062,675639117,675657926,18809,1808,250
675665006,675662060,675679582,17522,1809,250
675686661,675683716,675699316,15600,1810,250
675706393,675703448,675718732,15284,1811,250
675725811,675722864,675739732,16868,1812,250
675746810,675743865,675760099,16234,1813,250
675767178,675764233,675781754,17521,1814,250
675788832,675785888,675802753,16865,1815,250
675809832,675806887,675823456,16569,1816,250
675830536,675827590,675843191,15601,1817,250
675850270,675847324,675863873,16549,1818,250
675870951,675868006,675885525,17519,1819,250
675892604,675889658,675907813,18155,1820,250
675914891,675911946,675929467,17521,1821,250
675936546,675933600,675951121,17521,1822,250
675958200,675955254,675971171,15917,1823,250
675978249,675975303,675993121,17818,1824,250
676000201,675997254,676013173,15919,1825,250
676020035,676017306,676035144,17838,1826,250
676042222,676039277,676056797,17520,1827,250
676063877,676060931,676078451,17520,1828,250
676085529,676082584,676100421,17837,1829,250
676107499,676104554,676121104,16550,1830,250
676128183,676125237,676142440,17203,1831,250
676149518,676146573,676164409,17836,1832,250
676171489,676168542,676186698,18156,1833,250
676193777,676190831,676205799,14968,1834,250
676212879,676209932,676225218,15286,1835,250
676232296,676229351,676247822,18471,1836,250
676254902,676251956,676269159,17203,1837,250
676276239,676273293,676290497,17204,1838,250
676297576,676294631,676312469,17838,1839,250
676319548,676316603,676335728,19125,1840,250
676342807,676339861,676357383,17522,1841,250
676364462,676361516,676379352,17836,1842,250
676386214,676383486,676401639,18153,1843,250
676408717,676405772,676423271,17499,1844,250
676430349,676427404,676444271,16867,1845,250
676451349,676448404,676464004,15600,1846,250
676471082,676468137,676484684,16547,1847,250
676491764,676488818,676505706,16888,1848,250
676512784,676509839,676527677,17838,1849,250
676534757,676531811,676546778,14967,1850,250
676553855,676550910,676567480,16570,1851,250
676574558,676571613,676588480,16867,1852,250
676595558,676592613,676611737,19124,1853,250
676618815,676615870,676631787,15917,1854,250
676638649,676635920,676651836,15916,1855,250
676658914,676655969,676673173,17204,1856,250
676680252,676677307,676695776,18469,1857,250
676702855,676699909,676715826,15917,1858,250
676722904,676719959,676737163,17204,1859,250
676744024,676741296,676756895,15599,1860,250
676763973,676761028,676778230,17202,1861,250
676785309,676782363,676800538,18175,1862,250
676807616,676804671,676820272,15601,1863,250
676827350,676824405,676842559,18154,1864,250
676849636,676846692,676866132,19440,1865,250
676873211,676870265,676887152,16887,1866,250
676894233,676891286,676907838,16552,1867,250
676914915,676911971,676928520,16549,1868,250
676935599,676932653,676950491,17838,1869,250
676957571,676954624,676969909,15285,1870,250
676976987,676974042,676991225,17183,1871,250
676998304,676995359,677012542,17183,1872,250
677019620,677016675,677032275,15600,1873,250
677039354,677036408,677052326,15918,1874,250
677059404,677056459,677074297,17838,1875,250
677081375,677078430,677096267,17837,1876,250
677103346,677100400,677118890,18490,1877,250
677125969,677123024,677140523,17499,1878,250
677147602,677144656,677160573,15917,1879,250
677167651,677164706,677181255,16549,1880,250
677188334,677185388,677201621,16233,1881,250
677208700,677205755,677223909,18154,1882,250
677230987,677228042,677244592,16550,1883,250
677251453,677248725,677267532,18807,1884,250
677274612,677271666,677289484,17818,1885,250
677296563,677293618,677308902,15284,1886,250
677315980,677313035,677330534,17499,1887,250
677337613,677334667,677352188,17521,1888,250
677359266,677356321,677374789,18468,1889,250
677381870,677378923,677396108,17185,1890,250
677403187,677400242,677417108,16866,1891,250
677424186,677421241,677439395,18154,1892,250
677446474,677443529,677458496,14967,1893,250
677465575,677462628,677478546,15918,1894,250
677485624,677482679,677497645,14966,1895,250
677504722,677501777,677518327,16550,1896,250
677525406,677522461,677537429,14968,1897,250
677544508,677541562,677560688,19126,1898,250
677567768,677564822,677583293,18471,1899,250
677590371,677587426,677604926,17500,1900,250
677612005,677609059,677625948,16889,1901,250
677633026,677630081,677646314,16233,1902,250
677653393,677650448,677668602,18154,1903,250
677675681,677672736,677690888,18152,1904,250
677697966,677695021,677710621,15600,1905,250
677717699,677714754,677730988,16234,1906,250
677738067,677735122,677752305,17183,1907,250
677759384,677756439,677773306,16867,1908,250
677780385,677777440,677794306,16866,1909,250
677801386,677798440,677815306,16866,1910,250
677822384,677819440,677835989,16549,1911,250
677843068,677840123,677858931,18808,1912,250
677866010,677863065,677882189,19124,1913,250
677889268,677886323,677903209,16886,1914,250
677910289,677907343,677924526,17183,1915,250
677931605,677928660,677946497,17837,1916,250
677953576,677950631,677965913,15282,1917,250
677972991,677970046,677988200,18154,1918,250
677995063,677992334,678008251,15917,1919,250
678015328,678012384,678028617,16233,1920,250
678035479,678032751,678051221,18470,1921,250
678058302,678055355,678072222,16867,1922,250
678079301,678076356,678095481,19125,1923,250
678102559,678099614,678116501,16887,1924,250
678123363,678120634,678138155,17521,1925,250
678145018,678142289,678158522,16233,1926,250
678165385,678162656,678178889,16233,1927,250
678185751,678183022,678199254,16232,1928,250
678206334,678203387,678219306,15919,1929,250
678226384,678223439,678240326,16887,1930,250
678247406,678244460,678261960,17500,1931,250
678269039,678266094,678284268,18174,1932,250
678291131,678288402,678305607,17205,1933,250
678312686,678309740,678327577,17837,1934,250
678334658,678331711,678350520,18809,1935,250
678357600,678354654,678372176,17522,1936,250
678379255,678376310,678392227,15917,1937,250
678399306,678396360,678413247,16887,1938,250
678420326,678417380,678434902,17522,1939,250
678441981,678439035,678456219,17184,1940,250
678463297,678460352,678477218,16866,1941,250
678484296,678481351,678498870,17519,1942,250
678505949,678503003,678520206,17203,1943,250
678527284,678524339,678542177,17838,1944,250
678549258,678546311,678564150,17839,1945,250
678571229,678568283,678584518,16235,1946,250
678591596,678588651,678605538,16887,1947,250
678612616,678609672,678625588,15916,1948,250
678632667,678629721,678647875,18154,1949,250
678654953,678652008,678666974,14966,1950,250
678674053,678671107,678689916,18809,1951,250
678696995,678694050,678709334,15284,1952,250
678716411,678713467,678731303,17836,1953,250
678738381,678735436,678753590,18154,1954,250
678760670,678757724,678776532,18808,1955,250
678783612,678780666,678797534,16868,1956,250
678804613,678801668,678820793,19125,1957,250
678827873,678824927,678842132,17205,1958,250
678849213,678846266,678863787,17521,1959,250
678870866,678867920,678883837,15917,1960,250
678890915,678887970,678903885,15915,1961,250
678910962,678908018,678925537,17519,1962,250
678932616,678929670,678944638,14968,1963,250
678951500,678948771,678964688,15917,1964,250
678971766,678968821,678985686,16865,1965,250
678992765,678989819,679006052,16233,1966,250
679013131,679010185,679028678,18493,1967,250
679035756,679032811,679047778,14967,1968,250
679054855,679051910,679068144,16234,1969,250
679075223,679072278,679089482,17204,1970,250
679096560,679093616,679112423,18807,1971,250
679119503,679116557,679133108,16551,1972,250
679140187,679137241,679153158,15917,1973,250
679160236,679157291,679175129,17838,1974,250
679182208,679179262,679196783,17521,1975,250
679203860,679200916,679219068,18152,1976,250
679226147,679223201,679238803,15602,1977,250
679245881,679242936,679259485,16549,1978,250
679266564,679263619,679280484,16865,1979,250
679287563,679284618,679299584,14966,1980,250
679306663,679303717,679319951,16234,1981,250
679327031,679324084,679340319,16235,1982,250
679347399,679344453,679360370,15917,1983,250
679367446,679364502,679381051,16549,1984,250
679388129,679385184,679403020,17836,1985,250
679410101,679407154,679424992,17838,1986,250
679432070,679429125,679446013,16888,1987,250
679453092,679450146,679468639,18493,1988,250
679475719,679472773,679490295,17522,1989,250
679497375,679494429,679511317,16888,1990,250
679518395,679515450,679533603,18153,1991,250
679540683,679537737,679554626,16889,1992,250
679561705,679558759,679575965,17206,1993,250
679583044,679580099,679596332,16233,1994,250
679603412,679600466,679618304,17838,1995,250
679625384,679622438,679639621,17183,1996,250
679646701,679643754,679660306,16552,1997,250
679667386,679664440,679681961,17521,1998,250
679689039,679686094,679702011,15917,1999,250
679709091,679706144,679722717,16573,2000,250
679729796,679726851,679743716,16865,2001,250
679750794,679747850,679766023,18173,2002,250
679773103,679770157,679787679,17522,2003,250
679794758,679791813,679807729,15916,2004,250
679814808,679811863,679830015,18152,2005,250
679837095,679834149,679849750,15601,2006,250
679856827,679853883,679871401,17518,2007,250
679878481,679875535,679892403,16868,2008,250
679899267,679896537,679913405,16868,2009,250
679920484,679917539,679935693,18154,2010,250
679942555,679939827,679956377,16550,2011,250
679963456,679960511,679977715,17204,2012,250
679984793,679981849,680000001,18152,2013,250
680007079,680004134,680020684,16550,2014,250
680027762,680024817,680043625,18808,2015,250
680050705,680047759,680063677,15918,2016,250
680070756,680067810,680084360,16550,2017,250
680091439,680088494,680103460,14966,2018,250
680110538,680107593,680124143,16550,2019,250
680131222,680128277,680145460,17183,2020,250
680152539,680149594,680169034,19440,2021,250
680176112,680173168,680191005,17837,2022,250
680198084,680195139,680210738,15599,2023,250
680217816,680214871,680231442,16571,2024,250
680238522,680235576,680254048,18472,2025,250
680261128,680258182,680274733,16551,2026,250
680281813,680278867,680295417,16550,2027,250
680302497,680299551,680317389,17838,2028,250
680324469,680321523,680340332,18809,2029,250
680347411,680344466,680361987,17521,2030,250
680368850,680366121,680382038,15917,2031,250
680389116,680386171,680402721,16550,2032,250
680409801,680406855,680425009,18154,2033,250
680432088,680429143,680446030,16887,2034,250
680453109,680450164,680467684,17520,2035,250
680474763,680471818,680490288,18470,2036,250
680497367,680494422,680512259,17837,2037,250
680519338,680516393,680533892,17499,2038,250
680540972,680538026,680553310,15284,2039,250
680560389,680557443,680572409,14966,2040,250
680579489,680576542,680594064,17522,2041,250
680601145,680598198,680615087,16889,2042,250
680622166,680619221,680638007,18786,2043,250
680645086,680642141,680658057,15916,2044,250
680665136,680662190,680680342,18152,2045,250
680687421,680684476,680701659,17183,2046,250
680708738,680705793,680723968,18175,2047,250
680731048,680728102,680744991,16889,2048,250
680752070,680749125,680766330,17205,2049,250
680773409,680770464,680785430,14966,2050,250
680792509,680789564,680808372,18808,2051,250
680815452,680812506,680828741,16235,2052,250
680835820,680832875,680848475,15600,2053,250
680855553,680852608,680870128,17520,2054,250
680877207,680874262,680890178,15916,2055,250
680897040,680894312,680913436,19124,2056,250
680920516,680917570,680934458,16888,2057,250
680941537,680938592,680955795,17203,2058,250
680962875,680959929,680978422,18493,2059,250
680985502,680982556,680998474,15918,2060,250
681005336,681002607,681018522,15915,2061,250
681025599,681022655,681039521,16866,2062,250
681046601,681043655,681061176,17521,2063,250
681068255,681065310,681082512,17202,2064,250
681089593,681086646,681103197,16551,2065,250
681110276,681107331,681122932,15601,2066,250
681130010,681127065,681144565,17500,2067,250
681151427,681148699,681166220,17521,2068,250
681173300,681170354,681185639,15285,2069,250
681192718,681189772,681205374,15602,2070,250
681212454,681209508,681227663,18155,2071,250
681234741,681231797,681250265,18468,2072,250
681257344,681254399,681270632,16233,2073,250
681277711,681274766,681293235,18469,2074,250
681300314,681297369,681314890,17521,2075,250
681321970,681319024,681336229,17205,2076,250
681343308,681340363,681358516,18153,2077,250
681365596,681362650,681381121,18471,2078,250
681388201,681385255,681402776,17521,2079,250
681409856,681406910,681426352,19442,2080,250
681433431,681430486,681448956,18470,2081,250
681456034,681453090,681469005,15915,2082,250
681475867,681473138,681489055,15917,2083,250
681496134,681493188,681512314,19126,2084,250
681519393,681516448,681533334,16886,2085,250
681540412,681537468,681553701,16233,2086,250
681560780,681557835,681574068,16233,2087,250
681581149,681578203,681594438,16235,2088,250
681601516,681598571,681616090,17519,2089,250
681623168,681620223,681635505,15282,2090,250
681642584,681639638,681655872,16234,2091,250
681662951,681660006,681676894,16888,2092,250
681683972,681681027,681696944,15917,2093,250
681704023,681701077,681718915,17838,2094,250
681725993,681723049,681738647,15598,2095,250
681745725,681742780,681759330,16550,2096,250
681766409,681763463,681781299,17836,2097,250
681788378,681785432,681803270,17838,2098,250
681810349,681807403,681825557,18154,2099,250
681832635,681829690,681845290,15600,2100,250
681852369,681849423,681865973,16550,2101,250
681873053,681870107,681887290,17183,2102,250
681894370,681891424,681910232,18808,2103,250
681917312,681914366,681931234,16868,2104,250
681938313,681935368,681952867,17499,2105,250
681959945,681957000,681972283,15283,2106,250
681979362,681976417,681995857,19440,2107,250
682002936,681999990,682016540,16550,2108,250
682023620,682020674,682037858,17184,2109,250
682044939,682041992,682057910,15918,2110,250
682064988,682062043,682079224,17181,2111,250
682086304,682083358,682099908,16550,2112,250
682106987,682104042,682119958,15916,2113,250
682127037,682124091,682141613,17522,2114,250
682148691,682145747,682162317,16570,2115,250
682169396,682166451,682183972,17521,2116,250
682191052,682188106,682207548,19442,2117,250
682214628,682211682,682227284,15602,2118,250
682234363,682231417,682248285,16868,2119,250
682255364,682252419,682270573,18154,2120,250
682277653,682274707,682292207,17500,2121,250
682299286,682296341,682311941,15600,2122,250
682319019,682316074,682331674,15600,2123,250
682338752,682335807,682353621,17814,2124,250
682360700,682357755,682374938,17183,2125,250
682382016,682379072,682396909,17837,2126,250
682403771,682401042,682416958,15916,2127,250
682424036,682421091,682438610,17519,2128,250
682445690,682442744,682461869,19125,2129,250
682468949,682466003,682481605,15602,2130,250
682488683,682485738,682504546,18808,2131,250
682511625,682508680,682525568,16888,2132,250
682532648,682529702,682545303,15601,2133,250
682552381,682549436,682567589,18153,2134,250
682574669,682571723,682590847,19124,2135,250
682597710,682594981,682611214,16233,2136,250
682618293,682615347,682631582,16235,2137,250
682638662,682635716,682654524,18808,2138,250
682661603,682658658,682676177,17519,2139,250
682683256,682680311,682697198,16887,2140,250
682704277,682701332,682718536,17204,2141,250
682725400,682722670,682740190,17520,2142,250
682747271,682744324,682762162,17838,2143,250
682769023,682766296,682784787,18491,2144,250
682791649,682788921,682805471,16550,2145,250
682812549,682809605,682829044,19439,2146,250
682836123,682833178,682850045,16867,2147,250
682857124,682854179,682870413,16234,2148,250
682877493,682874547,682893039,18492,2149,250
682900118,682897173,682914061,16888,2150,250
682920924,682918195,682934767,16572,2151,250
682941846,682938901,682956422,17521,2152,250
682963501,682960556,682978393,17837,2153,250
682985473,682982527,683000048,17521,2154,250
683007127,683004182,683021387,17205,2155,250
683028466,683025521,683042725,17204,2156,250
683049803,683046859,683064695,17836,2157,250
683071775,683068829,683086035,17206,2158,250
683093114,683090169,683107373,17204,2159,250
683114453,683111507,683129027,17520,2160,250
683136106,683133161,683152284,19123,2161,250
683159363,683156418,683172334,15916,2162,250
683179412,683176467,683193988,17521,2163,250
683201068,683198122,683214672,16550,2164,250
683221752,683218806,683237932,19126,2165,250
683245012,683242066,683258299,16233,2166,250
683265378,683262433,683279616,17183,2167,250
683286695,683283750,683301586,17836,2168,250
683308665,683305720,683322903,17183,2169,250
683329983,683327037,683344558,17521,2170,250
683351637,683348692,683365559,16867,2171,250
683372640,683369693,683385611,15918,2172,250
683392689,683389744,683407244,17500,2173,250
683414324,683411378,683429848,18470,2174,250
683436927,683433982,683451502,17520,2175,250
683458580,683455636,683471868,16232,2176,250
683478730,683476002,683494809,18807,2177,250
683501889,683498943,683515494,16551,2178,250
683522574,683519628,683536516,16888,2179,250
683543596,683540650,683558803,18153,2180,250
683565883,683562937,683580121,17184,2181,250
683587201,683584255,683602726,18471,2182,250
683609805,683606860,683624381,17521,2183,250
683631461,683628515,683645699,17184,2184,250
683652777,683649833,683665432,15599,2185,250
683672293,683669565,683686770,17205,2186,250
683693848,683690904,683708108,17204,2187,250
683715188,683712242,683729763,17521,2188,250
683736842,683733897,683749496,15599,2189,250
683756574,683753629,683770177,16548,2190,250
683777257,683774311,683791517,17206,2191,250
683798596,683795651,683813489,17838,2192,250
683820352,683817623,683833222,15599,2193,250
683840300,683837356,683854558,17202,2194,250
683861639,683858692,683874928,16236,2195,250
683882008,683879062,683896562,17500,2196,250
683903642,683900696,683917564,16868,2197,250
683924644,683921698,683938566,16868,2198,250
683945645,683942700,683961824,19124,2199,250
683968904,683965958,683983458,17500,2200,250
683990539,683987592,684004143,16551,2201,250
684011223,684008277,684026432,18155,2202,250
684033513,684030567,684048405,17838,2203,250
684055484,684052539,684071009,18470,2204,250
684078089,684075143,684094268,19125,2205,250
684101347,684098402,684115583,17181,2206,250
684122663,684119717,684135950,16233,2207,250
684143031,684140084,684156951,16867,2208,250
684164031,684161085,684178607,17522,2209,250
684185687,684182741,684198342,15601,2210,250
684205203,684202475,684220311,17836,2211,250
684227391,684224445,684241333,16888,2212,250
684248196,684245467,684261068,15601,2213,250
684268147,684265201,684282723,17522,2214,250
684289802,684286857,684305327,18470,2215,250
684312406,684309461,684327299,17838,2216,250
684334162,684331433,684347983,16550,2217,250
684355064,684352117,684369323,17206,2218,250
684376403,684373457,684390662,17205,2219,250
684397741,684394796,684412631,17835,2220,250
684419494,684416765,684432682,15917,2221,250
684439761,684436815,684453366,16551,2222,250
684460444,684457500,684474704,17204,2223,250
684481783,684478838,684496992,18154,2224,250
684504071,684501126,684517359,16233,2225,250
684524439,684521493,684538698,17205,2226,250
684545777,684542832,684560352,17520,2227,250
684567214,684564486,684580085,15599,2228,250
684586947,684584218,684600769,16551,2229,250
684607849,684604903,684622107,17204,2230,250
684629185,684626241,684643423,17182,2231,250
684650503,684647557,684664446,16889,2232,250
684671526,684668580,684683548,14968,2233,250
684690625,684687681,684705200,17519,2234,250
684712279,684709334,684727825,18491,2235,250
684734904,684731959,684749458,17499,2236,250
684756538,684753592,684770481,16889,2237,250
684777561,684774615,684792136,17521,2238,250
684798999,684796270,684814108,17838,2239,250
684820972,684818243,684835427,17184,2240,250
684842507,684839561,684856449,16888,2241,250
684863528,684860583,684877449,16866,2242,250
684884529,684881583,684898471,16888,2243,250
684905551,684902605,684918522,15917,2244,250
684925601,684922655,684940177,17522,2245,250
684947040,684944311,684962149,17838,2246,250
684969228,684966283,684983487,17204,2247,250
684990566,684987621,685005141,17520,2248,250
685012220,685009275,685027428,18153,2249,250
685034507,685031562,685050686,19124,2250,250
685057549,685054820,685072657,17837,2251,250
685079737,685076791,685093997,17206,2252,250
685101076,685098131,685114364,16233,2253,250
685121443,685118498,685133781,15283,2254,250
685140860,685137914,685154782,16868,2255,250
685161861,685158916,685175781,16865,2256,250
685182642,685179915,685196147,16232,2257,250
685203009,685200281,685218751,18470,2258,250
685225614,685222885,685240068,17183,2259,250
685247148,685244202,685263327,19125,2260,250
685270408,685267461,685285300,17839,2261,250
685292162,685289434,685307905,18471,2262,250
685314984,685312039,685330846,18807,2263,250
685337709,685334980,685351531,16551,2264,250
685358611,685355665,685373503,17838,2265,250
685380582,685377637,685395475,17838,2266,250
685402555,685399609,685417427,17818,2267,250
685424506,685421561,685439715,18154,2268,250
685446797,685443850,685460086,16236,2269,250
685467165,685464220,685482374,18154,2270,250
685489237,685486508,685503713,17205,2271,250
685510794,685507848,685526002,18154,2272,250
685533081,685530136,685546053,15917,2273,250
685553131,685550186,685566102,15916,2274,250
685573181,685570236,685586786,16550,2275,250
685593866,685590920,685608441,17521,2276,250
685615304,685612575,685629462,16887,2277,250
685636541,685633596,685651117,17521,2278,250
685658196,685655251,685672116,16865,2279,250
685679196,685676250,685694722,18472,2280,250
685701801,685698856,685714772,15916,2281,250
685721851,685718905,685736108,17203,2282,250
685743187,685740242,685759029,18787,2283,250
685766108,685763163,685780051,16888,2284,250
685787131,685784185,685801706,17521,2285,250
685808785,685805840,685824647,18807,2286,250
685831727,685828781,685844383,15602,2287,250
685851461,685848516,685865698,17182,2288,250
685872778,685869832,685887986,18154,2289,250
685895066,685892121,685909304,17183,2290,250
685916167,685913438,685932562,19124,2291,250
685939643,685936696,685952298,15602,2292,250
685959377,685956431,685973952,17521,2293,250
685981031,685978086,685995586,17500,2294,250
686002665,685999720,686018191,18471,2295,250
686025272,686022325,686040480,18155,2296,250
686047560,686044614,686063086,18472,2297,250
686070167,686067221,686086031,18810,2298,250
686093111,686090165,686108636,18471,2299,250
686115716,686112770,686128688,15918,2300,250
686135768,686132821,686150639,17818,2301,250
686157718,686154773,686171955,17182,2302,250
686179034,686176089,686193926,17837,2303,250
686201004,686198060,686215241,17181,2304,250
686222320,686219375,686236579,17204,2305,250
686243658,686240713,686257917,17204,2306,250
686264998,686262051,686277968,15917,2307,250
686285047,686282102,686299307,17205,2308,250
686306170,686303441,686320942,17501,2309,250
686328021,686325076,686341942,16866,2310,250
686349021,686346076,686363595,17519,2311,250
686370675,686367729,686383330,15601,2312,250
686390407,686387463,686405932,18469,2313,250
686413011,686410066,686425033,14967,2314,250
686432112,686429166,686447321,18155,2315,250
686454400,686451455,686468659,17204,2316,250
686475738,686472793,686491284,18491,2317,250
686498364,686495418,686513256,17838,2318,250
686520121,686517390,686535209,17819,2319,250
686542288,686539343,686557497,18154,2320,250
686564577,686561631,686579469,17838,2321,250
686586332,686583603,686601442,17839,2322,250
686608522,686605576,686622443,16867,2323,250
686629523,686626577,686643445,16868,2324,250
686650524,686647579,686666386,18807,2325,250
686673466,686670520,686687725,17205,2326,250
686694805,686691859,686706826,14967,2327,250
686713905,686710960,686728479,17519,2328,250
686735557,686732613,686749479,16866,2329,250
686756559,686753613,686771768,18155,2330,250
686778848,686775902,686792453,16551,2331,250
686799533,686796587,686814742,18155,2332,250
686821821,686818876,686836713,17837,2333,250
686843794,686840847,686857714,16867,2334,250
686864794,686861848,686879054,17206,2335,250
686885917,686883188,686901996,18808,2336,250
686909076,686906130,686924601,18471,2337,250
686931680,686928735,686946551,17816,2338,250
686953413,686950685,686966602,15917,2339,250
686973680,686970735,686987918,17183,2340,250
686994997,686992052,687008601,16549,2341,250
687015681,687012735,687030257,17522,2342,250
687037337,687034392,687051597,17205,2343,250
687058678,687055732,687073231,17499,2344,250
687080310,687077365,687095856,18491,2345,250
687102936,687099990,687115909,15919,2346,250
687122990,687120043,687137249,17206,2347,250
687144328,687141383,687158588,17205,2348,250
687165668,687162722,687180560,17838,2349,250
687187640,687184694,687202531,17837,2350,250
687209611,687206665,687225156,18491,2351,250
687232235,687229290,687247444,18154,2352,250
687254523,687251578,687268782,17204,2353,250
687275862,687272916,687289803,16887,2354,250
687296883,687293937,687311121,17184,2355,250
687317984,687315255,687332776,17521,2356,250
687339855,687336910,687354748,17838,2357,250
687361828,687358882,687376087,17205,2358,250
687383166,687380221,687398375,18154,2359,250
687405456,687402509,687421296,18787,2360,250
687428377,687425430,687442636,17206,2361,250
687449716,687446770,687463636,16866,2362,250
687470716,687467770,687485292,17522,2363,250
687492154,687489426,687505975,16549,2364,250
687513054,687510109,687527946,17837,2365,250
687535025,687532080,687547678,15598,2366,250
687554757,687551812,687569016,17204,2367,250
687576095,687573150,687591958,18808,2368,250
687599039,687596092,687613278,17186,2369,250
687620357,687617412,687634278,16866,2370,250
687641357,687638412,687654646,16234,2371,250
687661726,687658780,687676301,17521,2372,250
687683163,687680435,687696668,16233,2373,250
687703747,687700802,687718005,17203,2374,250
687725084,687722139,687741264,19125,2375,250
687748127,687745398,687762265,16867,2376,250
687769344,687766399,687782314,15915,2377,250
687789394,687786448,687803653,17205,2378,250
687810733,687807787,687823704,15917,2379,250
687830783,687827838,687844388,16550,2380,250
687851467,687848522,687866042,17520,2381,250
687873121,687870176,687885459,15283,2382,250
687892321,687889593,687908084,18491,2383,250
687915164,687912219,687929740,17521,2384,250
687936819,687933874,687950423,16549,2385,250
687957503,687954557,687971763,17206,2386,250
687978844,687975898,687992132,16234,2387,250
687998995,687996266,688012183,15917,2388,250
688019262,688016317,688033498,17181,2389,250
688040578,688037632,688055470,17838,2390,250
688062550,688059604,688077126,17522,2391,250
688084206,688081260,688098148,16888,2392,250
688105227,688102282,688118854,16572,2393,250
688125935,688122989,688140827,17838,2394,250
688147908,688144961,688160879,15918,2395,250
688167958,688165012,688181899,16887,2396,250
688188761,688186033,688201000,14967,2397,250
688208079,688205133,688221051,15918,2398,250
688228129,688225184,688241415,16231,2399,250
688248495,688245549,688261467,15918,2400,250
688268545,688265600,688282150,16550,2401,250
688289229,688286284,688302516,16232,2402,250
688309596,688306650,688323201,16551,2403,250
688330281,688327335,688343885,16550,2404,250
688350964,688348019,688364590,16571,2405,250
688371452,688368724,688385274,16550,2406,250
688392353,688389407,688406611,17204,2407,250
688413473,688410745,688427632,16887,2408,250
688434711,688431766,688448949,17183,2409,250
688456030,688453083,688470583,17500,2410,250
688477663,688474717,688490950,16233,2411,250
688498030,688495084,688513239,18155,2412,250
688520319,688517373,688535211,17838,2413,250
688542291,688539345,688556866,17521,2414,250
688563946,688561000,688577233,16233,2415,250
688584312,688581367,688597599,16232,2416,250
688604461,688601733,688620857,19124,2417,250
688627937,688624991,688643146,18155,2418,250
688650225,688647280,688664800,17520,2419,250
688671879,688668934,688688059,19125,2420,250
688695138,688692193,688709057,16864,2421,250
688716137,688713191,688730080,16889,2422,250
688737158,688734214,688753654,19440,2423,250
688760733,688757788,688775625,17837,2424,250
688782703,688779759,688795992,16233,2425,250
688802855,688800126,688817942,17816,2426,250
688825022,688822076,688840884,18808,2427,250
688847964,688845018,688862539,17521,2428,250
688869618,688866673,688883856,17183,2429,250
688890936,688887990,688902957,14967,2430,250
688910036,688907090,688922372,15282,2431,250
688929451,688926505,688944342,17837,2432,250
688951421,688948476,688964077,15601,2433,250
688971155,688968210,688987018,18808,2434,250
688993880,688991152,689009305,18153,2435,250
689016386,689013439,689030644,17205,2436,250
689037724,689034778,689051012,16234,2437,250
689058091,689055146,689072666,17520,2438,250
689079746,689076800,689095925,19125,2439,250
689103005,689100059,689119502,19443,2440,250
689126581,689123636,689141790,18154,2441,250
689148870,689145924,689162157,16233,2442,250
689169236,689166291,689182524,16233,2443,250
689189388,689186658,689203863,17205,2444,250
689210944,689207997,689225204,17207,2445,250
689232068,689229338,689247810,18472,2446,250
689254891,689251945,689268517,16572,2447,250
689275598,689272651,689292093,19442,2448,250
689299172,689296227,689315351,19124,2449,250
689322215,689319485,689337641,18156,2450,250
689344720,689341775,689360584,18809,2451,250
689367662,689364718,689382553,17835,2452,250
689389633,689386687,689404186,17499,2453,250
689411266,689408320,689425187,16867,2454,250
689432266,689429321,689446841,17520,2455,250
689453920,689450975,689470416,19441,2456,250
689477496,689474550,689492071,17521,2457,250
689499152,689496205,689514677,18472,2458,250
689521757,689518811,689538254,19443,2459,250
689545334,689542388,689560226,17838,2460,250
689567306,689564361,689581249,16888,2461,250
689588328,689585383,689600982,15599,2462,250
689608060,689605115,689621982,16867,2463,250
689628844,689626116,689643636,17520,2464,250
689650715,689647770,689665608,17838,2465,250
689672688,689669742,689686631,16889,2466,250
689693710,689690765,689707313,16548,2467,250
689714392,689711447,689727363,15916,2468,250
689734442,689731497,689747730,16233,2469,250
689754810,689751864,689770334,18470,2470,250
689777414,689774468,689792307,17839,2471,250
689799387,689796441,689815883,19442,2472,250
689822964,689820017,689838173,18156,2473,250
689845253,689842307,689861094,18787,2474,250
689868175,689865228,689881779,16551,2475,250
689888641,689885913,689902147,16234,2476,250
689909227,689906281,689923803,17522,2477,250
689930882,689927937,689945120,17183,2478,250
689952199,689949254,689965508,16254,2479,250
689972588,689969642,689987163,17521,2480,250
689994243,689991297,690009767,18470,2481,250
690016630,690013901,690031085,17184,2482,250
690038164,690035219,690052737,17518,2483,250
690059817,690056871,690072471,15600,2484,250
690079550,690076604,690092521,15917,2485,250
690099600,690096655,690113205,16550,2486,250
690120285,690117339,690133890,16551,2487,250
690140970,690138024,690155230,17206,2488,250
690162310,690159364,690175915,16551,2489,250
690182995,690180050,690199492,19442,2490,250
690206572,690203626,690222752,19126,2491,250
690229832,690226886,690244089,17203,2492,250
690251168,690248223,690266714,18491,2493,250
690273793,690270848,690288368,17520,2494,250
690295447,690292502,690309052,16550,2495,250
690315915,690313186,690332311,19125,2496,250
690339391,690336445,690354600,18155,2497,250
690361678,690358734,690375283,16549,2498,250
690382362,690379417,690395334,15917,2499,250
690402196,690399467,690416672,17205,2500,250
690423750,690420806,690438958,18152,2501,250
690446037,690443092,690460296,17204,2502,250
690467158,690464430,690481949,17519,2503,250
690489028,690486083,690501999,15916,2504,250
690509078,690506132,690521732,15600,2505,250
690528594,690525865,690541150,15285,2506,250
690548231,690545284,690561517,16233,2507,250
690568596,690565651,690583488,17837,2508,250
690590351,690587622,690605776,18154,2509,250
690612855,690609910,690627430,17520,2510,250
690634510,690631564,690650036,18472,2511,250
690657116,690654170,690671037,16867,2512,250
690678117,690675171,690692039,16868,2513,250
690698902,690696173,690712724,16551,2514,250
690719805,690716858,690734359,17501,2515,250
690741438,690738493,690756330,17837,2516,250
690763193,690760465,690777014,16549,2517,250
690784093,690781148,690800273,19125,2518,250
690807137,690804407,690821909,17502,2519,250
690828988,690826043,690842593,16550,2520,250
690849672,690846727,690864881,18154,2521,250
690871959,690869015,690886219,17204,2522,250
690893081,690890353,690907874,17521,2523,250
690914953,690912008,690929528,17520,2524,250
690936608,690933662,690950234,16572,2525,250
690957097,690954368,690970285,15917,2526,250
690977364,690974419,690991307,16888,2527,250
690998387,690995442,691012013,16571,2528,250
691019093,691016147,691033668,17521,2529,250
691040531,691037802,691054352,16550,2530,250
691061431,691058486,691076323,17837,2531,250
691083402,691080457,691098294,17837,2532,250
691105374,691102428,691118661,16233,2533,250
691125740,691122795,691142236,19441,2534,250
691149098,691146370,691164207,17837,2535,250
691171289,691168342,691185548,17206,2536,250
691192628,691189682,691205284,15602,2537,250
691212363,691209417,691226937,17520,2538,250
691234017,691231071,691248593,17522,2539,250
691255672,691252727,691270565,17838,2540,250
691277645,691274699,691291904,17205,2541,250
691298983,691296038,691311954,15916,2542,250
691319031,691316087,691332319,16232,2543,250
691339398,691336453,691353002,16549,2544,250
691360081,691357136,691375627,18491,2545,250
691382706,691379761,691397915,18154,2546,250
691404994,691402049,691419251,17202,2547,250
691426331,691423385,691440273,16888,2548,250
691447354,691444407,691460640,16233,2549,250
691467720,691464774,691480374,15600,2550,250
691487452,691484507,691500423,15916,2551,250
691507501,691504556,691522394,17838,2552,250
691529474,691526528,691543078,16550,2553,250
691550158,691547212,691565366,18154,2554,250
691572230,691569500,691588308,18808,2555,250
691595171,691592442,691611935,19493,2556,250
691619014,691616069,691633252,17183,2557,250
691640332,691637386,691653937,16551,2558,250
691661016,691658071,691675274,17203,2559,250
691682352,691679408,691695640,16232,2560,250
691702720,691699775,691717296,17521,2561,250
691724376,691721430,691737348,15918,2562,250
691744427,691741482,691759635,18153,2563,250
691766716,691763770,691779054,15284,2564,250
691786134,691783187,691799738,16551,2565,250
691806818,691803873,691820423,16550,2566,250
691827504,691824558,691843683,19125,2567,250
691850762,691847817,691864366,16549,2568,250
691871229,691868501,691886001,17500,2569,250
691893081,691890136,691908943,18807,2570,250
691916023,691913078,691930915,17837,2571,250
691937779,691935050,691952887,17837,2572,250
691959967,691957022,691974839,17817,2573,250
691981920,691978974,691998100,19126,2574,250
692005180,692002235,692020388,18153,2575,250
692027468,692024523,692040439,15916,2576,250
692047302,692044573,692061124,16551,2577,250
692068205,692065259,692083731,18472,2578,250
692090810,692087865,692103780,15915,2579,250
692110642,692107914,692126701,18787,2580,250
692133781,692130836,692149307,18471,2581,250
692156388,692153442,692169993,16551,2582,250
692177074,692174127,692190678,16551,2583,250
692197758,692194812,692209779,14967,2584,250
692216858,692213913,692229196,15283,2585,250
692236274,692233330,692249246,15916,2586,250
692256325,692253380,692271533,18153,2587,250
692278396,692275667,692294158,18491,2588,250
692301020,692298292,692315473,17181,2589,250
692322553,692319608,692337762,18154,2590,250
692344843,692341897,692357182,15285,2591,250
692364260,692361315,692377232,15917,2592,250
692384094,692381366,692398569,17203,2593,250
692405649,692402704,692420858,18154,2594,250
692427938,692424993,692441881,16888,2595,250
692448959,692446015,692462564,16549,2596,250
692469645,692466699,692482617,15918,2597,250
692489696,692486751,692503636,16885,2598,250
692510715,692507770,692524636,16866,2599,250
692531717,692528771,692546926,18155,2600,250
692554006,692551061,692568244,17183,2601,250
692575324,692572378,692590850,18472,2602,250
692597930,692594984,692611871,16887,2603,250
692618951,692616005,692632240,16235,2604,250
692639320,692636375,692654211,17836,2605,250
692661290,692658345,692677131,18786,2606,250
692684210,692681265,692699736,18471,2607,250
692706817,692703871,692721372,17501,2608,250
692728452,692725507,692742710,17203,2609,250
692749790,692746844,692765652,18808,2610,250
692772732,692769787,692787941,18154,2611,250
692795019,692792075,692808961,16886,2612,250
692816041,692813095,692830933,17838,2613,250
692838012,692835067,692851933,16866,2614,250
692859014,692856068,692873905,17837,2615,250
692880984,692878039,692895558,17519,2616,250
692902637,692899692,692918479,18787,2617,250
692925559,692922614,692939480,16866,2618,250
692946560,692943615,692959531,15916,2619,250
692966610,692963665,692982788,19123,2620,250
692989650,692986922,693005391,18469,2621,250
693012472,693009526,693027047,17521,2622,250
693034128,693031181,693047099,15918,2623,250
693054179,693051233,693068100,16867,2624,250
693074962,693072234,693087201,14967,2625,250
693094281,693091335,693108519,17184,2626,250
693115599,693112654,693131125,18471,2627,250
693138205,693135260,693151493,16233,2628,250
693158573,693155627,693172494,16867,2629,250
693179574,693176629,693194128,17499,2630,250
693201207,693198263,693214179,15916,2631,250
693221259,693218313,693236152,17839,2632,250
693243232,693240287,693256203,15916,2633,250
693263283,693260337,693278173,17836,2634,250
693285253,693282307,693300461,18154,2635,250
693307540,693304595,693322092,17497,2636,250
693329172,693326227,693343727,17500,2637,250
693350807,693347862,693364095,16233,2638,250
693370959,693368230,693385411,17181,2639,250
693392492,693389546,693407068,17522,2640,250
693414147,693411202,693426485,15283,2641,250
693433564,693430619,693446218,15599,2642,250
693453297,693450352,693467872,17520,2643,250
693474953,693472007,693489212,17205,2644,250
693496291,693493346,693510529,17183,2645,250
693517609,693514663,693532500,17837,2646,250
693539581,693536635,693553501,16866,2647,250
693560582,693557635,693574820,17185,2648,250
693581899,693578954,693598394,19440,2649,250
693605474,693602529,693620049,17520,2650,250
693627129,693624184,693642972,18788,2651,250
693650053,693647107,693664945,17838,2652,250
693672025,693669080,693685630,16550,2653,250
693692710,693689765,693707602,17837,2654,250
693714683,693711736,693729237,17501,2655,250
693736317,693733372,693750892,17520,2656,250
693757972,693755027,693772547,17520,2657,250
693779409,693776682,693793546,16864,2658,250
693800625,693797680,693815834,18154,2659,250
693822913,693819968,693836538,16570,2660,250
693843617,693840672,693857222,16550,2661,250
693864084,693861357,693877906,16549,2662,250
693884986,693882041,693897958,15917,2663,250
693905038,693902092,693918959,16867,2664,250
693926040,693923094,693940932,17838,2665,250
693948012,693945067,693961934,16867,2666,250
693969014,693966068,693983588,17520,2667,250
693990668,693987723,694003640,15917,2668,250
694010719,694007774,694024007,16233,2669,250
694031088,694028142,694046614,18472,2670,250
694053695,694050749,694069240,18491,2671,250
694076320,694073375,694091529,18154,2672,250
694098610,694095664,694113501,17837,2673,250
694120582,694117636,694135157,17521,2674,250
694142238,694139292,694157447,18155,2675,250
694164527,694161582,694180707,19125,2676,250
694187788,694184842,694202658,17816,2677,250
694209738,694206793,694223976,17183,2678,250
694231057,694228111,694246265,18154,2679,250
694253345,694250400,694268553,18153,2680,250
694275633,694272688,694289237,16549,2681,250
694296317,694293372,694311864,18492,2682,250
694318945,694315999,694331284,15285,2683,250
694338148,694335418,694351019,15601,2684,250
694358099,694355154,694371704,16550,2685,250
694378783,694375839,694392072,16233,2686,250
694399153,694396207,694413413,17206,2687,250
694420493,694417548,694435384,17836,2688,250
694442464,694439519,694455435,15916,2689,250
694462514,694459569,694477405,17836,2690,250
694484487,694481540,694497459,15919,2691,250
694504538,694501593,694517510,15917,2692,250
694524590,694521645,694538848,17203,2693,250
694545710,694542982,694559553,16571,2694,250
694566633,694563688,694581842,18154,2695,250
694588922,694585977,694601893,15916,2696,250
694608972,694606027,694623232,17205,2697,250
694630313,694627367,694645523,18156,2698,250
694652603,694649658,694668127,18469,2699,250
694675208,694672262,694689763,17501,2700,250
694696843,694693898,694711736,17838,2701,250
694718815,694715870,694733391,17521,2702,250
694740471,694737525,694753127,15602,2703,250
694760207,694757261,694774467,17206,2704,250
694781547,694778601,694795468,16867,2705,250
694802548,694799602,694816470,16868,2706,250
694823550,694820604,694836838,16234,2707,250
694843918,694840973,694859464,18491,2708,250
694866546,694863599,694880151,16552,2709,250
694887230,694884285,694900200,15915,2710,250
694907280,694904334,694922171,17837,2711,250
694929252,694926306,694942223,15917,2712,250
694949303,694946357,694964174,17817,2713,250
694971255,694968309,694986148,17839,2714,250
694993228,694990283,695006516,16233,2715,250
695013597,695010651,695025935,15284,2716,250
695033015,695030069,695046620,16551,2717,250
695053700,695050755,695067304,16549,2718,250
695074384,695071438,695087356,15918,2719,250
695094435,695091490,695108671,17181,2720,250
695115751,695112805,695128407,15602,2721,250
695135486,695132541,695150694,18153,2722,250
695157773,695154828,695172033,17205,2723,250
695179113,695176167,695193056,16889,2724,250
695200136,695197191,695214712,17521,2725,250
695221575,695218846,695234447,15601,2726,250
695241526,695238581,695255130,16549,2727,250
695261993,695259264,695276130,16866,2728,250
695283210,695280265,695299390,19125,2729,250
695306471,695303525,695322333,18808,2730,250
695329413,695326468,695344621,18153,2731,250
695351700,695348755,695366930,18175,2732,250
695374010,695371065,695387298,16233,2733,250
695394377,695391432,695408299,16867,2734,250
695415380,695412434,695431875,19441,2735,250
695438956,695436010,695452561,16551,2736,250
695459642,695456696,695474218,17522,2737,250
695481298,695478353,695495873,17520,2738,250
695502953,695500008,695518815,18807,2739,250
695525896,695522950,695540787,17837,2740,250
695547867,695544922,695563413,18491,2741,250
695570277,695567548,695583466,15918,2742,250
695590546,695587600,695604488,16888,2743,250
695611569,695608623,695627093,18470,2744,250
695634174,695631228,695648750,17522,2745,250
695655831,695652885,695671693,18808,2746,250
695678774,695675828,695693349,17521,2747,250
695700430,695697484,695715660,18176,2748,250
695722741,695719795,695735713,15918,2749,250
695742792,695739847,695756396,16549,2750,250
695763475,695760531,695778050,17519,2751,250
695785130,695782185,695799052,16867,2752,250
695806133,695803187,695821340,18153,2753,250
695828421,695825475,695842660,17185,2754,250
695849741,695846795,695861763,14968,2755,250
695868842,695865897,695881179,15282,2756,250
695888259,695885313,695901231,15918,2757,250
695908310,695905365,695922232,16867,2758,250
695929313,695926367,695943233,16866,2759,250
695950313,695947368,695963602,16234,2760,250
695970466,695967737,695985574,17837,2761,250
695992654,695989709,696005626,15917,2762,250
696012706,696009760,696025044,15284,2763,250
696032123,696029178,696045410,16232,2764,250
696052490,696049545,696064829,15284,2765,250
696071909,696068963,696086799,17836,2766,250
696093879,696090934,696109741,18807,2767,250
696116821,696113876,696131711,17835,2768,250
696138791,696135846,696150812,14966,2769,250
696157891,696154946,696171495,16549,2770,250
696178358,696175630,696193151,17521,2771,250
696200015,696197286,696214175,16889,2772,250
696221256,696218310,696234859,16549,2773,250
696241939,696238994,696257147,18153,2774,250
696264228,696261282,696279753,18471,2775,250
696286834,696283888,696300438,16550,2776,250
696307518,696304573,696321775,17202,2777,250
696328856,696325910,696343432,17522,2778,250
696350512,696347566,696364433,16867,2779,250
696371512,696368567,696387692,19125,2780,250
696394556,696391827,696409032,17205,2781,250
696416112,696413166,696430053,16887,2782,250
696436915,696434187,696452340,18153,2783,250
696459421,696456475,696473996,17521,2784,250
696481075,696478130,696495333,17203,2785,250
696502413,696499467,696517303,17836,2786,250
696524383,696521437,696537670,16233,2787,250
696544750,696541804,696557722,15918,2788,250
696564801,696561856,696578722,16866,2789,250
696585801,696582856,696600693,17837,2790,250
696607773,696604828,696622664,17836,2791,250
696629744,696626799,696644637,17838,2792,250
696651717,696648772,696666608,17836,2793,250
696673688,696670742,696686025,15283,2794,250
696693104,696690159,696706730,16571,2795,250
696713810,696710865,696726782,15917,2796,250
696733861,696730916,696748753,17837,2797,250
696755834,696752888,696769755,16867,2798,250
696776835,696773890,696789490,15600,2799,250
696796570,696793624,696809857,16233,2800,250
696816936,696813991,696830561,16570,2801,250
696837642,696834696,696854137,19441,2802,250
696861216,696858272,696876742,18470,2803,250
696883822,696880876,696898713,17837,2804,250
696905792,696902847,696919397,16550,2805,250
696926261,696923532,696941707,18175,2806,250
696948788,696945842,696963679,17837,2807,250
696970760,696967813,696984363,16550,2808,250
696991442,696988497,697006334,17837,2809,250
697013414,697010469,697027990,17521,2810,250
697035071,697032125,697050597,18472,2811,250
697057677,697054731,697071914,17183,2812,250
697078995,697076049,697093233,17184,2813,250
697100314,697097367,697116809,19442,2814,250
697123890,697120944,697138148,17204,2815,250
697145228,697142283,697161723,19440,2816,250
697168802,697165857,697182090,16233,2817,250
697188954,697186225,697203091,16866,2818,250
697210173,697207226,697222510,15284,2819,250
697229588,697226644,697243846,17202,2820,250
697250926,697247981,697264214,16233,2821,250
697271295,697268349,697284900,16551,2822,250
697291980,697289035,697305605,16570,2823,250
697312685,697309739,697326943,17204,2824,250
697334023,697331078,697347627,16549,2825,250
697354707,697351762,697368311,16549,2826,250
697375391,697372445,697389650,17205,2827,250
697396511,697393784,697410333,16549,2828,250
697417412,697414467,697429750,15283,2829,250
697436830,697433884,697453008,19124,2830,250
697460090,697457143,697474982,17839,2831,250
697481844,697479116,697501140,22024,2832,250
697508223,697505275,697522777,17502,2833,250
697529858,697526912,697544434,17522,2834,250
697551513,697548569,697563534,14965,2835,250
697570615,697567668,697582638,14970,2836,250
697589716,697586772,697602688,15916,2837,250
697609768,697606822,697624976,18154,2838,250
697632056,697629110,697646948,17838,2839,250
697654028,697651083,697668603,17520,2840,250
697675683,697672737,697688972,16235,2841,250
697696052,697693106,697711894,18788,2842,250
697718973,697716028,697732262,16234,2843,250
697739342,697736396,697754550,18154,2844,250
697761630,697758685,697775573,16888,2845,250
697782654,697779707,697797546,17839,2846,250
697804408,697801680,697817914,16234,2847,250
697824777,697822048,697837966,15918,2848,250
697845046,697842100,697858967,16867,2849,250
697866048,697863102,697879989,16887,2850,250
697887069,697884124,697899723,15599,2851,250
697906585,697903857,697922009,18152,2852,250
697929087,697926143,697943980,17837,2853,250
697951059,697948115,697964663,16548,2854,250
697971743,697968798,697987921,19123,2855,250
697995000,697992055,698007339,15284,2856,250
698014417,698011473,698029625,18152,2857,250
698036705,698033760,698051598,17838,2858,250
698058678,698055732,698071332,15600,2859,250
698078411,698075466,698092648,17182,2860,250
698099729,698096783,698112067,15284,2861,250
698118929,698116201,698134355,18154,2862,250
698141436,698138490,698157300,18810,2863,250
698164380,698161435,698176401,14966,2864,250
698183481,698180535,698197086,16551,2865,250
698204167,698201221,698217771,16550,2866,250
698224852,698221906,698239428,17522,2867,250
698246508,698243563,698262371,18808,2868,250
698269453,698266506,698282742,16236,2869,250
698289822,698286877,698303743,16866,2870,250
698310823,698307878,698323795,15917,2871,250
698330874,698327929,698344796,16867,2872,250
698351877,698348931,698365165,16234,2873,250
698372244,698369299,698386481,17182,2874,250
698393561,698390615,698407799,17184,2875,250
698414662,698411933,698430088,18155,2876,250
698437167,698434222,698451108,16886,2877,250
698458188,698455243,698471476,16233,2878,250
698478555,698475610,698493764,18154,2879,250
698500844,698497899,698515102,17203,2880,250
698522181,698519237,698535467,16230,2881,250
698542546,698539602,698558071,18469,2882,250
698565151,698562206,698580042,17836,2883,250
698587121,698584176,698603300,19124,2884,250
698610381,698607435,698625274,17839,2885,250
698632353,698629408,698646908,17500,2886,250
698653771,698651042,698668563,17521,2887,250
698675645,698672698,698687983,15285,2888,250
698695062,698692117,698709004,16887,2889,250
698716084,698713139,698731610,18471,2890,250
698738689,698735744,698752610,16866,2891,250
698759690,698756744,698775869,19125,2892,250
698782950,698780004,698797209,17205,2893,250
698804289,698801344,698817894,16550,2894,250
698824973,698822028,698839210,17182,2895,250
698846072,698843344,698861160,17816,2896,250
698868240,698865294,698883765,18471,2897,250
698890845,698887900,698905103,17203,2898,250
698912183,698909238,698925787,16549,2899,250
698932867,698929922,698947758,17836,2900,250
698954623,698951893,698968782,16889,2901,250
698975862,698972917,698991388,18471,2902,250
698998469,698995523,699012707,17184,2903,250
699019786,699016841,699032442,15601,2904,250
699039523,699036576,699053782,17206,2905,250
699060863,699057917,699074467,16550,2906,250
699081547,699078602,699097093,18491,2907,250
699104174,699101228,699120353,19125,2908,250
699127433,699124488,699139456,14968,2909,250
699146536,699143590,699162061,18471,2910,250
699169141,699166196,699184012,17816,2911,250
699191092,699188147,699206301,18154,2912,250
699213381,699210436,699227302,16866,2913,250
699234383,699231437,699248959,17522,2914,250
699256039,699253094,699271564,18470,2915,250
699278426,699275698,699294506,18808,2916,250
699301585,699298641,699316793,18152,2917,250
699323875,699320928,699335896,14968,2918,250
699342976,699340030,699357847,17817,2919,250
699364927,699361982,699379502,17520,2920,250
699386583,699383637,699399554,15917,2921,250
699406634,699403688,699419605,15917,2922,250
699426685,699423739,699439657,15918,2923,250
699446519,699443791,699460341,16550,2924,250
699467421,699464476,699479759,15283,2925,250
699486839,699483893,699502048,18155,2926,250
699509129,699506183,699523705,17522,2927,250
699530786,699527840,699543758,15918,2928,250
699550837,699547892,699566363,18471,2929,250
699573443,699570498,699589305,18807,2930,250
699596169,699593440,699609673,16233,2931,250
699616753,699613808,699633249,19441,2932,250
699640329,699637384,699654904,17520,2933,250
699661768,699659039,699674957,15918,2934,250
699682036,699679091,699696295,17204,2935,250
699703375,699700430,699716978,16548,2936,250
699724058,699721113,699737663,16550,2937,250
699744744,699741798,699758982,17184,2938,250
699765845,699763117,699778083,14966,2939,250
699784946,699782217,699799106,16889,2940,250
699806187,699803241,699821079,17838,2941,250
699828159,699825214,699842418,17204,2942,250
699849500,699846553,699865679,19126,2943,250
699872760,699869814,699886682,16868,2944,250
699893546,699890817,699907684,16867,2945,250
699914767,699911819,699928371,16552,2946,250
699935452,699932506,699950005,17499,2947,250
699957086,699954140,699972633,18493,2948,250
699979713,699976768,699993972,17204,2949,250
700000836,699998107,700014341,16234,2950,250
700021422,700018476,700035682,17206,2951,250
700042763,700039817,700058604,18787,2952,250
700065684,700062739,700079604,16865,2953,250
700086685,700083739,700100943,17204,2954,250
700108023,700105078,700124203,19125,2955,250
700131283,700128338,700146809,18471,2956,250
700153889,700150944,700168761,17817,2957,250
700175625,700172896,700190397,17501,2958,250
700197478,700194532,700212687,18155,2959,250
700219766,700216822,700233054,16232,2960,250
700240134,700237189,700255996,18807,2961,250
700262860,700260131,700279256,19125,2962,250
700286336,700283391,700300574,17183,2963,250
700307655,700304709,700320627,15918,2964,250
700327707,700324761,700340996,16235,2965,250
700348078,700345131,700362316,17185,2966,250
700369398,700366451,700383341,16890,2967,250
700390421,700387476,700404363,16887,2968,250
700411444,700408498,700425047,16549,2969,250
700432128,700429182,700447336,18154,2970,250
700454416,700451470,700469963,18493,2971,250
700477044,700474098,700490015,15917,2972,250
700497094,700494149,700512620,18471,2973,250
700519700,700516755,700534276,17521,2974,250
700541141,700538411,700555596,17185,2975,250
700562676,700559731,700577569,17838,2976,250
700584649,700581704,700598908,17204,2977,250
700605989,700603043,700621198,18155,2978,250
700628278,700625333,700642536,17203,2979,250
700649400,700646671,700665479,18808,2980,250
700672559,700669614,700686819,17205,2981,250
700693683,700690954,700709763,18809,2982,250
700716843,700713898,700730448,16550,2983,250
700737530,700734583,700751473,16890,2984,250
700758337,700755608,700772180,16572,2985,250
700779260,700776315,700793518,17203,2986,250
700800599,700797653,700815173,17520,2987,250
700822254,700819308,700836514,17206,2988,250
700843595,700840649,700857854,17205,2989,250
700864934,700861989,700879827,17838,2990,250
700886907,700883962,700900848,16886,2991,250
700907928,700904983,700924107,19124,2992,250
700931188,700928242,700945447,17205,2993,250
700952527,700949582,700966786,17204,2994,250
700973866,700970921,700987787,16866,2995,250
700994868,700991922,701010075,18153,2996,250
701017155,701014210,701031096,16886,2997,250
701038177,701035231,701051782,16551,2998,250
701058862,701055917,701072151,16234,2999,250
701079232,701076286,701092857,16571,3000,250
701099939,701096992,701116436,19444,3001,250
701123516,701120571,701135854,15283,3002,250
701142933,701139988,701156538,16550,3003,250
701163618,701160673,701176907,16234,3004,250
701183988,701181042,701197593,16551,3005,250
701204675,701201728,701219567,17839,3006,250
701226431,701223702,701240273,16571,3007,250
701247137,701244408,701262244,17836,3008,250
701269325,701266379,701284534,18155,3009,250
701291617,701288669,701307797,19128,3010,250
701314877,701311932,701328166,16234,3011,250
701335247,701332301,701348535,16234,3012,250
701355614,701352669,701371139,18470,3013,250
701378221,701375274,701392481,17207,3014,250
701399562,701396616,701414138,17522,3015,250
701421218,701418273,701437713,19440,3016,250
701444794,701441848,701457765,15917,3017,250
701464843,701461899,701479735,17836,3018,250
701486815,701483870,701501390,17520,3019,250
701508470,701505525,701522708,17183,3020,250
701529788,701526843,701542441,15598,3021,250
701549521,701546575,701563441,16866,3022,250
701570521,701567576,701585412,17836,3023,250
701592494,701589547,701607534,17987,3024,250
701614614,701611669,701628851,17182,3025,250
701635931,701632986,701650190,17204,3026,250
701657270,701654325,701672141,17816,3027,250
701679222,701676276,701694431,18155,3028,250
701701296,701698566,701715433,16867,3029,250
701722513,701719567,701738036,18469,3030,250
701745117,701742171,701757139,14968,3031,250
701764219,701761273,701778456,17183,3032,250
701785321,701782591,701798826,16235,3033,250
701805906,701802961,701818876,15915,3034,250
701825956,701823010,701838611,15601,3035,250
701845692,701842746,701858031,15285,3036,250
701865110,701862165,701877132,14967,3037,250
701884213,701881266,701897817,16551,3038,250
701904898,701901952,701918819,16867,3039,250
701925900,701922954,701938871,15917,3040,250
701945950,701943005,701958922,15917,3041,250
701966002,701963056,701981527,18471,3042,250
701988391,701985662,702002530,16868,3043,250
702009611,702006665,702025135,18470,3044,250
702032215,702029270,702046157,16887,3045,250
702053237,702050292,702067497,17205,3046,250
702074578,702071632,702089154,17522,3047,250
702096234,702093289,702108255,14966,3048,250
702115337,702112389,702129596,17207,3049,250
702136678,702133731,702150938,17207,3050,250
702158019,702155073,702171624,16551,3051,250
702178704,702175759,702195200,19441,3052,250
702202280,702199335,702218143,18808,3053,250
702225007,702222278,702239166,16888,3054,250
702246246,702243301,702258901,15600,3055,250
702265764,702263035,702282160,19125,3056,250
702289241,702286295,702303796,17501,3057,250
702310876,702307931,702325114,17183,3058,250
702332195,702329249,702344850,15601,3059,250
702351929,702348984,702364900,15916,3060,250
702371763,702369034,702386555,17521,3061,250
702393635,702390690,702409499,18809,3062,250
702416580,702413634,702432105,18471,3063,250
702439185,702436240,702452810,16570,3064,250
702459892,702456945,702473834,16889,3065,250
702480916,702477969,702494838,16869,3066,250
702501919,702498973,702516158,17185,3067,250
702523239,702520293,702538764,18471,3068,250
702545627,702542899,702561684,18785,3069,250
702568764,702565819,702583002,17183,3070,250
702590083,702587137,702604638,17501,3071,250
702611719,702608773,702628215,19442,3072,250
702635078,702632350,702648266,15916,3073,250
702655128,702652400,702670871,18471,3074,250
702677952,702675006,702694131,19125,3075,250
702701211,702698266,702717391,19125,3076,250
702724472,702721526,702739027,17501,3077,250
702746107,702743162,702760661,17499,3078,250
702767742,702764796,702780396,15600,3079,250
702787476,702784530,702801417,16887,3080,250
702808497,702805552,702822418,16866,3081,250
702829499,702826553,702841838,15285,3082,250
702848918,702845972,702862206,16234,3083,250
702869286,702866341,702881307,14966,3084,250
702888171,702885441,702902331,16890,3085,250
702909194,702906466,702924303,17837,3086,250
702931166,702928438,702947247,18809,3087,250
702954328,702951382,702969220,17838,3088,250
702976085,702973355,702988957,15602,3089,250
702995819,702993091,703008056,14965,3090,250
703015135,703012190,703030028,17838,3091,250
703037108,703034163,703050080,15917,3092,250
703057159,703054214,703071734,17520,3093,250
703078598,703075869,703092441,16572,3094,250
703099522,703096576,703113782,17206,3095,250
703120863,703117917,703136071,18154,3096,250
703142934,703140206,703156756,16550,3097,250
703163835,703160891,703180015,19124,3098,250
703187096,703184150,703200067,15917,3099,250
703207146,703204201,703221720,17519,3100,250
703228801,703225855,703241772,15917,3101,250
703248852,703245906,703263407,17501,3102,250
703270488,703267542,703282510,14968,3103,250
703289590,703286644,703303195,16551,3104,250
703310275,703307330,703323880,16550,3105,250
703330960,703328015,703344565,16550,3106,250
703351429,703348700,703365250,16550,3107,250
703372115,703369385,703385303,15918,3108,250
703392382,703389437,703405037,15600,3109,250
703412117,703409171,703427981,18810,3110,250
703435061,703432116,703448983,16867,3111,250
703456064,703453118,703469353,16235,3112,250
703476433,703473488,703490692,17204,3113,250
703497773,703494827,703510429,15602,3114,250
703517509,703514563,703530164,15601,3115,250
703537243,703534298,703551165,16867,3116,250
703558028,703555300,703572504,17204,3117,250
703579585,703576638,703592238,15600,3118,250
703599316,703596372,703612921,16549,3119,250
703620001,703617056,703634893,17837,3120,250
703641974,703639028,703655579,16551,3121,250
703662659,703659714,703675631,15917,3122,250
703682712,703679765,703696634,16869,3123,250
703703713,703700769,703718921,18152,3124,250
703726002,703723056,703741864,18808,3125,250
703748944,703745999,703763520,17521,3126,250
703770601,703767655,703784227,16572,3127,250
703791306,703788362,703805565,17203,3128,250
703812645,703809700,703826905,17205,3129,250
703833986,703831040,703847928,16888,3130,250
703855008,703852063,703867980,15917,3131,250
703875060,703872114,703891240,19126,3132,250
703898321,703895375,703912264,16889,3133,250
703919344,703916399,703934237,17838,3134,250
703941317,703938372,703954922,16550,3135,250
703962002,703959057,703976556,17499,3136,250
703983636,703980691,703998212,17521,3137,250
704005293,704002347,704021134,18787,3138,250
704028215,704025269,704042790,17521,3139,250
704049870,704046925,704064763,17838,3140,250
704071843,704068898,704086419,17521,3141,250
704093499,704090553,704106470,15917,3142,250
704113333,704110604,704126521,15917,3143,250
704133601,704130655,704147521,16866,3144,250
704154601,704151656,704168205,16549,3145,250
704175285,704172340,704189860,17520,3146,250
704196941,704193995,704210883,16888,3147,250
704217963,704215018,704232854,17836,3148,250
704239935,704236989,704255144,18155,3149,250
704262224,704259279,704277096,17817,3150,250
704284175,704281231,704298413,17182,3151,250
704305494,704302548,704319753,17205,3152,250
704326834,704323888,704341094,17206,3153,250
704348174,704345229,704361145,15916,3154,250
704368223,704365279,704383431,18152,3155,250
704390511,704387566,704406037,18471,3156,250
704413117,704410172,704426088,15916,3157,250
704432951,704430222,704447722,17500,3158,250
704454802,704451857,704467773,15916,3159,250
704474853,704471907,704490399,18492,3160,250
704497480,704494534,704511401,16867,3161,250
704518481,704515536,704534343,18807,3162,250
704541423,704538477,704554394,15917,3163,250
704561472,704558527,704573493,14966,3164,250
704580572,704577627,704593860,16233,3165,250
704600940,704597994,704615199,17205,3166,250
704622279,704619333,704634933,15600,3167,250
704642013,704639067,704655934,16867,3168,250
704663014,704660069,704677273,17204,3169,250
704684138,704681408,704697642,16234,3170,250
704704721,704701777,704718981,17204,3171,250
704726062,704723116,704740617,17501,3172,250
704747699,704744752,704762592,17840,3173,250
704769674,704766727,704783595,16868,3174,250
704790675,704787729,704804597,16868,3175,250
704811460,704808731,704827857,19126,3176,250
704834937,704831992,704851433,19441,3177,250
704858514,704855568,704874039,18471,3178,250
704881120,704878174,704894725,16551,3179,250
704901806,704898860,704917331,18471,3180,250
704924195,704921466,704938967,17501,3181,250
704946047,704943102,704960602,17500,3182,250
704967682,704964737,704981941,17204,3183,250
704989023,704986076,705002311,16235,3184,250
705009174,705006446,705022994,16548,3185,250
705029857,705027129,705044965,17836,3186,250
705052045,705049100,705065967,16867,3187,250
705073047,705070102,705088255,18153,3188,250
705095336,705092390,705108308,15918,3189,250
705115387,705112442,705130910,18468,3190,250
705137990,705135045,705150645,15600,3191,250
705157724,705154779,705173902,19123,3192,250
705180982,705178037,705195873,17836,3193,250
705202737,705200008,705217825,17817,3194,250
705224906,705221960,705236927,14967,3195,250
705244006,705241061,705258265,17204,3196,250
705265346,705262400,705279268,16868,3197,250
705286348,705283403,705299319,15916,3198,250
705306399,705303453,705321945,18492,3199,250
705329025,705326080,705345205,19125,3200,250
705352285,705349340,705367493,18153,3201,250
705374574,705371628,705389150,17522,3202,250
705396230,705393284,705412093,18809,3203,250
705419172,705416227,705435668,19441,3204,250
705442748,705439803,705456352,16549,3205,250
705463431,705460486,705476718,16232,3206,250
705483797,705480852,705498690,17838,3207,250
705505771,705502825,705519692,16867,3208,250
705526773,705523827,705541011,17184,3209,250
705548091,705545146,705561696,16550,3210,250
705568775,705565830,705583666,17836,3211,250
705590747,705587801,705604036,16235,3212,250
705610898,705608170,705624720,16550,3213,250
705631799,705628854,705646374,17520,3214,250
705653455,705650508,705668031,17523,3215,250
705675110,705672165,705689684,17519,3216,250
705696764,705693819,705710706,16887,3217,250
705717786,705714841,705732362,17521,3218,250
705739443,705736497,705754651,18154,3219,250
705761731,705758785,705776622,17837,3220,250
705783485,705780757,705798276,17519,3221,250
705805357,705802411,705818012,15601,3222,250
705824875,705822146,705839668,17522,3223,250
705846748,705843803,705860036,16233,3224,250
705867116,705864170,705880088,15918,3225,250
705887168,705884222,705899507,15285,3226,250
705906586,705903641,705919874,16233,3227,250
705926953,705924009,705941845,17836,3228,250
705948926,705945980,705964450,18470,3229,250
705971312,705968584,705985132,16548,3230,250
705992212,705989267,706004550,15283,3231,250
706011629,706008684,706027492,18808,3232,250
706034573,706031627,706049782,18155,3233,250
706056862,706053917,706071754,17837,3234,250
706078834,706075888,706092437,16549,3235,250
706099517,706096572,706114703,18131,3236,250
706121783,706118838,706135703,16865,3237,250
706142784,706139838,706157655,17817,3238,250
706164738,706161790,706179609,17819,3239,250
706186689,706183743,706202552,18809,3240,250
706209632,706206687,706223573,16886,3241,250
706230653,706227708,706244574,16866,3242,250
706251655,706248709,706267835,19126,3243,250
706274915,706271970,706289490,17520,3244,250
706296570,706293625,706310829,17204,3245,250
706317909,706314964,706331197,16233,3246,250
706338277,706335332,706350932,15600,3247,250
706358011,706355066,706371954,16888,3248,250
706379034,706376089,706392323,16234,3249,250
706399404,706396458,706414296,17838,3250,250
706421376,706418431,706434348,15917,3251,250
706441428,706438482,706457924,19442,3252,250
706465004,706462058,706481499,19441,3253,250
706488578,706485634,706502182,16548,3254,250
706509264,706506317,706524810,18493,3255,250
706531889,706528944,706547415,18471,3256,250
706554497,706551550,706570360,18810,3257,250
706577440,706574495,706590095,15600,3258,250
706596957,706594229,706610779,16550,3259,250
706617859,706614914,706630195,15281,3260,250
706637275,706634329,706652800,18471,3261,250
706659663,706656934,706673801,16867,3262,250
706680881,706677935,706697061,19126,3263,250
706704142,706701196,706719035,17839,3264,250
706726115,706723170,706739404,16234,3265,250
706746485,706743539,706761060,17521,3266,250
706768141,706765195,706783665,18470,3267,250
706790746,706787800,706805639,17839,3268,250
706812719,706809774,706826324,16550,3269,250
706833403,706830458,706846059,15601,3270,250
706853138,706850193,706868980,18787,3271,250
706876060,706873115,706890931,17816,3272,250
706898012,706895066,706912903,17837,3273,250
706919983,706917038,706932638,15600,3274,250
706939717,706936772,706955241,18469,3275,250
706962321,706959376,706977213,17837,3276,250
706984294,706981348,706998216,16868,3277,250
707005297,707002351,707020189,17838,3278,250
707027270,707024324,707041507,17183,3279,250
707048588,707045642,707062825,17183,3280,250
707069906,707066960,707082562,15602,3281,250
707089426,707086696,707105483,18787,3282,250
707112563,707109618,707127453,17835,3283,250
707134316,707131588,707148138,16550,3284,250
707155218,707152273,707168506,16233,3285,250
707175585,707172640,707189189,16549,3286,250
707196270,707193324,707212449,19125,3287,250
707219529,707216584,707233450,16866,3288,250
707240314,707237584,707254157,16573,3289,250
707261238,707258292,707274210,15918,3290,250
707281289,707278344,707296497,18153,3291,250
707303360,707300631,707318150,17519,3292,250
707325232,707322285,707340758,18473,3293,250
707347839,707344893,707361760,16867,3294,250
707368624,707365895,707384028,18133,3295,250
707391108,707388163,707406632,18469,3296,250
707413712,707410767,707427950,17183,3297,250
707435029,707432085,707448951,16866,3298,250
707455813,707453086,707471556,18470,3299,250
707478637,707475691,707491609,15918,3300,250
707498473,707495743,707511979,16236,3301,250
707519059,707516114,707535239,19125,3302,250
707542320,707539374,707555608,16234,3303,250
707562688,707559743,707577896,18153,3304,250
707584760,707582031,707598898,16867,3305,250
707605979,707603033,707620534,17501,3306,250
707627615,707624669,707640902,16233,3307,250
707647983,707645037,707660639,15602,3308,250
707667718,707664773,707681660,16887,3309,250
707688740,707685794,707703316,17522,3310,250
707710395,707707451,707724633,17182,3311,250
707731498,707728768,707745636,16868,3312,250
707752718,707749771,707765689,15918,3313,250
707772768,707769823,707788609,18786,3314,250
707795689,707792744,707808028,15284,3315,250
707815106,707812161,707829997,17836,3316,250
707837077,707834132,707850049,15917,3317,250
707857128,707854183,707872970,18787,3318,250
707880051,707877104,707894289,17185,3319,250
707901369,707898424,707914656,16232,3320,250
707921738,707918791,707935975,17184,3321,250
707943056,707940110,707956027,15917,3322,250
707963105,707960160,707975759,15599,3323,250
707982839,707979893,707997731,17838,3324,250
708004812,708001866,708019703,17837,3325,250
708026783,708023837,708040387,16550,3326,250
708047467,708044522,708060755,16233,3327,250
708067619,708064890,708081440,16550,3328,250
708088521,708085575,708103392,17817,3329,250
708110473,708107527,708125027,17500,3330,250
708132107,708129162,708146999,17837,3331,250
708154078,708151134,708167704,16570,3332,250
708174784,708171838,708188388,16550,3333,250
708195250,708192523,708209072,16549,3334,250
708216154,708213207,708231994,18787,3335,250
708239074,708236129,708254936,18807,3336,250
708262017,708259071,708275959,16888,3337,250
708283041,708280094,708296962,16868,3338,250
708304042,708301097,708317647,16550,3339,250
708324727,708321782,708337381,15599,3340,250
708344461,708341515,708357750,16235,3341,250
708364614,708361885,708378752,16867,3342,250
708385833,708382887,708399437,16550,3343,250
708406517,708403572,708418538,14966,3344,250
708425617,708422672,708438589,15917,3345,250
708445669,708442723,708460857,18134,3346,250
708467937,708464992,708483462,18470,3347,250
708490540,708487596,708503829,16233,3348,250
708510909,708507964,708523565,15601,3349,250
708530645,708527699,708546170,18471,3350,250
708553250,708550305,708568774,18469,3351,250
708575854,708572909,708588509,15600,3352,250
708595372,708592643,708610459,17816,3353,250
708617538,708614594,708629876,15282,3354,250
708636956,708634010,708650245,16235,3355,250
708657324,708654379,708672533,18154,3356,250
708679396,708676667,708695159,18492,3357,250
708702240,708699294,708715845,16551,3358,250
708722925,708719980,708738133,18153,3359,250
708745212,708742268,708758184,15916,3360,250
708765263,708762318,708779205,16887,3361,250
708786284,708783339,708800544,17205,3362,250
708807623,708804678,708820277,15599,3363,250
708827357,708824411,708839695,15284,3364,250
708846774,708843829,708861666,17837,3365,250
708868746,708865801,708881401,15600,3366,250
708888480,708885535,708903371,17836,3367,250
708910451,708907506,708925343,17837,3368,250
708932424,708929478,708945396,15918,3369,250
708952474,708949530,708967682,18152,3370,250
708974762,708971817,708987418,15601,3371,250
708994497,708991552,709007784,16232,3372,250
709014865,709011919,709027519,15600,3373,250
709034598,709031653,709048541,16888,3374,250
709055621,709052676,709070196,17520,3375,250
709077276,709074331,709091851,17520,3376,250
709098931,709095986,709114139,18153,3377,250
709121220,709118274,709135458,17184,3378,250
709142539,709139593,709157432,17839,3379,250
709164512,709161566,709178137,16571,3380,250
709185000,709182272,709197871,15599,3381,250
709204733,709202005,709217288,15283,3382,250
709224368,709221422,709237340,15918,3383,250
709244420,709241474,709259606,18132,3384,250
709266685,709263740,709280627,16887,3385,250
709287706,709284761,709301964,17203,3386,250
709309045,709306099,709321066,14967,3387,250
709328144,709325200,709342086,16886,3388,250
709349167,709346221,709362455,16234,3389,250
709369537,709366590,709383797,17207,3390,250
709390878,709387932,709403850,15918,3391,250
709410929,709407984,709426455,18471,3392,250
709433535,709430590,709448406,17816,3393,250
709455486,709452540,709470694,18154,3394,250
709477774,709474828,709493299,18471,3395,250
709500379,709497434,709513350,15916,3396,250
709520213,709517484,709534055,16571,3397,250
709541134,709538189,709555394,17205,3398,250
709562474,709559528,709577050,17522,3399,250
709584130,709581185,709599656,18471,3400,250
709606736,709603791,709621629,17838,3401,250
709628709,709625764,709645205,19441,3402,250
709652284,709649339,709666226,16887,3403,250
709673307,709670361,709687228,16867,3404,250
709694092,709691363,709710171,18808,3405,250
709717252,709714306,709730857,16551,3406,250
709737721,709734992,709751859,16867,3407,250
709758939,709755994,709773830,17836,3408,250
709780910,709777965,709796436,18471,3409,250
709803517,709800571,709819359,18788,3410,250
709826222,709823494,709840064,16570,3411,250
709847143,709844198,709862330,18132,3412,250
709869410,709866465,709883668,17203,3413,250
709890749,709887803,709905957,18154,3414,250
709913038,709910092,709928879,18787,3415,250
709935961,709933014,709950200,17186,3416,250
709957280,709954335,709973143,18808,3417,250
709980223,709977278,709996402,19124,3418,250
710003482,710000537,710017741,17204,3419,250
710024822,710021876,710039080,17204,3420,250
710046160,710043215,710060736,17521,3421,250
710067817,710064871,710083659,18788,3422,250
710090740,710087794,710104683,16889,3423,250
710111763,710108818,710126001,17183,3424,250
710133081,710130136,710147656,17520,3425,250
710154735,710151791,710168677,16886,3426,250
710175758,710172812,710189362,16550,3427,250
710196443,710193497,710211650,18153,3428,250
710218731,710215785,710233306,17521,3429,250
710240387,710237441,710252724,15283,3430,250
710259803,710256859,710275667,18808,3431,250
710282748,710279802,710296690,16888,3432,250
710303553,710300825,710319633,18808,3433,250
710326713,710323768,710340971,17203,3434,250
710347835,710345106,710361340,16234,3435,250
710368421,710365475,710382046,16571,3436,250
710389127,710386181,710404337,18156,3437,250
710411418,710408472,710425359,16887,3438,250
710432439,710429494,710446676,17182,3439,250
710453757,710450811,710468311,17500,3440,250
710475392,710472446,710489650,17204,3441,250
710496730,710493785,710511938,18153,3442,250
710519019,710516073,710534227,18154,3443,250
710541308,710538362,710553964,15602,3444,250
710561043,710558098,710577540,19442,3445,250
710584621,710581675,710597909,16234,3446,250
710604990,710602044,710619248,17204,3447,250
710626328,710623383,710641854,18471,3448,250
710648934,710645989,710664143,18154,3449,250
710671224,710668278,710684196,15918,3450,250
710691275,710688330,710703931,15601,3451,250
710711011,710708065,710725271,17206,3452,250
710732352,710729406,710746927,17521,3453,250
710754007,710751062,710766663,15601,3454,250
710773742,710770797,710788002,17205,3455,250
710795083,710792137,710807104,14967,3456,250
710814184,710811238,710828127,16889,3457,250
710835207,710832262,710848496,16234,3458,250
710855577,710852631,710869520,16889,3459,250
710876601,710873655,710889571,15916,3460,250
710896649,710893705,710909938,16233,3461,250
710917019,710914073,710931278,17205,3462,250
710938358,710935413,710952615,17202,3463,250
710959695,710956750,710973616,16866,3464,250
710980696,710977751,710994300,16549,3465,250
711001380,710998435,711014035,15600,3466,250
711021116,711018169,711036324,18155,3467,250
711043405,711040459,711058931,18472,3468,250
711066011,711063066,711080587,17521,3469,250
711087668,711084722,711102877,18155,3470,250
711109957,711107012,711125164,18152,3471,250
711132244,711129299,711144897,15598,3472,250
711151977,711149031,711166849,17818,3473,250
711173929,711170984,711188484,17500,3474,250
711195565,711192619,711210139,17520,3475,250
711217221,711214274,711229874,15600,3476,250
711236955,711234008,711250244,16236,3477,250
711257323,711254378,711271581,17203,3478,250
711278662,711275716,711291633,15917,3479,250
711298495,711295767,711312971,17204,3480,250
711320051,711317106,711333022,15916,3481,250
711340101,711337156,711352124,14968,3482,250
711359203,711356258,711373779,17521,3483,250
711380860,711377914,711395434,17520,3484,250
711402514,711399569,711417723,18154,3485,250
711424803,711421858,711440328,18470,3486,250
711447408,711444463,711462616,18153,3487,250
711469697,711466751,711485560,18809,3488,250
711492641,711489695,711508821,19126,3489,250
711515901,711512956,711530139,17183,3490,250
711537219,711534274,711552427,18153,3491,250
711559510,711556562,711573770,17208,3492,250
711580850,711577905,711595741,17836,3493,250
711602821,711599876,711618347,18471,3494,250
711625427,711622482,711639031,16549,3495,250
711645895,711643166,711660982,17816,3496,250
711668062,711665117,711683270,18153,3497,250
711690350,711687405,711705558,18153,3498,250
711712638,711709693,711725294,15601,3499,250
711732373,711729428,711746315,16887,3500,250
711753395,711750450,711768287,17837,3501,250
711775367,711772422,711789626,17204,3502,250
711796707,711793761,711811578,17817,3503,250
711818442,711815713,711832263,16550,3504,250
711839343,711836398,711853601,17203,3505,250
711860681,711857736,711874603,16867,3506,250
711881683,711878738,711896258,17520,3507,250
711903121,711900393,711919516,19123,3508,250
711926597,711923651,711941806,18155,3509,250
711948886,711945941,711965066,19125,3510,250
711971929,711969201,711987355,18154,3511,250
711994436,711991490,712009328,17838,3512,250
712016408,712013463,712030351,16888,3513,250
712037431,712034486,712053609,19123,3514,250
712060689,712057744,712075898,18154,3515,250
712082762,712080033,712096583,16550,3516,250
712103663,712100717,712116950,16233,3517,250
712123813,712121085,712139239,18154,3518,250
712146319,712143374,712160241,16867,3519,250
712167105,712164376,712183500,19124,3520,250
712190580,712187635,712205135,17500,3521,250
712212215,712209270,712226136,16866,3522,250
712233215,712230270,712246503,16233,3523,250
712253583,712250638,712267841,17203,3524,250
712274924,712271976,712290133,18157,3525,250
712297213,712294268,712312420,18152,3526,250
712319501,712316555,712333422,16867,3527,250
712340501,712337557,712354421,16864,3528,250
712361501,712358556,712376710,18154,3529,250
712383790,712380845,712398028,17183,3530,250
712405109,712402163,712419368,17205,3531,250
712426447,712423502,712440052,16550,3532,250
712447132,712444187,712460420,16233,3533,250
712467501,712464555,712482077,17522,3534,250
712489157,712486212,712504028,17816,3535,250
712511107,712508163,712524710,16547,3536,250
712531790,712528845,712544128,15283,3537,250
712551207,712548262,712567387,19125,3538,250
712574467,712571522,712589359,17837,3539,250
712596439,712593494,712610044,16550,3540,250
712617124,712614179,712630413,16234,3541,250
712637494,712634548,712653357,18809,3542,250
712660220,712657492,712675013,17521,3543,250
712682094,712679148,712695381,16233,3544,250
712702245,712699516,712716066,16550,3545,250
712723146,712720201,712738987,18786,3546,250
712746069,712743122,712760327,17205,3547,250
712767408,712764462,712782301,17839,3548,250
712789383,712786436,712802989,16553,3549,250
712810069,712807124,712823674,16550,3550,250
712830754,712827809,712845961,18152,3551,250
712853043,712850096,712868885,18789,3552,250
712875965,712873020,712890540,17520,3553,250
712897620,712894675,712911563,16888,3554,250
712918645,712915698,712932903,17205,3555,250
712939983,712937038,712952322,15284,3556,250
712959186,712956456,712975244,18788,3557,250
712982324,712979379,712995612,16233,3558,250
713002693,712999747,713017902,18155,3559,250
713024982,713022037,713039874,17837,3560,250
713046953,713044009,713061191,17182,3561,250
713068271,713065326,713081558,16232,3562,250
713088638,713085693,713101608,15915,3563,250
713108688,713105742,713122630,16888,3564,250
713129710,713126765,713142999,16234,3565,250
713150078,713147133,713163682,16549,3566,250
713170762,713167816,713184048,16232,3567,250
713191128,713188183,713204733,16550,3568,250
713211813,713208868,713226387,17519,3569,250
713233465,713230521,713248336,17815,3570,250
713255415,713252470,713270308,17838,3571,250
713277389,713274443,713290360,15917,3572,250
713297439,713294494,713312648,18154,3573,250
713319728,713316782,713332382,15600,3574,250
713339462,713336516,713353701,17185,3575,250
713360782,713357836,713372805,14969,3576,250
713379884,713376939,713392222,15283,3577,250
713399302,713396356,713415144,18788,3578,250
713422225,713419279,713435829,16550,3579,250
713442909,713439964,713457169,17205,3580,250
713464035,713461304,713477857,16553,3581,250
713484937,713481992,713498880,16888,3582,250
713505960,713503015,713519902,16887,3583,250
713526982,713524037,713541239,17202,3584,250
713548319,713545374,713561606,16232,3585,250
713568687,713565741,713583895,18154,3586,250
713590976,713588030,713604898,16868,3587,250
713611979,713609033,713624634,15601,3588,250
713631713,713628768,713645655,16887,3589,250
713652518,713649790,713667309,17519,3590,250
713674390,713671444,713688017,16573,3591,250
713694880,713692151,713709673,17522,3592,250
713716753,713713808,713731308,17500,3593,250
713738387,713735442,713752625,17183,3594,250
713759706,713756760,713772994,16234,3595,250
713780074,713777129,713795598,18469,3596,250
713802677,713799732,713815648,15916,3597,250
713822728,713819782,713836669,16887,3598,250
713843751,713840804,713856723,15919,3599,250
713863802,713860857,713879981,19124,3600,250
713887063,713884116,713899718,15602,3601,250
713906798,713903852,713921057,17205,3602,250
713927921,713925192,713943346,18154,3603,250
713950210,713947481,713963716,16235,3604,250
713970580,713967851,713984738,16887,3605,250
713991819,713988873,714006057,17184,3606,250
714013137,714010192,714026424,16232,3607,250
714033504,714030559,714049684,19125,3608,250
714056766,714053819,714071024,17205,3609,250
714078104,714075159,714092341,17182,3610,250
714099204,714096476,714115262,18786,3611,250
714122125,714119397,714136601,17204,3612,250
714143681,714140736,714156970,16234,3613,250
714164052,714161105,714179576,18471,3614,250
714186656,714183711,714202182,18471,3615,250
714209046,714206317,714221602,15285,3616,250
714228682,714225736,714242288,16552,3617,250
714249367,714246423,714264258,17835,3618,250
714271339,714268393,714283677,15284,3619,250
714290757,714287811,714304381,16570,3620,250
714311462,714308516,714324435,15919,3621,250
714331298,714328569,714343854,15285,3622,250
714350933,714347988,714365824,17836,3623,250
714372688,714369959,714387458,17499,3624,250
714394538,714391593,714411033,19440,3625,250
714418114,714415168,714433322,18154,3626,250
714440402,714437456,714454661,17205,3627,250
714461739,714458795,714474710,15915,3628,250
714481572,714478844,714496998,18154,3629,250
714503862,714501133,714518021,16888,3630,250
714525100,714522155,714538389,16234,3631,250
714545470,714542524,714559413,16889,3632,250
714566494,714563548,714581702,18154,3633,250
714588566,714585836,714604645,18809,3634,250
714611725,714608780,714625331,16551,3635,250
714632412,714629466,714645384,15918,3636,250
714652464,714649518,714666384,16866,3637,250
714673465,714670519,714686120,15601,3638,250
714693199,714690254,714708091,17837,3639,250
714715171,714712226,714728459,16233,3640,250
714735539,714732594,714750115,17521,3641,250
714756979,714754250,714772742,18492,3642,250
714779822,714776877,714792478,15601,3643,250
714799558,714796612,714812528,15916,3644,250
714819607,714816662,714833212,16550,3645,250
714840292,714837347,714856471,19124,3646,250
714863552,714860606,714876841,16235,3647,250
714883921,714880976,714899130,18154,3648,250
714906210,714903264,714920130,16866,3649,250
714927211,714924265,714940500,16235,3650,250
714947581,714944635,714960868,16233,3651,250
714967731,714965002,714981552,16550,3652,250
714988634,714985687,715003504,17817,3653,250
715010584,715007639,715025475,17836,3654,250
715032555,715029610,715049051,19441,3655,250
715056132,715053186,715070370,17184,3656,250
715077450,715074505,715092026,17521,3657,250
715099107,715096161,715113028,16867,3658,250
715119892,715117163,715135972,18809,3659,250
715143053,715140107,715156975,16868,3660,250
715164056,715161110,715178949,17839,3661,250
715186030,715183084,715201239,18155,3662,250
715208320,715205374,715223866,18492,3663,250
715230948,715228001,715246157,18156,3664,250
715253021,715250292,715265577,15285,3665,250
715272658,715269711,715286263,16552,3666,250
715293344,715290398,715306633,16235,3667,250
715313714,715310768,715327974,17206,3668,250
715334840,715332109,715351553,19444,3669,250
715358634,715355688,715371289,15601,3670,250
715378368,715375423,715392627,17204,3671,250
715399708,715396762,715413946,17184,3672,250
715421026,715418081,715436235,18154,3673,250
715443315,715440370,715458208,17838,3674,250
715465071,715462343,715480834,18491,3675,250
715487915,715484969,715502489,17520,3676,250
715509569,715506624,715523511,16887,3677,250
715530591,715527646,715544849,17203,3678,250
715551929,715548984,715567138,18154,3679,250
715574218,715571273,715588477,17204,3680,250
715595558,715592612,715608847,16235,3681,250
715615928,715612982,715629850,16868,3682,250
715636931,715633985,715651190,17205,3683,250
715658269,715655325,715671557,16232,3684,250
715678637,715675692,715692558,16866,3685,250
715699639,715696693,715712293,15600,3686,250
715719373,715716427,715733294,16867,3687,250
715740374,715737429,715752397,14968,3688,250
715759259,715756531,715774052,17521,3689,250
715781133,715778187,715795393,17206,3690,250
715802474,715799528,715818020,18492,3691,250
715825100,715822155,715838704,16549,3692,250
715845786,715842839,715860025,17186,3693,250
715867104,715864160,715882968,18808,3694,250
715889832,715887103,715904285,17182,3695,250
715911365,715908420,715927718,19298,3696,250
715934799,715931853,715950347,18494,3697,250
715957428,715954482,715971033,16551,3698,250
715978112,715975168,715992035,16867,3699,250
715998898,715996170,716014007,17837,3700,250
716021088,716018142,716036615,18473,3701,250
716043696,716040750,716058272,17522,3702,250
716065352,716062407,716078009,15602,3703,250
716085088,716082143,716098061,15918,3704,250
716105141,716102195,716121005,18810,3705,250
716128085,716125140,716142977,17837,3706,250
716150057,716147112,716164000,16888,3707,250
716171081,716168135,716185953,17818,3708,250
716192818,716190088,716206007,15919,3709,250
716213086,716210141,716225426,15285,3710,250
716232506,716229560,716244845,15285,3711,250
716251925,716248979,716266184,17205,3712,250
716273264,716270319,716288474,18155,3713,250
716295554,716292609,716308210,15601,3714,250
716315289,716312344,716327629,15285,3715,250
716334708,716331763,716347363,15600,3716,250
716354225,716351497,716368386,16889,3717,250
716375467,716372521,716389727,17206,3718,250
716396808,716393862,716411701,17839,3719,250
716418564,716415836,716433653,17817,3720,250
716440734,716437788,716453707,15919,3721,250
716460786,716457841,716472809,14968,3722,250
716479887,716476943,716493176,16233,3723,250
716500256,716497311,716514178,16867,3724,250
716521261,716518313,716535838,17525,3725,250
716542919,716539973,716555259,15286,3726,250
716562339,716559394,716575945,16551,3727,250
716583026,716580080,716598553,18473,3728,250
716605416,716602688,716620842,18154,3729,250
716627923,716624977,716643132,18155,3730,250
716649995,716647267,716663818,16551,3731,250
716670900,716667953,716685476,17523,3732,250
716692557,716689611,716706816,17205,3733,250
716713896,716710951,716726867,15916,3734,250
716733948,716731002,716748842,17840,3735,250
716755706,716752977,716768896,15919,3736,250
716775976,716773031,716790237,17206,3737,250
716797317,716794372,716812528,18156,3738,250
716819608,716816663,716834184,17521,3739,250
716841263,716838318,716855817,17499,3740,250
716862897,716859952,716874919,14967,3741,250
716881999,716879053,716895604,16551,3742,250
716902684,716899738,716915340,15602,3743,250
716922418,716919473,716937945,18472,3744,250
716945024,716942079,716959263,17184,3745,250
716966343,716963398,716981236,17838,3746,250
716988315,716985370,717001603,16233,3747,250
717008684,717005738,717023894,18156,3748,250
717030975,717028029,717045551,17522,3749,250
717052631,717049686,717066237,16551,3750,250
717073100,717070371,717088209,17838,3751,250
717095290,717092344,717108578,16234,3752,250
717115658,717112712,717128947,16235,3753,250
717136027,717133082,717148050,14968,3754,250
717155129,717152184,717169704,17520,3755,250
717176784,717173839,717189756,15917,3756,250
717196836,717193890,717209175,15285,3757,250
717216255,717213309,717230197,16888,3758,250
717237276,717234331,717250249,15918,3759,250
717257112,717254383,717271251,16868,3760,250
717278331,717275386,717293224,17838,3761,250
717300305,717297359,717314228,16869,3762,250
717321307,717318362,717336199,17837,3763,250
717343063,717340334,717357855,17521,3764,250
717364937,717361990,717379829,17839,3765,250
717386909,717383964,717400852,16888,3766,250
717407932,717404987,717423773,18786,3767,250
717430853,717427908,717445746,17838,3768,250
717452826,717449880,717467085,17205,3769,250
717474164,717471219,717487137,15918,3770,250
717494217,717491271,717509110,17839,3771,250
717516191,717513245,717531083,17838,3772,250
717538164,717535218,717552403,17185,3773,250
717559482,717556538,717574373,17835,3774,250
717581455,717578508,717595715,17207,3775,250
717602797,717599850,717615769,15919,3776,250
717622848,717619903,717635187,15284,3777,250
717642266,717639321,717657814,18493,3778,250
717664677,717661948,717678816,16868,3779,250
717685895,717682950,717700767,17817,3780,250
717707846,717704901,717719868,14967,3781,250
717726949,717724002,717741209,17207,3782,250
717748288,717745343,717762548,17205,3783,250
717769629,717766683,717785809,19126,3784,250
717792889,717789944,717807148,17204,3785,250
717814229,717811283,717828150,16867,3786,250
717835230,717832285,717849489,17204,3787,250
717856570,717853624,717872750,19126,3788,250
717879829,717876884,717894404,17520,3789,250
717901267,717898539,717915744,17205,3790,250
717922825,717919879,717936115,16236,3791,250
717943195,717940250,717958404,18154,3792,250
717965484,717962539,717981009,18470,3793,250
717988089,717985143,718001695,16552,3794,250
718008776,718005830,718021749,15919,3795,250
718028612,718025883,718042435,16552,3796,250
718049515,718046570,718064725,18155,3797,250
718071806,718068860,718085729,16869,3798,250
718092810,718089864,718107069,17205,3799,250
718114150,718111204,718130012,18808,3800,250
718137092,718134147,718151984,17837,3801,250
718159066,718156119,718173009,16890,3802,250
718180089,718177144,718192745,15601,3803,250
718199824,718196879,718212797,15918,3804,250
718219876,718216931,718233820,16889,3805,250
718240901,718237955,718254823,16868,3806,250
718261903,718258958,718278399,19441,3807,250
718285480,718282534,718300055,17521,3808,250
718307137,718304190,718321691,17501,3809,250
718328772,718325826,718341427,15601,3810,250
718348506,718345561,718362429,16868,3811,250
718369510,718366564,718384065,17501,3812,250
718391145,718388200,718405405,17205,3813,250
718412485,718409540,718426091,16551,3814,250
718433172,718430226,718446778,16552,3815,250
718453642,718450913,718468751,17838,3816,250
718475831,718472886,718490407,17521,3817,250
718497487,718494542,718511726,17184,3818,250
718518806,718515861,718534351,18490,3819,250
718541432,718538486,718555691,17205,3820,250
718562771,718559826,718577326,17500,3821,250
718584189,718581461,718597694,16233,3822,250
718604774,718601829,718617747,15918,3823,250
718624825,718621881,718639084,17203,3824,250
718646165,718643219,718659452,16233,3825,250
718666532,718663586,718681742,18156,3826,250
718688823,718685877,718701478,15601,3827,250
718708558,718705612,718722185,16573,3828,250
718729266,718726320,718742238,15918,3829,250
718749317,718746372,718762606,16234,3830,250
718769685,718766741,718785212,18471,3831,250
718792292,718789347,718806847,17500,3832,250
718813926,718810982,718829136,18154,3833,250
718836216,718833271,718851109,17838,3834,250
718858189,718855244,718872448,17204,3835,250
718879527,718876583,718893133,16550,3836,250
718900213,718897267,718916075,18808,3837,250
718923243,718920210,718939106,18896,3838,250
718946187,718943241,718960742,17501,3839,250
718967823,718964877,718981766,16889,3840,250
718988845,718985900,719004370,18470,3841,250
719011450,719008505,719026659,18154,3842,250
719033739,719030794,719048631,17837,3843,250
719055710,719052766,719069947,17181,3844,250
719077028,719074082,719091920,17838,3845,250
719099000,719096055,719111971,15916,3846,250
719119051,719116105,719133627,17522,3847,250
719140707,719137761,719156548,18787,3848,250
719163627,719160683,719178202,17519,3849,250
719185282,719182337,719197303,14966,3850,250
719204382,719201437,719220243,18806,3851,250
719227324,719224378,719242216,17838,3852,250
719249298,719246351,719261953,15602,3853,250
719269032,719266087,719283607,17520,3854,250
719290687,719287741,719304924,17183,3855,250
719312004,719309059,719324026,14967,3856,250
719331106,719328160,719343761,15601,3857,250
719350841,719347895,719365733,17838,3858,250
719372813,719369868,719389308,19440,3859,250
719396388,719393443,719410309,16866,3860,250
719417389,719414444,719431647,17203,3861,250
719438727,719435782,719451699,15917,3862,250
719458778,719455833,719473037,17204,3863,250
719479901,719477172,719495011,17839,3864,250
719502092,719499146,719516983,17837,3865,250
719524064,719521118,719537352,16234,3866,250
719544432,719541487,719556769,15282,3867,250
719563849,719560903,719578403,17500,3868,250
719585484,719582538,719599089,16551,3869,250
719606170,719603224,719621378,18154,3870,250
719628459,719625513,719642064,16551,3871,250
719649143,719646198,719663402,17204,3872,250
719670482,719667537,719682820,15283,3873,250
719689899,719686954,719704791,17837,3874,250
719711872,719708926,719727398,18472,3875,250
719734262,719731533,719748084,16551,3876,250
719755165,719752219,719768770,16551,3877,250
719775851,719772905,719787872,14967,3878,250
719794951,719792006,719808555,16549,3879,250
719815636,719812690,719830528,17838,3880,250
719837392,719834663,719850898,16235,3881,250
719857979,719855033,719871585,16552,3882,250
719878665,719875720,719893874,18154,3883,250
719900955,719898009,719915213,17204,3884,250
719922294,719919348,719934948,15600,3885,250
719942027,719939082,719956264,17182,3886,250
719963345,719960399,719979524,19125,3887,250
719986389,719983659,720000865,17206,3888,250
720007945,720005000,720023154,18154,3889,250
720030234,720027289,720042572,15283,3890,250
720049652,720046706,720064859,18153,3891,250
720071940,720068994,720087466,18472,3892,250
720094546,720091601,720108805,17204,3893,250
720115886,720112940,720128858,15918,3894,250
720135721,720132992,720151125,18133,3895,250
720158206,720155260,720172466,17206,3896,250
720179546,720176601,720193151,16550,3897,250
720200231,720197286,720216095,18809,3898,250
720223175,720220230,720238701,18471,3899,250
720245782,720242836,720258754,15918,3900,250
720265835,720262888,720279757,16869,3901,250
720286621,720283892,720300779,16887,3902,250
720307859,720304914,720322729,17815,3903,250
720329810,720326864,720345335,18471,3904,250
720352416,720349470,720365387,15917,3905,250
720372467,720369521,720387021,17500,3906,250
720393885,720391156,720408339,17183,3907,250
720415419,720412474,720428073,15599,3908,250
720435152,720432207,720448440,16233,3909,250
720455520,720452574,720469780,17206,3910,250
720476642,720473914,720492385,18471,3911,250
720499465,720496520,720512436,15916,3912,250
720519515,720516570,720534070,17500,3913,250
720541150,720538205,720556675,18470,3914,250
720563539,720560810,720578332,17522,3915,250
720585413,720582467,720598384,15917,3916,250
720605464,720602518,720620989,18471,3917,250
720628070,720625124,720643279,18155,3918,250
720650360,720647414,720663332,15918,3919,250
720670411,720667466,720684965,17499,3920,250
720692045,720689100,720705332,16232,3921,250
720712413,720709467,720725701,16234,3922,250
720732782,720729836,720746386,16550,3923,250
720753466,720750521,720768991,18470,3924,250
720775855,720773126,720790647,17521,3925,250
720797511,720794782,720810383,15601,3926,250
720817463,720814517,720831066,16549,3927,250
720838146,720835201,720853355,18154,3928,250
720860435,720857490,720874039,16549,3929,250
720880904,720878174,720896645,18471,3930,250
720903725,720900779,720919249,18470,3931,250
720926328,720923383,720940566,17183,3932,250
720947646,720944700,720962220,17520,3933,250
720969084,720966354,720986430,20076,3934,250
720993401,720990672,721009262,18590,3935,250
721016343,721013397,721031552,18155,3936,250
721038632,721035686,721053841,18155,3937,250
721060920,721057975,721074524,16549,3938,250
721081603,721078658,721095862,17204,3939,250
721102942,721099997,721117201,17204,3940,250
721124282,721121336,721137253,15917,3941,250
721144331,721141386,721158885,17499,3942,250
721165965,721163020,721182462,19442,3943,250
721189327,721186597,721204119,17522,3944,250
721210984,721208254,721227379,19125,3945,250
721234457,721231513,721250003,18490,3946,250
721257083,721254138,721272290,18152,3947,250
721279369,721276424,721293944,17520,3948,250
721301025,721298079,721314967,16888,3949,250
721322047,721319101,721336918,17817,3950,250
721343998,721341052,721357287,16235,3951,250
721364366,721361421,721378942,17521,3952,250
721386021,721383076,721400576,17500,3953,250
721407439,721404711,721422231,17520,3954,250
721429311,721426366,721444519,18153,3955,250
721451599,721448653,721467145,18492,3956,250
721474225,721471279,721489118,17839,3957,250
721495982,721493253,721510754,17501,3958,250
721517834,721514888,721534329,19441,3959,250
721541409,721538464,721557272,18808,3960,250
721564352,721561407,721578274,16867,3961,250
721585354,721582409,721604193,21784,3962,250
721611273,721608327,721624560,16233,3963,250
721631423,721628694,721646216,17522,3964,250
721653297,721650351,721668505,18154,3965,250
721675585,721672640,721690477,17837,3966,250
721697557,721694612,721713736,19124,3967,250
721720817,721717871,721735076,17205,3968,250
721742155,721739210,721756393,17183,3969,250
721763472,721760527,721777098,16571,3970,250
721784178,721781232,721799071,17839,3971,250
721806151,721803206,721821043,17837,3972,250
721827906,721825177,721840462,15285,3973,250
721847542,721844596,721861800,17204,3974,250
721868879,721865934,721885057,19123,3975,250
721892137,721889191,721906713,17522,3976,250
721913794,721910848,721929003,18155,3977,250
721936083,721933137,721950003,16866,3978,250
721957083,721954137,721972292,18155,3979,250
721979154,721976426,721994263,17837,3980,250
722001342,721998397,722016868,18471,3981,250
722023948,722021003,722038838,17835,3982,250
722045919,722042973,722060812,17839,3983,250
722067893,722064947,722082786,17839,3984,250
722089866,722086920,722103153,16233,3985,250
722110016,722107287,722124470,17183,3986,250
722131551,722128605,722146759,18154,3987,250
722153839,722150893,722167443,16550,3988,250
722174306,722171577,722188759,17182,3989,250
722195622,722192894,722208177,15283,3990,250
722215256,722212311,722229514,17203,3991,250
722236594,722233649,722250220,16571,3992,250
722257299,722254354,722271854,17500,3993,250
722278935,722275989,722293827,17838,3994,250
722300907,722297962,722314511,16549,3995,250
722321590,722318645,722336166,17521,3996,250
722343248,722340301,722358140,17839,3997,250
722365220,722362274,722379141,16867,3998,250
722386221,722383276,722400141,16865,3999,250
722407221,722404276,722421797,17521,4000,250
722428877,722425932,722442165,16233,4001,250
722449245,722446299,722463800,17501,4002,250
722470882,722467935,722484487,16552,4003,250
722491566,722488621,722506142,17521,4004,250
722513223,722510277,722528432,18155,4005,250
722535513,722532567,722548484,15917,4006,250
722555563,722552618,722569167,16549,4007,250
722576246,722573301,722589218,15917,4008,250
722596298,722593352,722610536,17184,4009,250
722617615,722614670,722633478,18808,4010,250
722640559,722637613,722656401,18788,4011,250
722663482,722660536,722676137,15601,4012,250
722683217,722680271,722699080,18809,4013,250
722706161,722703215,722722657,19442,4014,250
722729737,722726792,722743658,16866,4015,250
722750738,722747793,722764026,16233,4016,250
722771106,722768161,722783761,15600,4017,250
722790840,722787895,722805414,17519,4018,250
722812278,722809549,722825466,15917,4019,250
722832546,722829600,722846150,16550,4020,250
722853231,722850285,722869074,18789,4021,250
722876155,722873209,722890392,17183,4022,250
722897473,722894527,722910127,15600,4023,250
722917207,722914261,722929861,15600,4024,250
722936939,722933995,722949910,15915,4025,250
722956989,722954044,722971880,17836,4026,250
722978961,722976015,722994486,18471,4027,250
723001567,722998621,723016460,17839,4028,250
723023540,723020595,723038748,18153,4029,250
723045829,723042883,723059770,16887,4030,250
723066850,723063905,723079504,15599,4031,250
723086366,723083638,723100505,16867,4032,250
723107585,723104639,723123428,18789,4033,250
723130507,723127563,723145081,17518,4034,250
723152162,723149216,723165451,16235,4035,250
723172532,723169586,723187741,18155,4036,250
723194822,723191876,723207477,15601,4037,250
723214556,723211611,723229111,17500,4038,250
723236192,723233245,723249817,16572,4039,250
723256898,723253952,723269554,15602,4040,250
723276417,723273688,723289606,15918,4041,250
723296468,723293740,723312210,18470,4042,250
723319290,723316345,723333549,17204,4043,250
723340412,723337683,723355184,17501,4044,250
723362264,723359319,723375551,16232,4045,250
723382631,723379685,723394653,14968,4046,250
723401516,723398787,723415991,17204,4047,250
723423072,723420126,723437332,17206,4048,250
723444411,723441467,723458332,16865,4049,250
723465412,723462467,723479017,16550,4050,250
723486097,723483152,723500019,16867,4051,250
723507100,723504154,723519439,15285,4052,250
723526520,723523573,723540779,17206,4053,250
723547858,723544913,723561780,16867,4054,250
723568860,723565915,723583118,17203,4055,250
723590198,723587253,723603803,16550,4056,250
723610882,723607937,723626745,18808,4057,250
723633824,723630879,723649370,18491,4058,250
723656449,723653504,723670687,17183,4059,250
723677767,723674822,723690738,15916,4060,250
723697818,723694872,723711106,16234,4061,250
723718186,723715241,723733077,17836,4062,250
723740157,723737211,723755365,18154,4063,250
723762228,723759500,723775732,16232,4064,250
723782595,723779867,723796754,16887,4065,250
723803834,723800888,723817756,16868,4066,250
723824836,723821891,723839728,17837,4067,250
723846593,723843863,723860730,16867,4068,250
723867812,723864865,723883021,18156,4069,250
723890101,723887156,723904044,16888,4070,250
723911124,723908179,723925699,17520,4071,250
723932779,723929834,723945118,15284,4072,250
723952197,723949252,723965168,15916,4073,250
723972247,723969302,723987773,18471,4074,250
723994853,723991907,724009428,17521,4075,250
724016508,724013563,724030450,16887,4076,250
724037530,724034585,724051155,16570,4077,250
724058234,724055289,724072472,17183,4078,250
724079552,724076607,724092524,15917,4079,250
724099604,724096658,724112892,16234,4080,250
724119971,724117026,724133259,16233,4081,250
724140339,724137394,724154578,17184,4082,250
724161658,724158712,724174312,15600,4083,250
724181392,724178446,724196285,17839,4084,250
724203364,724200419,724216969,16550,4085,250
724223831,724221103,724237337,16234,4086,250
724244417,724241471,724258675,17204,4087,250
724265755,724262809,724279677,16868,4088,250
724286756,724283811,724300361,16550,4089,250
724307442,724304496,724321680,17184,4090,250
724328758,724325814,724341728,15914,4091,250
724348807,724345862,724363044,17182,4092,250
724370124,724367179,724382779,15600,4093,250
724389859,724386913,724402831,15918,4094,250
724409910,724406965,724422247,15282,4095,250
724429326,724426381,724442298,15917,4096,250
724449377,724446432,724462348,15916,4097,250
724469427,724466482,724482398,15916,4098,250
724489261,724486532,724502766,16234,4099,250
724509848,724506901,724522187,15286,4100,250
724529266,724526320,724541605,15285,4101,250
724548686,724545739,724562924,17185,4102,250
724569788,724567059,724584243,17184,4103,250
724591323,724588378,724604950,16572,4104,250
724612030,724609085,724625634,16549,4105,250
724632715,724629769,724647586,17817,4106,250
724654666,724651721,724668587,16866,4107,250
724675666,724672722,724689924,17202,4108,250
724697003,724694058,724710608,16550,4109,250
724717689,724714743,724732560,17817,4110,250
724739641,724736695,724753879,17184,4111,250
724760958,724758014,724775534,17520,4112,250
724782615,724779669,724797507,17838,4113,250
724804589,724801642,724816612,14970,4114,250
724823691,724820746,724837949,17203,4115,250
724845029,724842084,724858971,16887,4116,250
724866052,724863106,724879972,16866,4117,250
724886835,724884106,724902914,18808,4118,250
724909994,724907049,724923599,16550,4119,250
724930679,724927734,724944938,17204,4120,250
724952020,724949073,724966912,17839,4121,250
724973993,724971047,724987280,16233,4122,250
724994360,724991415,725010202,18787,4123,250
725017282,725014337,725031223,16886,4124,250
725038304,725035358,725053829,18471,4125,250
725060910,725057964,725074832,16868,4126,250
725081912,725078966,725097774,18808,4127,250
725104854,725101909,725119091,17182,4128,250
725126172,725123226,725140430,17204,4129,250
725147509,725144564,725161748,17184,4130,250
725168828,725165883,725181484,15601,4131,250
725188563,725185618,725201535,15917,4132,250
725208397,725205668,725222873,17205,4133,250
725229952,725227007,725242923,15916,4134,250
725249786,725247057,725263605,16548,4135,250
725270686,725267740,725287182,19442,4136,250
725294045,725291317,725309154,17837,4137,250
725316235,725313289,725328889,15600,4138,250
725335968,725333023,725350859,17836,4139,250
725357940,725354994,725370278,15284,4140,250
725377357,725374412,725392566,18154,4141,250
725399647,725396701,725413885,17184,4142,250
725420966,725418020,725433305,15285,4143,250
725440385,725437439,725453674,16235,4144,250
725460754,725457809,725476934,19125,4145,250
725484014,725481069,725497956,16887,4146,250
725505036,725502091,725519611,17520,4147,250
725526692,725523746,725540614,16868,4148,250
725547696,725544749,725563222,18473,4149,250
725570303,725567357,725583908,16551,4150,250
725590988,725588043,725605246,17203,4151,250
725612326,725609381,725626247,16866,4152,250
725633327,725630382,725647248,16866,4153,250
725654112,725651383,725667301,15918,4154,250
725674163,725671435,725688955,17520,4155,250
725696035,725693090,725709976,16886,4156,250
725717057,725714111,725732266,18155,4157,250
725739347,725736401,725753269,16868,4158,250
725760350,725757404,725774609,17205,4159,250
725781690,725778744,725796898,18154,4160,250
725803978,725801033,725818553,17520,4161,250
725825634,725822688,725838606,15918,4162,250
725845685,725842740,725858972,16232,4163,250
725866053,725863107,725880311,17204,4164,250
725887392,725884446,725901652,17206,4165,250
725908733,725905787,725921387,15600,4166,250
725928466,725925521,725942071,16550,4167,250
725949151,725946205,725964360,18155,4168,250
725971440,725968495,725985678,17183,4169,250
725992758,725989813,726008283,18470,4170,250
726015363,726012418,726029621,17203,4171,250
726036485,726033756,726048724,14968,4172,250
726055804,726052858,726071013,18155,4173,250
726077877,726075148,726091699,16551,4174,250
726098779,726095834,726114304,18470,4175,250
726121384,726118439,726136277,17838,4176,250
726143357,726140412,726157931,17519,4177,250
726164794,726162066,726178952,16886,4178,250
726186033,726183087,726200290,17203,4179,250
726207370,726204425,726219709,15284,4180,250
726226788,726223843,726241363,17520,4181,250
726248444,726245498,726262702,17204,4182,250
726269783,726266837,726283072,16235,4183,250
726290152,726287207,726305678,18471,4184,250
726312758,726309813,726327015,17202,4185,250
726334095,726331149,726348334,17185,4186,250
726355197,726352469,726369040,16571,4187,250
726376121,726373175,726390676,17501,4188,250
726397540,726394811,726410413,15602,4189,250
726417493,726414547,726432385,17838,4190,250
726439464,726436519,726452119,15600,4191,250
726459198,726456253,726473772,17519,4192,250
726480852,726477906,726495112,17206,4193,250
726502193,726499247,726516431,17184,4194,250
726523512,726520566,726538721,18155,4195,250
726545802,726542856,726559090,16234,4196,250
726566170,726563225,726581061,17836,4197,250
726587924,726585195,726604002,18807,4198,250
726610866,726608137,726624370,16233,4199,250
726631450,726628505,726644738,16233,4200,250
726651820,726648873,726665424,16551,4201,250
726672505,726669559,726685793,16234,4202,250
726692873,726689928,726707765,17837,4203,250
726714846,726711900,726730372,18472,4204,250
726737235,726734507,726752005,17498,4205,250
726759085,726756140,726774273,18133,4206,250
726781354,726778408,726793375,14967,4207,250
726800454,726797509,726813426,15917,4208,250
726820506,726817560,726833478,15918,4209,250
726840557,726837612,726854162,16550,4210,250
726861243,726858297,726875502,17205,4211,250
726882366,726879637,726896841,17204,4212,250
726903922,726900976,726917210,16234,4213,250
726924074,726921345,726937262,15917,4214,250
726944343,726941397,726957631,16234,4215,250
726964711,726961766,726980256,18490,4216,250
726987336,726984391,727001573,17182,4217,250
727008437,727005708,727024180,18472,4218,250
727031260,727028315,727045519,17204,4219,250
727052383,727049654,727068125,18471,4220,250
727075204,727072259,727088175,15916,4221,250
727095038,727092309,727110441,18132,4222,250
727117304,727114576,727131759,17183,4223,250
727138839,727135894,727155335,19441,4224,250
727162199,727159470,727178257,18787,4225,250
727185337,727182392,727201179,18787,4226,250
727208260,727205314,727222180,16866,4227,250
727229260,727226315,727241915,15600,4228,250
727248995,727246049,727262916,16867,4229,250
727269997,727267051,727284256,17205,4230,250
727291336,727288391,727306544,18153,4231,250
727313625,727310679,727326596,15917,4232,250
727333676,727330730,727346647,15917,4233,250
727353726,727350781,727368280,17499,4234,250
727375360,727372415,727389302,16887,4235,250
727396383,727393437,727409355,15918,4236,250
727416434,727413489,727430988,17499,4237,250
727438068,727435123,727453614,18491,4238,250
727460695,727457749,727472718,14969,4239,250
727479581,727476852,727492136,15284,4240,250
727499215,727496270,727513137,16867,4241,250
727520218,727517272,727533822,16550,4242,250
727540903,727537957,727553242,15285,4243,250
727560321,727557376,727575847,18471,4244,250
727582928,727579982,727597188,17206,4245,250
727604268,727601323,727618189,16866,4246,250
727625269,727622324,727640141,17817,4247,250
727647221,727644276,727660193,15917,4248,250
727667273,727664327,727682797,18470,4249,250
727689877,727686931,727702533,15602,4250,250
727709611,727706667,727722266,15599,4251,250
727729345,727726400,727744891,18491,4252,250
727751971,727749025,727767813,18788,4253,250
727774893,727771948,727787547,15599,4254,250
727794628,727791681,727810469,18788,4255,250
727817548,727814604,727830835,16231,4256,250
727837916,727834970,727851520,16550,4257,250
727858601,727855655,727874126,18471,4258,250
727880991,727878261,727895445,17184,4259,250
727902526,727899580,727917102,17522,4260,250
727924182,727921237,727938104,16867,4261,250
727945185,727942239,727958473,16234,4262,250
727965337,727962608,727979475,16867,4263,250
727986555,727983610,727998893,15283,4264,250
728005974,728003027,728019917,16890,4265,250
728026997,728024052,728039968,15916,4266,250
728047048,728044102,728061623,17521,4267,250
728068704,728065758,728083912,18154,4268,250
728090992,728088046,728105230,17184,4269,250
728112311,728109365,728127835,18470,4270,250
728134699,728131970,728148836,16866,4271,250
728155917,728152971,728169521,16550,4272,250
728176601,728173656,728190522,16866,4273,250
728197386,728194657,728213126,18469,4274,250
728220206,728217260,728235077,17817,4275,250
728241941,728239212,728258000,18788,4276,250
728265080,728262135,728280289,18154,4277,250
728287369,728284424,728301628,17204,4278,250
728308709,728305763,728322947,17184,4279,250
728330027,728327082,728342998,15916,4280,250
728350077,728347132,728365602,18470,4281,250
728372683,728369737,728385971,16234,4282,250
728393052,728390106,728406994,16888,4283,250
728414074,728411129,728429262,18133,4284,250
728436342,728433397,728448681,15284,4285,250
728455761,728452815,728470315,17500,4286,250
728477395,728474450,728493574,19124,4287,250
728500653,728497709,728513308,15599,4288,250
728520388,728517442,728535913,18471,4289,250
728542994,728540048,728558519,18471,4290,250
728565600,728562654,728580155,17501,4291,250
728587235,728584290,728601810,17520,4292,250
728608890,728605945,728622812,16867,4293,250
728629891,728626947,728643178,16231,4294,250
728650258,728647313,728662595,15282,4295,250
728669458,728666729,728684250,17521,4296,250
728691332,728688385,728706858,18473,4297,250
728713937,728710993,728726909,15916,4298,250
728733988,728731043,728748246,17203,4299,250
728755327,728752381,728769587,17206,4300,250
728776668,728773722,728792510,18788,4301,250
728799590,728796645,728814482,17837,4302,250
728821562,728818617,728836137,17520,4303,250
728843218,728840272,728855872,15600,4304,250
728862950,728860006,728876872,16866,4305,250
728883952,728881007,728898191,17184,4306,250
728905054,728902326,728920163,17837,4307,250
728927244,728924298,728942768,18470,4308,250
728949850,728946903,728962504,15601,4309,250
728969583,728966638,728982239,15601,4310,250
728989318,728986373,729002923,16550,4311,250
729010003,729007058,729023606,16548,4312,250
729030686,729027741,729046212,18471,4313,250
729053292,729050347,729067213,16866,4314,250
729074077,729071348,729087899,16551,4315,250
729094979,729092034,729108583,16549,4316,250
729115445,729112717,729129584,16867,4317,250
729136665,729133719,729150586,16867,4318,250
729157667,729154721,729173529,18808,4319,250
729180610,729177664,729195165,17501,4320,250
729202245,729199300,729216167,16867,4321,250
729223247,729220301,729236534,16233,4322,250
729243615,729240669,729257874,17205,4323,250
729264955,729262009,729277925,15916,4324,250
729285005,729282059,729297661,15602,4325,250
729304740,729301795,729317711,15916,4326,250
729324790,729321845,729338078,16233,4327,250
729345159,729342213,729360052,17839,4328,250
729366915,729364186,729379786,15600,4329,250
729386865,729383920,729398888,14968,4330,250
729405967,729403022,729420860,17838,4331,250
729427941,729424995,729439964,14969,4332,250
729447042,729444098,729460963,16865,4333,250
729468042,729465097,729480697,15600,4334,250
729487776,729484831,729503956,19125,4335,250
729511038,729508091,729526561,18470,4336,250
729533642,729530696,729547585,16889,4337,250
729554666,729551720,729570192,18472,4338,250
729577273,729574327,729590562,16235,4339,250
729597643,729594697,729611248,16551,4340,250
729618328,729615383,729631615,16232,4341,250
729638695,729635750,729651666,15916,4342,250
729658745,729655800,729673004,17204,4343,250
729680085,729677139,729692423,15284,4344,250
729699501,729696557,729715025,18468,4345,250
729722105,729719160,729737314,18154,4346,250
729744394,729741449,729760573,19124,4347,250
729767653,729764708,729784149,19441,4348,250
729791229,729788283,729803883,15600,4349,250
729810962,729808017,729825852,17835,4350,250
729832932,729829986,729845587,15601,4351,250
729852666,729849721,729867557,17836,4352,250
729874637,729871692,729888264,16572,4353,250
729895344,729892399,729910870,18471,4354,250
729917951,729915005,729932843,17838,4355,250
729939923,729936977,729953212,16235,4356,250
729960292,729957347,729973263,15916,4357,250
729980343,729977397,729994580,17183,4358,250
730001660,729998715,730016236,17521,4359,250
730023317,730020371,730037238,16867,4360,250
730044319,730041373,730059527,18154,4361,250
730066608,730063662,730081500,17838,4362,250
730088581,730085635,730102839,17204,4363,250
730109918,730106973,730125780,18807,4364,250
730132861,730129915,730149041,19126,4365,250
730155905,730153176,730170044,16868,4366,250
730177125,730174179,730192333,18154,4367,250
730199196,730196468,730212699,16231,4368,250
730219779,730216834,730232751,15917,4369,250
730239831,730236885,730255039,18154,4370,250
730262119,730259174,730275724,16550,4371,250
730282587,730279859,730298666,18807,4372,250
730305745,730302801,730317767,14966,4373,250
730324846,730321901,730338768,16867,4374,250
730345848,730342903,730361690,18787,4375,250
730368771,730365825,730383346,17521,4376,250
730390426,730387481,730405319,17838,4377,250
730412400,730409454,730426321,16867,4378,250
730433402,730430456,730446688,16232,4379,250
730453767,730450822,730469293,18471,4380,250
730476373,730473428,730490928,17500,4381,250
730498009,730495063,730511612,16549,4382,250
730518692,730515747,730532295,16548,4383,250
730539374,730536430,730555870,19440,4384,250
730562950,730560005,730578158,18153,4385,250
730585238,730582293,730601079,18786,4386,250
730608160,730605214,730621764,16550,4387,250
730628845,730625899,730643083,17184,4388,250
730650163,730647218,730666024,18806,4389,250
730672888,730670159,730685760,15601,4390,250
730692839,730689894,730707077,17183,4391,250
730714158,730711212,730729367,18155,4392,250
730736447,730733501,730751022,17521,4393,250
730758103,730755157,730771391,16234,4394,250
730778471,730775526,730793047,17521,4395,250
730800128,730797182,730815652,18470,4396,250
730822732,730819787,730838258,18471,4397,250
730845121,730842393,730857994,15601,4398,250
730865074,730862128,730879311,17183,4399,250
730886392,730883446,730899998,16552,4400,250
730907078,730904133,730919733,15600,4401,250
730926813,730923867,730939785,15918,4402,250
730946648,730943919,730960787,16868,4403,250
730967869,730964922,730981791,16869,4404,250
730988872,730985926,731000894,14968,4405,250
731007975,731005028,731021601,16573,4406,250
731028681,731025736,731043573,17837,4407,250
731050653,731047708,731065545,17837,4408,250
731072626,731069680,731086568,16888,4409,250
731093648,731090703,731109511,18808,4410,250
731116591,731113646,731131146,17500,4411,250
731138226,731135281,731153096,17815,4412,250
731160176,731157231,731173465,16234,4413,250
731180545,731177600,731196408,18808,4414,250
731203488,731200543,731217747,17204,4415,250
731224827,731221882,731237165,15283,4416,250
731244245,731241299,731259453,18154,4417,250
731266533,731263588,731281742,18154,4418,250
731288822,731285877,731303694,17817,4419,250
731310774,731307829,731323745,15916,4420,250
731330824,731327879,731347320,19441,4421,250
731354401,731351455,731370898,19443,4422,250
731377979,731375033,731391584,16551,4423,250
731398448,731395719,731415159,19440,4424,250
731422239,731419294,731437785,18491,4425,250
731444866,731441920,731459124,17204,4426,250
731466205,731463259,731480126,16867,4427,250
731486989,731484261,731501147,16886,4428,250
731508228,731505282,731524068,18786,4429,250
731531148,731528203,731547328,19125,4430,250
731554408,731551462,731573901,22439,4431,250
731580982,731578036,731600116,22080,4432,250
731607197,731604251,731620485,16234,4433,250
731627565,731624620,731642773,18153,4434,250
731649637,731646908,731662825,15917,4435,250
731669904,731666959,731685112,18153,4436,250
731691975,731689247,731706430,17183,4437,250
731713510,731710565,731728718,18153,4438,250
731735798,731732853,731749424,16571,4439,250
731756504,731753559,731771396,17837,4440,250
731778477,731775531,731792736,17205,4441,250
731799817,731796871,731815997,19126,4442,250
731823078,731820132,731837971,17839,4443,250
731845052,731842106,731857706,15600,4444,250
731864568,731861840,731878073,16233,4445,250
731885154,731882208,731900362,18154,4446,250
731907442,731904497,731922335,17838,4447,250
731929416,731926470,731942704,16234,4448,250
731949784,731946839,731965964,19125,4449,250
731973046,731970099,731986989,16890,4450,250
731993853,731991124,732008309,17185,4451,250
732015389,732012444,732028360,15916,4452,250
732035440,732032495,732049362,16867,4453,250
732056443,732053497,732071652,18155,4454,250
732078733,732075787,732093625,17838,4455,250
732100706,732097760,732113044,15284,4456,250
732120123,732117178,732134699,17521,4457,250
732141779,732138834,732154435,15601,4458,250
732161516,732158570,732176091,17521,4459,250
732183171,732180226,732199351,19125,4460,250
732206431,732203486,732219719,16233,4461,250
732226799,732223854,732241374,17520,4462,250
732248455,732245509,732263347,17838,4463,250
732270427,732267482,732285320,17838,4464,250
732292400,732289455,732304422,14967,4465,250
732311502,732308556,732325760,17204,4466,250
732332840,732329895,732348048,18153,4467,250
732355130,732352183,732367152,14969,4468,250
732374231,732371286,732387203,15917,4469,250
732394282,732391337,732407254,15917,4470,250
732414333,732411388,732428276,16888,4471,250
732435356,732432411,732450565,18154,4472,250
732457645,732454700,732470616,15916,4473,250
732477695,732474750,732490667,15917,4474,250
732497746,732494801,732511689,16888,4475,250
732518769,732515824,732532374,16550,4476,250
732539455,732536509,732552744,16235,4477,250
732559824,732556879,732573450,16571,4478,250
732580313,732577584,732593502,15918,4479,250
732600582,732597637,732614820,17183,4480,250
732621901,732618955,732637110,18155,4481,250
732643974,732641245,732660033,18788,4482,250
732666897,732664168,732681373,17205,4483,250
732688454,732685508,732702713,17205,4484,250
732709793,732706848,732725002,18154,4485,250
732732082,732729137,732748578,19441,4486,250
732755442,732752713,732771205,18492,4487,250
732778285,732775340,732793177,17837,4488,250
732800258,732797312,732813863,16551,4489,250
732820944,732817998,732835182,17184,4490,250
732842262,732839317,732857786,18469,4491,250
732864867,732861921,732878787,16866,4492,250
732885868,732882922,732899810,16888,4493,250
732906890,732903945,732923070,19125,4494,250
732930151,732927205,732944093,16888,4495,250
732951174,732948228,732965095,16867,4496,250
732972175,732969230,732987066,17836,4497,250
732994146,732991201,733006802,15601,4498,250
733013880,733010936,733027801,16865,4499,250
733034881,733031936,733048487,16551,4500,250
733055567,733052622,733069489,16867,4501,250
733076352,733073624,733088906,15282,4502,250
733095986,733093040,733110244,17204,4503,250
733117108,733114379,733131880,17501,4504,250
733138961,733136015,733153218,17203,4505,250
733160298,733157353,733173269,15916,4506,250
733180349,733177403,733193954,16551,4507,250
733201036,733198089,733214957,16868,4508,250
733222037,733219092,733235959,16867,4509,250
733243040,733240094,733257298,17204,4510,250
733264378,733261433,733280240,18807,4511,250
733287320,733284375,733301241,16866,4512,250
733308320,733305376,733322263,16887,4513,250
733329344,733326398,733343898,17500,4514,250
733350979,733348033,733365238,17205,4515,250
733372317,733369373,733385921,16548,4516,250
733393001,733390056,733408209,18153,4517,250
733415073,733412344,733429528,17184,4518,250
733436609,733433663,733452156,18493,4519,250
733459238,733456291,733474446,18155,4520,250
733481310,733478581,733495132,16551,4521,250
733502212,733499267,733517737,18470,4522,250
733524818,733521872,733538444,16572,4523,250
733545308,733542579,733558180,15601,4524,250
733565042,733562314,733578230,15916,4525,250
733585308,733582364,733601150,18786,4526,250
733608230,733605285,733621202,15917,4527,250
733628064,733625336,733642222,16886,4528,250
733649302,733646357,733664511,18154,4529,250
733671593,733668646,733684248,15602,4530,250
733691328,733688383,733707825,19442,4531,250
733714905,733711960,733727876,15916,4532,250
733734956,733732010,733748583,16573,4533,250
733755663,733752718,733768950,16232,4534,250
733776030,733773085,733790606,17521,4535,250
733797686,733794741,733813865,19124,4536,250
733820946,733818000,733836789,18789,4537,250
733843869,733840924,733857789,16865,4538,250
733864869,733861924,733877524,15600,4539,250
733884603,733881658,733897258,15600,4540,250
733904337,733901392,733919884,18492,4541,250
733926965,733924019,733941203,17184,4542,250
733948282,733945338,733961886,16548,4543,250
733968749,733966021,733982254,16233,4544,250
733989334,733986389,734004544,18155,4545,250
734011625,734008679,734025229,16550,4546,250
734032308,734029363,734046884,17521,4547,250
734053965,734051019,734067886,16867,4548,250
734074967,734072021,734089227,17206,4549,250
734096307,734093362,734112148,18786,4550,250
734119226,734116282,734133463,17181,4551,250
734140543,734137598,734152565,14967,4552,250
734159644,734156699,734175507,18808,4553,250
734182371,734179642,734196510,16868,4554,250
734203591,734200645,734218146,17501,4555,250
734225227,734222281,734241068,18787,4556,250
734248149,734245203,734261754,16551,4557,250
734268834,734265889,734283705,17816,4558,250
734290569,734287840,734305341,17501,4559,250
734312422,734309476,734326997,17521,4560,250
734334079,734331132,734347368,16236,4561,250
734354448,734351503,734369002,17499,4562,250
734376083,734373137,734391945,18808,4563,250
734399026,734396080,734411998,15918,4564,250
734419076,734416132,734433630,17498,4565,250
734440492,734437764,734454651,16887,4566,250
734461730,734458785,734475018,16233,4567,250
734482098,734479153,734495386,16233,4568,250
734502468,734499521,734516726,17205,4569,250
734523807,734520861,734538699,17838,4570,250
734545780,734542834,734560356,17522,4571,250
734567434,734564490,734581693,17203,4572,250
734588773,734585828,734603664,17836,4573,250
734610743,734607799,734624685,16886,4574,250
734631765,734628820,734644418,15598,4575,250
734651497,734648552,734665103,16551,4576,250
734672184,734669238,734688047,18809,4577,250
734695128,734692182,734707148,14966,4578,250
734714227,734711282,734728466,17184,4579,250
734735546,734732601,734748517,15916,4580,250
734755597,734752651,734769855,17204,4581,250
734776936,734773990,734791510,17520,4582,250
734798374,734795645,734813483,17838,4583,250
734820563,734817618,734833851,16233,4584,250
734840933,734837986,734853905,15919,4585,250
734860985,734858039,734876194,18155,4586,250
734883276,734880329,734897830,17501,4587,250
734904692,734901964,734918197,16233,4588,250
734925277,734922332,734939537,17205,4589,250
734946617,734943672,734961172,17500,4590,250
734968253,734965307,734984748,19441,4591,250
734991828,734988883,735005116,16233,4592,250
735012198,735009251,735025486,16235,4593,250
735032567,735029621,735044589,14968,4594,250
735051669,735048723,735065591,16868,4595,250
735072671,735069726,735086275,16549,4596,250
735093355,735090410,735109219,18809,4597,250
735116299,735113354,735132794,19440,4598,250
735139875,735136929,735154451,17522,4599,250
735161531,735158586,735177057,18471,4600,250
735184139,735181192,735198714,17522,4601,250
735205578,735202849,735218765,15916,4602,250
735225843,735222899,735238498,15599,4603,250
735245577,735242632,735258865,16233,4604,250
735265945,735263000,735277966,14966,4605,250
735285045,735282100,735298650,16550,4606,250
735305729,735302785,735319988,17203,4607,250
735327070,735324123,735342279,18156,4608,250
735349358,735346414,735363934,17520,4609,250
735371015,735368069,735385273,17204,4610,250
735392354,735389408,735406614,17206,4611,250
735413694,735410749,735428248,17499,4612,250
735435329,735432383,735450517,18134,4613,250
735457598,735454652,735471520,16868,4614,250
735478601,735475655,735493176,17521,4615,250
735500256,735497311,735513861,16550,4616,250
735520942,735517996,735534229,16233,4617,250
735541093,735538364,735553965,15601,4618,250
735561044,735558099,735574649,16550,4619,250
735581730,735578784,735595969,17185,4620,250
735602833,735600104,735616338,16234,4621,250
735623418,735620473,735637339,16866,4622,250
735644420,735641474,735657074,15600,4623,250
735664153,735661208,735678390,17182,4624,250
735685470,735682525,735698757,16232,4625,250
735705837,735702892,735719757,16865,4626,250
735726837,735723892,735740442,16550,4627,250
735747522,735744577,735761464,16887,4628,250
735768543,735765598,735782802,17204,4629,250
735789883,735786937,735804776,17839,4630,250
735811639,735808911,735824512,15601,4631,250
735831375,735828646,735845514,16868,4632,250
735852594,735849649,735866516,16867,4633,250
735873596,735870651,735885934,15283,4634,250
735893013,735890068,735908221,18153,4635,250
735915084,735912356,735929560,17204,4636,250
735936640,735933695,735950582,16887,4637,250
735957662,735954717,735972870,18153,4638,250
735979951,735977005,735994843,17838,4639,250
736001923,735998978,736015211,16233,4640,250
736022291,736019346,736036844,17498,4641,250
736043923,736040978,736057528,16550,4642,250
736064607,736061662,736079182,17520,4643,250
736086047,736083317,736100522,17205,4644,250
736107601,736104656,736122177,17521,4645,250
736129258,736126312,736142230,15918,4646,250
736149309,736146364,736162598,16234,4647,250
736169678,736166733,736182334,15601,4648,250
736189413,736186468,736202701,16233,4649,250
736209781,736206836,736223385,16549,4650,250
736230465,736227520,736244701,17181,4651,250
736251782,736248836,736266990,18154,4652,250
736274071,736271125,736289280,18155,4653,250
736296362,736293415,736309650,16235,4654,250
736316731,736313785,736330020,16235,4655,250
736337100,736334154,736349755,15601,4656,250
736356833,736353889,736372379,18490,4657,250
736379459,736376514,736391797,15283,4658,250
736398878,736395931,736411849,15918,4659,250
736418929,736415983,736434138,18155,4660,250
736441218,736438273,736455478,17205,4661,250
736462342,736459613,736475529,15916,4662,250
736482610,736479663,736497819,18156,4663,250
736504681,736501954,736519158,17204,4664,250
736526237,736523292,736540812,17520,4665,250
736547892,736544947,736562152,17205,4666,250
736569232,736566287,736585096,18809,4667,250
736592176,736589231,736606435,17204,4668,250
736613515,736610570,736627436,16866,4669,250
736634517,736631571,736648437,16866,4670,250
736655517,736652572,736669438,16866,4671,250
736676519,736673573,736689808,16235,4672,250
736696888,736693942,736709859,15917,4673,250
736716938,736713993,736732780,18787,4674,250
736739861,736736915,736755407,18492,4675,250
736762486,736759541,736776407,16866,4676,250
736783487,736780542,736796459,15917,4677,250
736803538,736800593,736818093,17500,4678,250
736825174,736822228,736839095,16867,4679,250
736846175,736843230,736859147,15917,4680,250
736866227,736863282,736880486,17204,4681,250
736887566,736884621,736902121,17500,4682,250
736909202,736906256,736922807,16551,4683,250
736929888,736926942,736944464,17522,4684,250
736951544,736948599,736964832,16233,4685,250
736971912,736968967,736985854,16887,4686,250
736992935,736989989,737008777,18788,4687,250
737015857,737012912,737028512,15600,4688,250
737035592,737032646,737048564,15918,4689,250
737055644,737052698,737068932,16234,4690,250
737076013,737073067,737089934,16867,4691,250
737097015,737094069,737113195,19126,4692,250
737120275,737117330,737133879,16549,4693,250
737140960,737138014,737155853,17839,4694,250
737162933,737159988,737177509,17521,4695,250
737184590,737181644,737198827,17183,4696,250
737205907,737202962,737221095,18133,4697,250
737228175,737225230,737241463,16233,4698,250
737248545,737245598,737262151,16553,4699,250
737269232,737266286,737283806,17520,4700,250
737290887,737287941,737304809,16868,4701,250
737311888,737308943,737324544,15601,4702,250
737331623,737328678,737346178,17500,4703,250
737353258,737350312,737366862,16550,4704,250
737373941,737370996,737389148,18152,4705,250
737396228,737393282,737409515,16233,4706,250
737416378,737413650,737431486,17836,4707,250
737438567,737435621,737451856,16235,4708,250
737458937,737455990,737471908,15918,4709,250
737478770,737476042,737492275,16233,4710,250
737499354,737496409,737513928,17519,4711,250
737520791,737518062,737535582,17520,4712,250
737542663,737539717,737556267,16550,4713,250
737563347,737560402,737577921,17519,4714,250
737585000,737582055,737598288,16233,4715,250
737605369,737602423,737618973,16550,4716,250
737625836,737623107,737640290,17183,4717,250
737647369,737644424,737659707,15283,4718,250
737666786,737663841,737681023,17182,4719,250
737688104,737685158,737702025,16867,4720,250
737709104,737706159,737723026,16867,4721,250
737729891,737727161,737744684,17523,4722,250
737751765,737748818,737764737,15919,4723,250
737771815,737768871,737784786,15915,4724,250
737791865,737788920,737806123,17203,4725,250
737813203,737810257,737829381,19124,4726,250
737836461,737833515,737852303,18788,4727,250
737859384,737856438,737873960,17522,4728,250
737881041,737878095,737894962,16867,4729,250
737902043,737899097,737917568,18471,4730,250
737924648,737921702,737940174,18472,4731,250
737947036,737944308,737961489,17181,4732,250
737968569,737965624,737981857,16233,4733,250
737988937,737985991,738003830,17839,4734,250
738010694,738007965,738026773,18808,4735,250
738033853,738030907,738048744,17837,4736,250
738055824,738052878,738069112,16234,4737,250
738076192,738073247,738091400,18153,4738,250
738098480,738095535,738114004,18469,4739,250
738121083,738118138,738134688,16550,4740,250
738141768,738138823,738155711,16888,4741,250
738162791,738159846,738177029,17183,4742,250
738184110,738181164,738198683,17519,4743,250
738205763,738202818,738221288,18470,4744,250
738228369,738225423,738242943,17520,4745,250
738249808,738247078,738262680,15602,4746,250
738269760,738266814,738283702,16888,4747,250
738290782,738287837,738305356,17519,4748,250
738312436,738309491,738325092,15601,4749,250
738332171,738329225,738348349,19124,4750,250
738355430,738352484,738368086,15602,4751,250
738375166,738372220,738387821,15601,4752,250
738394900,738391955,738408821,16866,4753,250
738415901,738412956,738429189,16233,4754,250
738436269,738433324,738448923,15599,4755,250
738456002,738453057,738470578,17521,4756,250
738477658,738474713,738491917,17204,4757,250
738498999,738496052,738512921,16869,4758,250
738520001,738517055,738535208,18153,4759,250
738542289,738539343,738558153,18810,4760,250
738565233,738562288,738581729,19441,4761,250
738588809,738585864,738603068,17204,4762,250
738610150,738607203,738626012,18809,4763,250
738633095,738630147,738646700,16553,4764,250
738653781,738650835,738669960,19125,4765,250
738677041,738674095,738689062,14967,4766,250
738696142,738693196,738709430,16234,4767,250
738716510,738713564,738730115,16551,4768,250
738737197,738734250,738751772,17522,4769,250
738758852,738755907,738771824,15917,4770,250
738778904,738775958,738794112,18154,4771,250
738801193,738798247,738816062,17815,4772,250
738822925,738820196,738837718,17522,4773,250
738844582,738841853,738860007,18154,4774,250
738867088,738864142,738882297,18155,4775,250
738889378,738886432,738905557,19125,4776,250
738912637,738909692,738928815,19123,4777,250
738935895,738932950,738948865,15915,4778,250
738955945,738952999,738970183,17184,4779,250
738977262,738974317,738990233,15916,4780,250
738997314,738994367,739011573,17206,4781,250
739018653,739015708,739033208,17500,4782,250
739040289,739037343,739053260,15917,4783,250
739060122,739057394,739075548,18154,4784,250
739082628,739079683,739096254,16571,4785,250
739103334,739100389,739116938,16549,4786,250
739124018,739121073,739138256,17183,4787,250
739145337,739142391,739158308,15917,4788,250
739165388,739162443,739180281,17838,4789,250
739187361,739184416,739200650,16234,4790,250
739207731,739204785,739222284,17499,4791,250
739229364,739226419,739243939,17520,4792,250
739251019,739248074,739265278,17204,4793,250
739272358,739269412,739286279,16867,4794,250
739293358,739290413,739309537,19124,4795,250
739316400,739313672,739330537,16865,4796,250
739337616,739334671,739352486,17815,4797,250
739359565,739356620,739374119,17499,4798,250
739381198,739378253,739395139,16886,4799,250
739402219,739399273,739415505,16232,4800,250
739422367,739419639,739436189,16550,4801,250
739443269,739440324,739458478,18154,4802,250
739465559,739462613,739478531,15918,4803,250
739485611,739482665,739499847,17182,4804,250
739506928,739503982,739521186,17204,4805,250
739528267,739525321,739540922,15601,4806,250
739547784,739545056,739562556,17500,4807,250
739569636,739566691,739585161,18470,4808,250
739592240,739589295,739606477,17182,4809,250
739613558,739610612,739630053,19441,4810,250
739637133,739634188,739652995,18807,4811,250
739660075,739657130,739675284,18154,4812,250
739682363,739679418,739695967,16549,4813,250
739703047,739700102,739718254,18152,4814,250
739725335,739722389,739739277,16888,4815,250
739746357,739743411,739760933,17522,4816,250
739768012,739765067,739783221,18154,4817,250
739790302,739787356,739803591,16235,4818,250
739810672,739807726,739824614,16888,4819,250
739831695,739828749,739844666,15917,4820,250
739851745,739848800,739865350,16550,4821,250
739872430,739869484,739886688,17204,4822,250
739893768,739890823,739907709,16886,4823,250
739914789,739911844,739928416,16572,4824,250
739935496,739932551,739949101,16550,4825,250
739956183,739953236,739972678,19442,4826,250
739979759,739976812,739994968,18156,4827,250
740002049,739999103,740017890,18787,4828,250
740024971,740022025,740038913,16888,4829,250
740045993,740043048,740060231,17183,4830,250
740067094,740064366,740082201,17835,4831,250
740089282,740086336,740103223,16887,4832,250
740110304,740107358,740126800,19442,4833,250
740133879,740130934,740146218,15284,4834,250
740153298,740150352,740167239,16887,4835,250
740174319,740171374,740187290,15916,4836,250
740194369,740191424,740209261,17837,4837,250
740216342,740213396,740230916,17520,4838,250
740237996,740235051,740252571,17520,4839,250
740259652,740256706,740273278,16572,4840,250
740280358,740277413,740293329,15916,4841,250
740300408,740297463,740314646,17183,4842,250
740321727,740318781,740337273,18492,4843,250
740344353,740341408,740358590,17182,4844,250
740365670,740362725,740381195,18470,4845,250
740388276,740385330,740400932,15602,4846,250
740408012,740405066,740422250,17184,4847,250
740429329,740426385,740442934,16549,4848,250
740449798,740447069,740463301,16232,4849,250
740470382,740467436,740484619,17183,4850,250
740491700,740488754,740506593,17839,4851,250
740513674,740510728,740527932,17204,4852,250
740535011,740532067,740550219,18152,4853,250
740557300,740554354,740572191,17837,4854,250
740579272,740576326,740592877,16551,4855,250
740599956,740597011,740614827,17816,4856,250
740621907,740618962,740635829,16867,4857,250
740642910,740639964,740657485,17521,4858,250
740664568,740661620,740678510,16890,4859,250
740685591,740682645,740701116,18471,4860,250
740708197,740705251,740723090,17839,4861,250
740730170,740727225,740744090,16865,4862,250
740751171,740748225,740767035,18810,4863,250
740774116,740771170,740788375,17205,4864,250
740795238,740792510,740808744,16234,4865,250
740815825,740812879,740831033,18154,4866,250
740838114,740835168,740851719,16551,4867,250
740858582,740855854,740872403,16549,4868,250
740879266,740876538,740893720,17182,4869,250
740900801,740897855,740916664,18809,4870,250
740923744,740920799,740939291,18492,4871,250
740946372,740943426,740960312,16886,4872,250
740967394,740964447,740982287,17840,4873,250
740989369,740986422,741003628,17206,4874,250
741010708,741007763,741027205,19442,4875,250
741034285,741031340,741048543,17203,4876,250
741055624,741052678,741071150,18472,4877,250
741078231,741075285,741094411,19126,4878,250
741101491,741098546,741116362,17816,4879,250
741123443,741120497,741137363,16866,4880,250
741144444,741141498,741158387,16889,4881,250
741165468,741162522,741180043,17521,4882,250
741186907,741184178,741202016,17838,4883,250
741209097,741206151,741223355,17204,4884,250
741230436,741227490,741242458,14968,4885,250
741249538,741246592,741263460,16868,4886,250
741270541,741267595,741285117,17522,4887,250
741292197,741289252,741305801,16549,4888,250
741312881,741309936,741327139,17203,4889,250
741334220,741331274,741348794,17520,4890,250
741355875,741352929,741369163,16234,4891,250
741376245,741373298,741390503,17205,4892,250
741397583,741394638,741412476,17838,4893,250
741419557,741416611,741432844,16233,4894,250
741439924,741436979,741453212,16233,4895,250
741460293,741457347,741473582,16235,4896,250
741480664,741477717,741494606,16889,4897,250
741501688,741498741,741515293,16552,4898,250
741522373,741519428,741538215,18787,4899,250
741545295,741542350,741558584,16234,4900,250
741565447,741562719,741584597,21878,4901,250
741591460,741588732,741608583,19851,4902,250
741615664,741612718,741628320,15602,4903,250
741635400,741632454,741651580,19126,4904,250
741658660,741655715,741671316,15601,4905,250
741678395,741675450,741692654,17204,4906,250
741699735,741696789,741712073,15284,4907,250
741719152,741716207,741733726,17519,4908,250
741740806,741737861,741756015,18154,4909,250
741763095,741760150,741776383,16233,4910,250
741783463,741780517,741797702,17185,4911,250
741804782,741801837,741819041,17204,4912,250
741826121,741823176,741841329,18153,4913,250
741848409,741845464,741863935,18471,4914,250
741871015,741868070,741886857,18787,4915,250
741893937,741890992,741908492,17500,4916,250
741915357,741912627,741930782,18155,4917,250
741937862,741934917,741950833,15916,4918,250
741957912,741954967,741970567,15600,4919,250
741977646,741974701,741993170,18469,4920,250
742000251,741997305,742014511,17206,4921,250
742021376,742018646,742036148,17502,4922,250
742043228,742040283,742057804,17521,4923,250
742064884,742061939,742079460,17521,4924,250
742086541,742083595,742101434,17839,4925,250
742108298,742105569,742123091,17522,4926,250
742130171,742127226,742143776,16550,4927,250
742150856,742147911,742163826,15915,4928,250
742170906,742167960,742184826,16866,4929,250
742191689,742188961,742205193,16232,4930,250
742212057,742209328,742226850,17522,4931,250
742233931,742230985,742248191,17206,4932,250
742255055,742252326,742270164,17838,4933,250
742277244,742274299,742289900,15601,4934,250
742296979,742294034,742309318,15284,4935,250
742316396,742313452,742330972,17520,4936,250
742338052,742335107,742351024,15917,4937,250
742358105,742355159,742372364,17205,4938,250
742379445,742376499,742393703,17204,4939,250
742400784,742397838,742416329,18491,4940,250
742423409,742420463,742437985,17522,4941,250
742445066,742442120,742460591,18471,4942,250
742467673,742464726,742480959,16233,4943,250
742488039,742485094,742501642,16548,4944,250
742508723,742505777,742521060,15283,4945,250
742528141,742525194,742541745,16551,4946,250
742548824,742545879,742561479,15600,4947,250
742568559,742565613,742583431,17818,4948,250
742590510,742587566,742604452,16886,4949,250
742611533,742608587,742624187,15600,4950,250
742631266,742628321,742644238,15917,4951,250
742651317,742648372,742666187,17815,4952,250
742673266,742670322,742685920,15598,4953,250
742692999,742690054,742707238,17184,4954,250
742714318,742711373,742727289,15916,4955,250
742734369,742731423,742748312,16889,4956,250
742755176,742752447,742770263,17816,4957,250
742777344,742774398,742790949,16551,4958,250
742798030,742795084,742811971,16887,4959,250
742819051,742816106,742833626,17520,4960,250
742840706,742837760,742854311,16551,4961,250
742861390,742858445,742875331,16886,4962,250
742882411,742879466,742896987,17521,4963,250
742904067,742901122,742917988,16866,4964,250
742925068,742922123,742940276,18153,4965,250
742947356,742944411,742960644,16233,4966,250
742967723,742964778,742981327,16549,4967,250
742988191,742985462,743002983,17521,4968,250
743009847,743007118,743022719,15601,4969,250
743029798,743026853,743045977,19124,4970,250
743053058,743050112,743068266,18154,4971,250
743075346,743072401,743089922,17521,4972,250
743097003,743094057,743109342,15285,4973,250
743116421,743113476,743131313,17837,4974,250
743138394,743135448,743153920,18472,4975,250
743161001,743158055,743175893,17838,4976,250
743182757,743180028,743195945,15917,4977,250
743202808,743200079,743216629,16550,4978,250
743223709,743220764,743237967,17203,4979,250
743245047,743242101,743259305,17204,4980,250
743266384,743263440,743279039,15599,4981,250
743286121,743283173,743299408,16235,4982,250
743306488,743303543,743319775,16232,4983,250
743326638,743323910,743341114,17204,4984,250
743348196,743345249,743364037,18788,4985,250
743371118,743368172,743386010,17838,4986,250
743393090,743390145,743405745,15600,4987,250
743412824,743409879,743427084,17205,4988,250
743434165,743431219,743448424,17205,4989,250
743455504,743452559,743471683,19124,4990,250
743478763,743475818,743493338,17520,4991,250
743500419,743497473,743513706,16233,4992,250
743520786,743517841,743537283,19442,4993,250
743544362,743541418,743558621,17203,4994,250
743565701,743562756,743580571,17815,4995,250
743587651,743584706,743601573,16867,4996,250
743608653,743605708,743622574,16866,4997,250
743629655,743626709,743643914,17205,4998,250
743650996,743648049,743664917,16868,4999,250
743671997,743669052,743687860,18808,5000,250
743695240,743691995,743715272,23277,1,275
743722278,743719251,743742944,23693,2,275
743749941,743746912,743769637,22725,3,275
743776746,743773502,743797728,24226,4,275
743804839,743801594,743823901,22307,5,275
743830920,743827892,743850931,23039,6,275
743857888,743854861,743878892,24031,7,275
743886001,743882758,743906033,23275,8,275
743913144,743909899,743933177,23278,9,275
743940136,743937111,743961772,24661,10,275
743968970,743965726,743990607,24881,11,275
743997680,743994652,744019611,24959,12,275
744026649,744023621,744048580,24959,13,275
744055648,744052622,744074709,22087,14,275
744081773,744078746,744102439,23693,15,275
744109637,744106393,744132223,25830,16,275
744139289,744136262,744159638,23376,17,275
744166717,744163690,744188650,24960,18,275
744195849,744192605,744214910,22305,19,275
744222109,744218865,744244694,25829,20,275
744251752,744248725,744273703,24978,21,275
744280758,744277731,744301086,23355,22,275
744308285,744305041,744329902,24861,23,275
744337102,744333857,744355531,21674,24,275
744362730,744359486,744383396,23910,25,275
744390595,744387351,744409340,21989,26,275
744416539,744413295,744436550,23255,27,275
744443635,744440609,744465270,24661,28,275
744472469,744469225,744494739,25514,29,275
744501938,744498694,744521314,22620,30,275
744528346,744525318,744547427,22109,31,275
744554523,744551496,744575822,24326,32,275
744583021,744579777,744602399,22622,33,275
744609443,744606416,744629137,22721,34,275
744636119,744633092,744656685,23593,35,275
744663884,744660640,744684211,23571,36,275
744691410,744688166,744713997,25831,37,275
744721196,744717952,744741208,23256,38,275
744748253,744745225,744770523,25298,39,275
744777721,744774478,744796781,22303,40,275
744803980,744800736,744823676,22940,41,275
744830875,744827631,744852807,25176,42,275
744860006,744856762,744882276,25514,43,275
744889332,744886304,744909660,23356,44,275
744916859,744913615,744934971,21356,45,275
744942059,744939032,744961754,22722,46,275
744968817,744965790,744991066,25276,47,275
744998093,744995065,745015572,20507,48,275
745022641,745019614,745042652,23038,49,275
745049851,745046607,745068596,21989,50,275
745075646,745072619,745095658,23039,51,275
745102727,745099698,745122443,22745,52,275
745129508,745126482,745149858,23376,53,275
745157057,745153813,745179960,26147,54,275
745187036,745184009,745206750,22741,55,275
745213807,745210780,745231603,20823,56,275
745238693,745235666,745259991,24325,57,275
745267191,745263946,745288174,24228,58,275
745295209,745292182,745315854,23672,59,275
745323054,745319809,745342748,22939,60,275
745349948,745346703,745371564,24861,61,275
745378763,745375519,745400063,24544,62,275
745407262,745404018,745424741,20723,63,275
745431814,745428787,745451193,22406,64,275
745458252,745455225,745478284,23059,65,275
745485337,745482310,745506973,24663,66,275
745514037,745511011,745534071,23060,67,275
745541159,745538132,745561191,23059,68,275
745568390,745565146,745590342,25196,69,275
745597430,745594404,745617441,23037,70,275
745624640,745621396,745644354,22958,71,275
745651553,745648309,745671268,22959,72,275
745678334,745675308,745700264,24956,73,275
745707463,745704219,745727812,23593,74,275
745734879,745731851,745756514,24663,75,275
745763578,745760550,745784877,24327,76,275
745791982,745788955,745812648,23693,77,275
745819716,745816690,745840698,24008,78,275
745847897,745844653,745868245,23592,79,275
745875311,745872282,745897265,24983,80,275
745904464,745901220,745926079,24859,81,275
745933165,745930138,745952565,22427,82,275
745959626,745956598,745977422,20824,83,275
745984621,745981377,746003683,22306,84,275
746010726,746007698,746032974,25276,85,275
746040173,746036929,746059867,22938,86,275
746067067,746063822,746088387,24565,87,275
746095461,746092433,746117076,24643,88,275
746124276,746121031,746145574,24543,89,275
746152639,746149613,746173621,24008,90,275
746180670,746177642,746203257,25615,91,275
746210456,746207212,746230469,23257,92,275
746237667,746234424,746259621,25197,93,275
746266661,746263633,746286672,23039,94,275
746293873,746290627,746315487,24860,95,275
746322686,746319442,746343035,23593,96,275
746350098,746347070,746368209,21139,97,275
746375191,746372164,746395418,23254,98,275
746402617,746399373,746422627,23254,99,275
746429724,746426697,746450388,23691,100,275
746457676,746454432,746478321,23889,101,275
746485515,746482487,746504915,22428,102,275
746512062,746509035,746530490,21455,103,275
746537779,746534533,746558106,23573,104,275
746565270,746562243,746587538,25295,105,275
746594678,746591651,746615005,23354,106,275
746622293,746619049,746642642,23593,107,275
746649776,746646748,746668838,22090,108,275
746675978,746672952,746695674,22722,109,275
746702961,746699718,746722974,23256,110,275
746730045,746727018,746750926,23908,111,275
746758107,746755080,746779067,23987,112,275
746786355,746783111,746807337,24226,113,275
746814409,746811381,746835289,23908,114,275
746842577,746839333,746862927,23594,115,275
746870090,746867063,746890736,23673,116,275
746897881,746894853,746918863,24010,117,275
746926153,746922907,746946819,23912,118,275
746953935,746950908,746972998,22090,119,275
746980178,746977150,746998291,21141,120,275
747005450,747002421,747025460,23039,121,275
747032619,747029592,747050415,20823,122,275
747057605,747054579,747077931,23352,123,275
747085219,747081975,747105862,23887,124,275
747113027,747110000,747134326,24326,125,275
747141614,747138370,747164179,25809,126,275
747171461,747168434,747191156,22722,127,275
747198328,747195300,747218045,22745,128,275
747225182,747222155,747243928,21773,129,275
747251112,747248085,747271755,23670,130,275
747278827,747275799,747300997,25198,131,275
747308286,747305041,747329606,24565,132,275
747336894,747333650,747360768,27118,133,275
747367937,747364910,747388919,24009,134,275
747396206,747392963,747417822,24859,135,275
747425110,747422082,747446072,23990,136,275
747453269,747450242,747472352,22110,137,275
747479639,747476396,747501888,25492,138,275
747509178,747505932,747528874,22942,139,275
747536042,747533014,747556053,23039,140,275
747563341,747560096,747583056,22960,141,275
747590196,747587168,747610859,23691,142,275
747618146,747614902,747635624,20722,143,275
747642761,747639733,747663427,23694,144,275
747670607,747667579,747690618,23039,145,275
747697906,747694662,747719501,24839,146,275
747726790,747723545,747747137,23592,147,275
747754425,747751181,747774121,22940,148,275
747781313,747778285,747802296,24011,149,275
747809583,747806339,747831515,25176,150,275
747838688,747835660,747858698,23038,151,275
747865844,747862817,747886805,23988,152,275
747894092,747890849,747913788,22939,153,275
747920960,747917933,747939072,21139,154,275
747946359,747943115,747967341,24226,155,275
747974495,747971467,747997061,25594,156,275
748004350,748001105,748024994,23889,157,275
748032283,748029038,748053243,24205,158,275
748060531,748057287,748080564,23277,159,275
748087710,748084683,748106456,21773,160,275
748113620,748110591,748134602,24011,161,275
748141886,748138646,748164133,25487,162,275
748171420,748168177,748189848,21671,163,275
748197137,748193892,748218435,24543,164,275
748225592,748222564,748245625,23061,165,275
748252773,748249746,748272152,22406,166,275
748279440,748276196,748302340,26144,167,275
748309483,748306456,748332068,25612,168,275
748339218,748336191,748360515,24324,169,275
748367632,748364605,748389543,24938,170,275
748396733,748393706,748417083,23377,171,275
748424371,748421127,748445332,24205,172,275
748452619,748449376,748473918,24542,173,275
748481064,748478037,748503312,25275,174,275
748510596,748507357,748532865,25508,175,275
748540154,748537126,748558583,21457,176,275
748565870,748562627,748585902,23275,177,275
748593033,748590005,748612094,22089,178,275
748619265,748616238,748639615,23377,179,275
748646903,748643659,748670776,27117,180,275
748678064,748674821,748699679,24858,181,275
748706804,748703775,748725548,21773,182,275
748732836,748729593,748751896,22303,183,275
748759184,748755940,748780167,24227,184,275
748787341,748784314,748806403,22089,185,275
748813546,748810519,748833874,23355,186,275
748841163,748837918,748862124,24206,187,275
748869308,748866280,748890311,24031,188,275
748897441,748894414,748920344,25930,189,275
748927632,748924388,748947327,22939,190,275
748954458,748951431,748973203,21772,191,275
748980274,748977247,749002740,25493,192,275
749010028,749006785,749030040,23255,193,275
749037232,749034205,749057560,23355,194,275
749064850,749061605,749083278,21673,195,275
749090461,749087434,749111104,23670,196,275
749118391,749115148,749138404,23256,197,275
749145693,749142448,749165092,22644,198,275
749172379,749169136,749195281,26145,199,275
749202569,749199326,749223234,23908,200,275
749230523,749227279,749250535,23256,201,275
749257823,749254580,749277201,22621,202,275
749284490,749281246,749303234,21988,203,275
749310383,749307356,749332969,25613,204,275
749340117,749337090,749360466,23376,205,275
749367603,749364576,749388901,24325,206,275
749396044,749393015,749414474,21459,207,275
749421765,749418519,749442746,24227,208,275
749450035,749446791,749471967,25176,209,275
749479255,749476229,749499584,23355,210,275
749506774,749503747,749528706,24959,211,275
749535850,749532823,749557148,24325,212,275
749564436,749561193,749584784,23591,213,275
749592066,749589040,749613365,24325,214,275
749620522,749617493,749641504,24011,215,275
749648705,749645679,749669666,23987,216,275
749676953,749673711,749699224,25513,217,275
749706396,749703368,749727377,24009,218,275
749734666,749731422,749754361,22939,219,275
749761651,749758406,749783581,25175,220,275
749790870,749787626,749812485,24859,221,275
749819773,749816530,749839785,23255,222,275
749846949,749843922,749870506,26584,223,275
749877795,749874768,749899706,24938,224,275
749906894,749903866,749925956,22090,225,275
749933244,749930001,749953276,23275,226,275
749960565,749957321,749981209,23888,227,275
749988497,749985254,750009143,23889,228,275
750016291,750013264,750038222,24958,229,275
750045414,750042386,750064791,22405,230,275
750071955,750068927,750093232,24305,231,275
750100520,750097277,750120215,22938,232,275
750127504,750124260,750149119,24859,233,275
750156408,750153164,750176124,22960,234,275
750183264,750180236,750202010,21774,235,275
750209178,750206150,750229506,23356,236,275
750236795,750233551,750256194,22643,237,275
750263393,750260365,750284057,23692,238,275
750291188,750288160,750309933,21773,239,275
750317067,750314040,750338366,24326,240,275
750345525,750342498,750364587,22089,241,275
750371760,750368734,750392109,23375,242,275
750399305,750396277,750420581,24304,243,275
750427764,750424736,750448745,24009,244,275
750455896,750452869,750476878,24009,245,275
750484167,750481139,750503229,22090,246,275
750510396,750507369,750529457,22088,247,275
750536612,750533584,750557616,24032,248,275
750564762,750561734,750585090,23356,249,275
750592379,750589135,750614626,25491,250,275
750621916,750618888,750642264,23376,251,275
750649382,750646354,750669709,23355,252,275
750676998,750673754,750697031,23277,253,275
750704320,750701076,750724034,22958,254,275
750731172,750728146,750752471,24325,255,275
750759671,750756643,750779050,22407,256,275
750786340,750783095,750805719,22624,257,275
750812874,750809847,750833224,23377,258,275
750840514,750837269,750860863,23594,259,275
750867935,750864908,750888500,23592,260,275
750895654,750892627,750916298,23671,261,275
750923587,750920343,750944569,24226,262,275
750951858,750948614,750971574,22960,263,275
750978731,750975704,751000347,24643,264,275
751007488,751004461,751025283,20822,265,275
751032572,751029328,751052267,22939,266,275
751059557,751056312,751080539,24227,267,275
751087828,751084584,751110415,25831,268,275
751117556,751114528,751135668,21140,269,275
751142956,751139712,751165879,26167,270,275
751173169,751169925,751193498,23573,271,275
751200787,751197543,751223373,25830,272,275
751230570,751227543,751253133,25590,273,275
751260293,751257265,751280938,23673,274,275
751288010,751284983,751309525,24542,275,275
751316672,751313645,751337337,23692,276,275
751344625,751341382,751365608,24226,277,275
751372897,751369653,751396117,26464,278,275
751403406,751400162,751426626,26464,279,275
751433910,751430672,751455209,24537,280,275
751462372,751459344,751483038,23694,281,275
751490224,751487197,751510869,23672,282,275
751518158,751514914,751540428,25514,283,275
751547717,751544473,751578554,34081,284,275
751585711,751582684,751605405,22721,285,275
751612694,751609450,751634627,25177,286,275
751641756,751638728,751664976,26248,287,275
751672265,751669238,751692593,23355,288,275
751699789,751696761,751719822,23061,289,275
751727010,751723982,751746704,22722,290,275
751753868,751750842,751774511,23669,291,275
751781800,751778556,751802150,23594,292,275
751809330,751806304,751827759,21455,293,275
751834947,751831920,751856224,24304,294,275
751863513,751860486,751885445,24959,295,275
751892574,751889547,751915139,25592,296,275
751922428,751919184,751943093,23909,297,275
751950382,751947354,751971343,23989,298,275
751978634,751975388,752001536,26148,299,275
752008825,752005581,752030440,24859,300,275
752037586,752034557,752059221,24664,301,275
752066366,752063338,752085425,22087,302,275
752092566,752089538,752112281,22743,303,275
752119434,752116407,752141387,24980,304,275
752148677,752145432,752169975,24543,305,275
752177264,752174020,752196642,22622,306,275
752203932,752200687,752223628,22941,307,275
752230791,752227765,752248586,20821,308,275
752255783,752252755,752276132,23377,309,275
752283278,752280251,752304892,24641,310,275
752312036,752309009,752332702,23693,311,275
752339890,752336862,752362794,25932,312,275
752370083,752366839,752390410,23571,313,275
752397592,752394564,752416021,21457,314,275
752423216,752420189,752442910,22721,315,275
752450198,752446955,752469893,22938,316,275
752477182,752474155,752498817,24662,317,275
752506105,752502862,752526455,23593,318,275
752533744,752530500,752554706,24206,319,275
752561996,752558968,752583633,24665,320,275
752590921,752587678,752612557,24879,321,275
752619740,752616713,752641038,24325,322,275
752648225,752645198,752667307,22109,323,275
752674433,752671406,752693833,22427,324,275
752701122,752698095,752724024,25929,325,275
752731312,752728069,752751662,23593,326,275
752758800,752755773,752781069,25296,327,275
752788358,752785114,752809656,24542,328,275
752816946,752813701,752838245,24544,329,275
752845406,752842378,752867677,25299,330,275
752874967,752871722,752895317,23595,331,275
752902457,752899429,752923122,23693,332,275
752930411,752927166,752952998,25832,333,275
752960284,752957257,752980631,23374,334,275
752987782,752984755,753008428,23673,335,275
753015717,753012473,753035094,22621,336,275
753042229,753039202,753060340,21138,337,275
753067629,753064385,753090532,26147,338,275
753097821,753094577,753116884,22307,339,275
753124032,753121006,753145647,24641,340,275
753152938,753149692,753172000,22308,341,275
753179289,753176045,753199617,23572,342,275
753206906,753203662,753226916,23254,343,275
753234094,753231066,753255711,24645,344,275
753262834,753259807,753281896,22089,345,275
753289185,753285941,753308564,22623,346,275
753315853,753312609,753338756,26147,347,275
753346045,753342801,753365761,22960,348,275
753373050,753369806,753394349,24543,349,275
753401637,753398394,753424539,26145,350,275
753431830,753428585,753453782,25197,351,275
753460932,753457904,753482230,24326,352,275
753489382,753486354,753511652,25298,353,275
753518826,753515798,753539809,24011,354,275
753546953,753543926,753568905,24979,355,275
753576049,753573022,753595111,22089,356,275
753602401,753599157,753622414,23257,357,275
753629553,753626526,753649247,22721,358,275
753656533,753653292,753675277,21985,359,275
753682566,753679322,753705132,25810,360,275
753712250,753709223,753732283,23060,361,275
753739474,753736446,753761744,25298,362,275
753769033,753765788,753790986,25198,363,275
753798276,753795031,753817655,22624,364,275
753824944,753821700,753845588,23888,365,275
753852876,753849633,753873856,24223,366,275
753881145,753877901,753899574,21673,367,275
753906864,753903619,753927510,23891,368,275
753934628,753931600,753954640,23040,369,275
753961802,753958775,753980863,22088,370,275
753988152,753984908,754007531,22623,371,275
754014679,754011651,754033108,21457,372,275
754040398,754037153,754061381,24228,373,275
754068575,754065547,754089852,24305,374,275
754097136,754094108,754118750,24642,375,275
754125872,754122845,754145588,22743,376,275
754152877,754149633,754172255,22622,377,275
754179417,754176390,754202636,26246,378,275
754209926,754206681,754229325,22644,379,275
754236614,754233370,754257258,23888,380,275
754264399,754261372,754286647,25275,381,275
754293840,754290813,754311952,21139,382,275
754319242,754315997,754338937,22940,383,275
754346227,754343199,754367525,24326,384,275
754374675,754371649,754395341,23692,385,275
754402630,754399603,754423276,23673,386,275
754430566,754427321,754453786,26465,387,275
754460857,754457831,754481739,23908,388,275
754488941,754485914,754509586,23672,389,275
754516736,754513707,754538688,24981,390,275
754545853,754542824,754564599,21775,391,275
754571888,754568644,754594474,25830,392,275
754601668,754598639,754622628,23989,393,275
754629918,754626673,754652841,26168,394,275
754660130,754656886,754680458,23572,395,275
754687749,754684503,754707782,23279,396,275
754715071,754711827,754734767,22940,397,275
754742055,754738812,754762089,23277,398,275
754769239,754766212,754788953,22741,399,275
754796148,754793121,754819051,25930,400,275
754826341,754823096,754845717,22621,401,275
754852845,754849818,754872540,22722,402,275
754879736,754876709,754899431,22722,403,275
754906549,754903521,754928164,24643,404,275
754935364,754932337,754954741,22404,405,275
754962032,754958786,754983331,24545,406,275
754990532,754987505,755011493,23988,407,275
755018782,755015538,755039110,23572,408,275
755046400,755043155,755066432,23277,409,275
755073721,755070694,755094049,23355,410,275
755101338,755098094,755122298,24204,411,275
755129440,755126412,755148185,21773,412,275
755155332,755152304,755177581,25277,413,275
755184869,755181626,755204586,22960,414,275
755211658,755208631,755233509,24878,415,275
755240797,755237554,755262729,25175,416,275
755269876,755266848,755293433,26585,417,275
755300722,755297478,755321388,23910,418,275
755328461,755325432,755350927,25495,419,275
755358216,755354972,755378227,23255,420,275
755385517,755382489,755405865,23376,421,275
755413154,755409910,755435401,25491,422,275
755442593,755439566,755462921,23355,423,275
755470210,755466966,755492797,25831,424,275
755500085,755496842,755521364,24522,425,275
755528653,755525408,755547736,22328,426,275
755555023,755551780,755576340,24560,427,275
755583630,755580385,755603958,23573,428,275
755611246,755608003,755633199,25196,429,275
755640392,755637365,755661373,24008,430,275
755668528,755665502,755689511,24009,431,275
755696584,755693556,755717466,23910,432,275
755724666,755721639,755744360,22721,433,275
755751519,755748492,755772163,23671,434,275
755779450,755776423,755800095,23672,435,275
755807225,755804198,755826940,22742,436,275
755834229,755830985,755853924,22939,437,275
755861212,755857969,755881562,23593,438,275
755888747,755885719,755907808,22089,439,275
755914976,755911949,755934670,22721,440,275
755941959,755938715,755965178,26463,441,275
755972355,755969328,755994942,25614,442,275
756002015,755998987,756022559,23572,443,275
756029683,756026655,756050981,24326,444,275
756058111,756055083,756080064,24981,445,275
756087263,756084234,756106663,22429,446,275
756113841,756110814,756135477,24663,447,275
756142629,756139602,756162007,22405,448,275
756169199,756166172,756190498,24326,449,275
756197787,756194543,756218114,23571,450,275
756225403,756222376,756245436,23060,451,275
756252558,756249531,756271957,22426,452,275
756279246,756276002,756298307,22305,453,275
756305380,756302352,756326557,24205,454,275
756333689,756330662,756354651,23989,455,275
756361940,756358696,756381657,22961,456,275
756388813,756385785,756409773,23988,457,275
756416901,756413873,756435330,21457,458,275
756442456,756439428,756461517,22089,459,275
756468805,756465562,756490737,25175,460,275
756497894,756494866,756520480,25614,461,275
756527769,756524525,756549068,24543,462,275
756556358,756553113,756579578,26465,463,275
756586755,756583727,756605501,21774,464,275
756612790,756609546,756635356,25810,465,275
756642640,756639401,756662335,22934,466,275
756669487,756666460,756688549,22089,467,275
756695838,756692594,756715215,22621,468,275
756722505,756719260,756742199,22939,469,275
756749489,756746244,756769184,22940,470,275
756776474,756773229,756796484,23255,471,275
756803771,756800529,756823803,23274,472,275
756830875,756827848,756848570,20722,473,275
756855860,756852615,756874921,22306,474,275
756882064,756879037,756902412,23375,475,275
756909702,756906674,756928763,22089,476,275
756936052,756932808,756958956,26148,477,275
756966244,756963001,756988831,25830,478,275
756995968,756992940,757016632,23692,479,275
757023775,757020747,757042521,21774,480,275
757049652,757046624,757071288,24664,481,275
757078571,757075544,757098582,23038,482,275
757105746,757102719,757125441,22722,483,275
757132730,757129486,757152426,22940,484,275
757159543,757156516,757178944,22428,485,275
757186082,757183054,757205145,22091,486,275
757212217,757209190,757232150,22960,487,275
757239439,757236195,757260738,24543,488,275
757268026,757264998,757286138,21140,489,275
757293427,757290183,757313754,23571,490,275
757321044,757317799,757340760,22961,491,275
757348051,757344805,757369032,24227,492,275
757376315,757373287,757399852,26565,493,275
757406989,757403961,757428604,24643,494,275
757435777,757432749,757459313,26564,495,275
757466436,757463409,757487713,24304,496,275
757494855,757491828,757518729,26901,497,275
757525872,757522844,757547508,24664,498,275
757554711,757551684,757574427,22743,499,275
757581561,757578534,757600940,22406,500,275
757608083,757605056,757630331,25275,501,275
757637480,757634453,757658144,23691,502,275
757665433,757662189,757686732,24543,503,275
757694023,757690777,757713085,22308,504,275
757720373,757717345,757740723,23378,505,275
757748012,757744768,757770597,25829,506,275
757777714,757774687,757800278,25591,507,275
757807471,757804443,757829425,24982,508,275
757836607,757833581,757857252,23671,509,275
757864539,757861296,757885522,24226,510,275
757892652,757889624,757913002,23378,511,275
757920292,757917046,757943195,26149,512,275
757950483,757947240,757970811,23571,513,275
757977998,757974971,757998643,23672,514,275
758005715,758002688,758024044,21356,515,275
758031192,758028166,758052174,24008,516,275
758059347,758056320,758079064,22744,517,275
758086239,758083212,758106904,23692,518,275
758114188,758110948,758133905,22957,519,275
758141070,758138043,758162368,24325,520,275
758169511,758166484,758190473,23989,521,275
758197760,758194733,758220346,25613,522,275
758227634,758224391,758247646,23255,523,275
758254768,758251741,758277017,25276,524,275
758284136,758281109,758305435,24326,525,275
758312722,758309694,758333388,23694,526,275
758340678,758337433,758360711,23278,527,275
758367841,758364814,758387220,22406,528,275
758394292,758391265,758414519,23254,529,275
758421806,758418564,758444372,25808,530,275
758451661,758448417,758471990,23573,531,275
758479190,758476164,758501121,24957,532,275
758508268,758505240,758527646,22406,533,275
758534935,758531691,758554967,23276,534,275
758562252,758559012,758583868,24856,535,275
758591019,758587992,758611979,23987,536,275
758619267,758616024,758638011,21987,537,275
758645302,758642056,758664363,22307,538,275
758671652,758668408,758690397,21989,539,275
758697590,758694563,758718256,23693,540,275
758725409,758722382,758744490,22108,541,275
758751644,758748616,758773259,24643,542,275
758780548,758777304,758800265,22961,543,275
758807432,758804405,758829385,24980,544,275
758836675,758833430,758858924,25494,545,275
758866073,758863046,758887371,24325,546,275
758894660,758891416,758915324,23908,547,275
758922468,758919439,758943113,23674,548,275
758950401,758947158,758971066,23908,549,275
758978196,758975168,758999496,24328,550,275
759006618,759003590,759025364,21774,551,275
759032507,759029480,759052856,23376,552,275
759060016,759056989,759080997,24008,553,275
759088286,759085042,759111843,26801,554,275
759119134,759115889,759138195,22306,555,275
759145484,759142240,759163911,21671,556,275
759171040,759168013,759189786,21773,557,275
759196929,759193902,759218545,24643,558,275
759225834,759222590,759243946,21356,559,275
759251125,759248097,759270502,22405,560,275
759277665,759274639,759298014,23375,561,275
759305300,759302059,759324045,21986,562,275
759331209,759328181,759352508,24327,563,275
759359798,759356553,759380147,23594,564,275
759387288,759384261,759408565,24304,565,275
759415756,759412729,759434185,21456,566,275
759441475,759438447,759460852,22405,567,275
759468141,759464897,759489440,24543,568,275
759496729,759493485,759518661,25176,569,275
759525950,759522706,759547566,24860,570,275
759554855,759551611,759575521,23910,571,275
759582810,759579566,759602503,22937,572,275
759609793,759606548,759627906,21358,573,275
759635088,759632062,759655732,23670,574,275
759663022,759659777,759683034,23257,575,275
759690232,759687204,759709295,22091,576,275
759716490,759713462,759737472,24010,577,275
759744761,759741517,759764794,23277,578,275
759771938,759768911,759793552,24641,579,275
759800707,759797679,759821373,23694,580,275
759828661,759825418,759849623,24205,581,275
759856912,759853668,759878528,24860,582,275
759885707,759882680,759906710,24030,583,275
759913841,759910814,759935477,24663,584,275
759942636,759939610,759960431,20821,585,275
759967579,759964551,759986957,22406,586,275
759994122,759991095,760013818,22723,587,275
760020979,760017953,760042616,24663,588,275
760049742,760046714,760070725,24011,589,275
760077888,760074861,760096949,22088,590,275
760104072,760101045,760125031,23986,591,275
760132163,760129136,760154074,24938,592,275
760161219,760158193,760181864,23671,593,275
760189154,760185909,760208870,22961,594,275
760216159,760212915,760236170,23255,595,275
760243300,760240273,760265548,25275,596,275
760272837,760269593,760292868,23275,597,275
760300157,760296913,760320486,23573,598,275
760327776,760324531,760347491,22960,599,275
760354779,760351535,760373206,21671,600,275
760380490,760377462,760401790,24328,601,275
760409079,760405835,760427822,21987,602,275
760435105,760432078,760455770,23692,603,275
760462962,760459935,760482656,22721,604,275
760489946,760486701,760512512,25811,605,275
760519801,760516557,760540465,23908,606,275
760547754,760544510,760568103,23593,607,275
760575392,760572148,760598632,26484,608,275
760605825,760602798,760625837,23039,609,275
760633126,760629882,760655058,25176,610,275
760662347,760659103,760683963,24860,611,275
760691253,760688008,760713206,25198,612,275
760720495,760717251,760740505,23254,613,275
760747794,760744550,760767173,22623,614,275
760774310,760771283,760793687,22404,615,275
760800977,760797732,760820987,23255,616,275
760828276,760825032,760849257,24225,617,275
760856329,760853302,760878181,24879,618,275
760885470,760882226,760908056,25830,619,275
760915185,760912159,760933615,21456,620,275
760940800,760937774,760961126,23352,621,275
760968317,760965289,760989616,24327,622,275
760996778,760993751,761017759,24008,623,275
761025047,761021804,761045057,23253,624,275
761052346,761049319,761072694,23375,625,275
761079981,761076955,761099360,22405,626,275
761106648,761103405,761125076,21671,627,275
761132256,761129230,761153238,24008,628,275
761160362,761157335,761181028,23693,629,275
761188317,761185073,761207695,22622,630,275
761214982,761211740,761236279,24539,631,275
761243568,761240324,761263602,23278,632,275
761270891,761267647,761289953,22306,633,275
761297122,761294095,761316501,22406,634,275
761323790,761320546,761344119,23573,635,275
761351408,761348164,761370785,22621,636,275
761377969,761374942,761398951,24009,637,275
761406240,761402996,761427222,24226,638,275
761434510,761431267,761457730,26463,639,275
761465021,761461775,761483133,21358,640,275
761490423,761487178,761512038,24860,641,275
761519178,761516152,761536973,20821,642,275
761544111,761541084,761564757,23673,643,275
761572044,761568802,761593660,24858,644,275
761600948,761597705,761623850,26145,645,275
761630996,761627968,761651978,24010,646,275
761659121,761656094,761679787,23693,647,275
761686940,761683912,761707606,23694,648,275
761714895,761711651,761734274,22623,649,275
761741564,761738319,761763812,25493,650,275
761770963,761767936,761789391,21455,651,275
761796580,761793553,761816593,23040,652,275
761823882,761820638,761845836,25198,653,275
761853125,761849881,761874425,24544,654,275
761881590,761878563,761900650,22087,655,275
761907804,761904776,761928785,24009,656,275
761935910,761932882,761953389,20507,657,275
761960677,761957433,761978790,21357,658,275
761986079,761982835,762006427,23592,659,275
762013625,762010597,762034607,24010,660,275
762041895,762038651,762064798,26147,661,275
762072086,762068843,762091484,22641,662,275
762098646,762095620,762117392,21772,663,275
762124568,762121540,762145551,24011,664,275
762152841,762149596,762173191,23595,665,275
762180480,762177236,762202412,25176,666,275
762209583,762206556,762229615,23059,667,275
762236903,762233660,762257548,23888,668,275
762264740,762261712,762285066,23354,669,275
762292355,762289111,762314604,25493,670,275
762321894,762318649,762341294,22645,671,275
762348584,762345339,762368278,22939,672,275
762375467,762372438,762397736,25298,673,275
762404935,762401907,762425283,23376,674,275
762432354,762429327,762455157,25830,675,275
762462446,762459203,762481825,22622,676,275
762489114,762485870,762512016,26146,677,275
762519192,762516164,762537622,21458,678,275
762544774,762541747,762567360,25613,679,275
762574561,762571533,762595204,23671,680,275
762602394,762599366,762622089,22723,681,275
762629379,762626134,762647492,21358,682,275
762654781,762651537,762674498,22961,683,275
762681787,762678543,762703720,25177,684,275
762710897,762707869,762730928,23059,685,275
762738217,762735189,762760804,25615,686,275
762767995,762764969,762787394,22425,687,275
762794551,762791524,762814247,22723,688,275
762821410,762818383,762839521,21138,689,275
762846593,762843566,762866820,23254,690,275
762874104,762870865,762897007,26142,691,275
762904297,762901052,762925934,24882,692,275
762933223,762929979,762956126,26147,693,275
762963290,762960263,762982668,22405,694,275
762989858,762986831,763010208,23377,695,275
763017337,763014310,763038636,24326,696,275
763045924,763042681,763067223,24542,697,275
763074510,763071268,763096146,24878,698,275
763103265,763100237,763124585,24348,699,275
763131765,763128738,763153381,24643,700,275
763160453,763157426,763179099,21673,701,275
763186387,763183144,763206735,23591,702,275
763213879,763210852,763232941,22089,703,275
763240079,763237051,763260406,23355,704,275
763267694,763264451,763289942,25491,705,275
763297084,763294057,763319671,25614,706,275
763326816,763323789,763347165,23376,707,275
763354316,763351289,763374031,22742,708,275
763381319,763378076,763401014,22938,709,275
763408173,763405146,763428501,23355,710,275
763435646,763432618,763457917,25299,711,275
763465206,763462179,763485871,23692,712,275
763493160,763489916,763515429,25513,713,275
763522719,763519474,763543383,23909,714,275
763550515,763547488,763571813,24325,715,275
763579102,763575858,763599136,23278,716,275
763606321,763603294,763626015,22721,717,275
763633302,763630059,763653016,22957,718,275
763660156,763657129,763680505,23376,719,275
763687706,763684679,763707717,23038,720,275
763715006,763711762,763734068,22306,721,275
763741357,763738113,763762974,24861,722,275
763770108,763767081,763788853,21772,723,275
763796008,763792981,763815723,22742,724,275
763822874,763819847,763843223,23376,725,275
763850345,763847318,763872277,24959,726,275
763879403,763876376,763900702,24326,727,275
763907991,763904747,763930261,25514,728,275
763937334,763934306,763959188,24882,729,275
763966322,763963294,763987642,24348,730,275
763994800,763991773,764013862,22089,731,275
764021151,764017907,764040234,22327,732,275
764047362,764044335,764069631,25296,733,275
764076920,764073893,764096637,22744,734,275
764103793,764100766,764125091,24325,735,275
764132224,764129197,764151285,22088,736,275
764158573,764155330,764178583,23253,737,275
764185872,764182628,764206221,23593,738,275
764213384,764210358,764235316,24958,739,275
764242607,764239578,764262935,23357,740,275
764270224,764266980,764290572,23592,741,275
764297727,764294700,764318392,23692,742,275
764325576,764322548,764346242,23694,743,275
764353372,764350345,764373405,23060,744,275
764380694,764377450,764400410,22960,745,275
764407579,764404552,764429172,24620,746,275
764436373,764433346,764454167,20821,747,275
764461321,764458294,764480700,22406,748,275
764487817,764484789,764509094,24305,749,275
764516248,764513219,764536577,23358,750,275
764543867,764540622,764565505,24883,751,275
764572705,764569678,764592717,23039,752,275
764599791,764596762,764621961,25199,753,275
764629249,764626006,764650231,24225,754,275
764657369,764654341,764676768,22427,755,275
764684057,764680813,764702802,21989,756,275
764710092,764706847,764728204,21357,757,275
764735492,764732249,764757740,25491,758,275
764765028,764761785,764785357,23572,759,275
764792648,764789402,764813630,24228,760,275
764820920,764817675,764840930,23255,761,275
764848218,764845192,764870171,24979,762,275
764877460,764874216,764897154,22938,763,275
764904443,764901199,764922240,21041,764,275
764929372,764926344,764947484,21140,765,275
764954641,764951615,764976574,24959,766,275
764983863,764980835,765002291,21456,767,275
765009476,765006449,765030120,23671,768,275
765037409,765034165,765057758,23593,769,275
765064902,765061874,765085883,24009,770,275
765093016,765089988,765111445,21457,771,275
765118733,765115707,765139717,24010,772,275
765146871,765143843,765167221,23378,773,275
765174340,765171313,765194352,23039,774,275
765201640,765198397,765221672,23275,775,275
765228829,765225803,765249811,24008,776,275
765256952,765253924,765279201,25277,777,275
765286394,765283366,765304824,21458,778,275
765312113,765308869,765331806,22937,779,275
765339096,765335851,765358813,22962,780,275
765366102,765362858,765389005,26147,781,275
765396159,765393131,765416825,23694,782,275
765423991,765420963,765444338,23375,783,275
765451627,765448383,765470371,21988,784,275
765477660,765474416,765496406,21990,785,275
765503595,765500568,765525211,24643,786,275
765532341,765529314,765554927,25613,787,275
765562215,765559187,765581910,22723,788,275
765589199,765585955,765608599,22644,789,275
765615888,765612644,765635266,22622,790,275
765642421,765639394,765663086,23692,791,275
765670376,765667131,765692941,25810,792,275
765700066,765697039,765719760,22721,793,275
765726956,765723928,765746334,22406,794,275
765753470,765750444,765771266,20822,795,275
765778409,765775381,765799054,23673,796,275
765806196,765803167,765827493,24326,797,275
765834678,765831651,765855026,23375,798,275
765862216,765859189,765883219,24030,799,275
765890509,765887481,765910543,23062,800,275
765917832,765914805,765939785,24980,801,275
765947074,765943830,765969321,25491,802,275
765976440,765973413,765997758,24345,803,275
766005047,766001803,766026325,24522,804,275
766033614,766030370,766053310,22940,805,275
766060512,766057485,766081812,24327,806,275
766089101,766085856,766110084,24228,807,275
766117210,766114183,766136589,22406,808,275
766143878,766140634,766163257,22623,809,275
766170394,766167367,766192304,24937,810,275
766199593,766196349,766219922,23573,811,275
766227212,766223967,766248828,24861,812,275
766256118,766252873,766276783,23910,813,275
766283920,766280893,766304902,24009,814,275
766312190,766308947,766331884,22937,815,275
766339172,766335929,766360153,24224,816,275
766367317,766364291,766387983,23692,817,275
766395271,766392028,766416570,24542,818,275
766423859,766420615,766444504,23889,819,275
766451695,766448667,766470440,21773,820,275
766477596,766474569,766499212,24643,821,275
766506352,766503325,766526384,23059,822,275
766533514,766530485,766554814,24329,823,275
766562100,766559073,766583378,24305,824,275
766590667,766587640,766610679,23039,825,275
766617967,766614724,766640216,25492,826,275
766647503,766644261,766668169,23908,827,275
766675328,766672299,766693124,20825,828,275
766700413,766697169,766720446,23277,829,275
766727638,766724610,766748281,23671,830,275
766755472,766752446,766774851,22405,831,275
766781994,766778966,766803610,24644,832,275
766810900,766807655,766832198,24543,833,275
766839330,766836303,766860290,23987,834,275
766867463,766864436,766887158,22722,835,275
766894322,766891295,766915958,24663,836,275
766923111,766920083,766944728,24645,837,275
766952017,766948773,766971416,22643,838,275
766978559,766975533,766999858,24325,839,275
767007147,767003903,767029100,25197,840,275
767036252,767033226,767056897,23671,841,275
767064028,767061001,767086277,25276,842,275
767093567,767090322,767116152,25830,843,275
767123442,767120198,767143476,23278,844,275
767150765,767147521,767171431,23910,845,275
767178720,767175476,767197149,21673,846,275
767204292,767201265,767225275,24010,847,275
767232441,767229412,767254392,24980,848,275
767261517,767258491,767281234,22743,849,275
767288393,767285366,767311928,26562,850,275
767319217,767315974,767337646,21672,851,275
767344805,767341777,767365788,24011,852,275
767372958,767369930,767392020,22090,853,275
767399309,767396065,767418372,22307,854,275
767425661,767422417,767446980,24563,855,275
767454270,767451242,767476202,24960,856,275
767483274,767480247,767505559,25312,857,275
767512746,767509719,767533074,23355,858,275
767540213,767537185,767558325,21140,859,275
767565614,767562587,767587566,24979,860,275
767594855,767591611,767617103,25492,861,275
767624296,767621268,767642724,21456,862,275
767649891,767646863,767667370,20507,863,275
767674658,767671415,767695957,24542,864,275
767703247,767700219,767721358,21139,865,275
767728646,767725403,767748024,22621,866,275
767755311,767752069,767777262,25193,867,275
767784450,767781423,767805750,24327,868,275
767813039,767809795,767834000,24205,869,275
767841162,767838134,767863094,24960,870,275
767870235,767867207,767889614,22407,871,275
767896793,767893764,767916488,22724,872,275
767923777,767920533,767944104,23571,873,275
767951267,767948239,767971933,23694,874,275
767979222,767975978,768001808,25830,875,275
768009097,768005853,768030078,24225,876,275
768037217,768034189,768055644,21455,877,275
768062934,768059689,768083600,23911,878,275
768090757,768087730,768108553,20823,879,275
768115842,768112597,768136486,23889,880,275
768143775,768140530,768165074,24544,881,275
768172362,768169118,768192709,23591,882,275
768199998,768196753,768220347,23594,883,275
768227515,768224488,768246893,22405,884,275
768254042,768251015,768275655,24640,885,275
768282836,768279808,768304472,24664,886,275
768311761,768308517,768330190,21673,887,275
768337347,768334321,768355141,20820,888,275
768362429,768359185,768382143,22958,889,275
768389432,768386188,768408177,21989,890,275
768415465,768412222,768437079,24857,891,275
768444223,768441195,768463918,22723,892,275
768471076,768468048,768491088,23040,893,275
768498377,768495133,768518704,23571,894,275
768525993,768522749,768546974,24225,895,275
768554122,768551094,768573183,22089,896,275
768580345,768577318,768600672,23354,897,275
768607821,768604793,768628487,23694,898,275
768635637,768632609,768658856,26247,899,275
768666145,768662901,768688056,25155,900,275
768695344,768692101,768715672,23571,901,275
768722790,768719764,768743117,23353,902,275
768750269,768747242,768769331,22089,903,275
768776620,768773376,768795365,21989,904,275
768802654,768799627,768826211,26584,905,275
768833499,768830256,768853191,22935,906,275
768860348,768857319,768883588,26269,907,275
768890723,768887696,768912993,25297,908,275
768920151,768917123,768942084,24961,909,275
768949373,768946345,768970038,23693,910,275
768977328,768974083,768998944,24861,911,275
769006133,769003107,769025828,22721,912,275
769033117,769029873,769051863,21990,913,275
769059031,769056004,769082588,26584,914,275
769089878,769086633,769113119,26486,915,275
769120273,769117245,769139651,22406,916,275
769146833,769143805,769167161,23356,917,275
769174300,769171272,769193045,21773,918,275
769200242,769197215,769221223,24008,919,275
769228421,769225394,769249721,24327,920,275
769257010,769253766,769275121,21355,921,275
769282411,769279166,769303392,24226,922,275
769310681,769307437,769331978,24541,923,275
769339102,769336075,769358481,22406,924,275
769365770,769362525,769390678,28153,925,275
769397969,769394724,769419902,25178,926,275
769427038,769424011,769449285,25274,927,275
769456574,769453330,769478525,25195,928,275
769485722,769482692,769506704,24012,929,275
769513990,769510749,769535290,24541,930,275
769542486,769539459,769563469,24010,931,275
769570758,769567514,769592036,24522,932,275
769599326,769596081,769619020,22939,933,275
769626208,769623181,769645607,22426,934,275
769652895,769649651,769674195,24544,935,275
769681376,769678349,769700754,22405,936,275
769708043,769704799,769728075,23276,937,275
769735365,769732120,769758584,26464,938,275
769765731,769762703,769786058,23355,939,275
769793347,769790103,769814666,24563,940,275
769821846,769818819,769843145,24326,941,275
769850296,769847269,769870644,23375,942,275
769877812,769874785,769897190,22405,943,275
769904479,769901234,769922275,21041,944,275
769929394,769926367,769950692,24325,945,275
769957979,769954952,769978624,23672,946,275
769985913,769982669,770005291,22622,947,275
770012435,770009409,770030864,21455,948,275
770038033,770035006,770058044,23038,949,275
770065202,770062174,770087451,25277,950,275
770094523,770091495,770115406,23911,951,275
770122547,770119519,770142896,23377,952,275
770150185,770146941,770172139,25198,953,275
770179274,770176246,770201543,25297,954,275
770208832,770205588,770228526,22938,955,275
770235815,770232571,770256461,23890,956,275
770263750,770260723,770285998,25275,957,275
770293134,770290107,770315700,25593,958,275
770322830,770319802,770344446,24644,959,275
770351644,770348617,770373577,24960,960,275
770380866,770377622,770402185,24563,961,275
770409329,770406301,770427757,21456,962,275
770435045,770431802,770456048,24246,963,275
770463337,770460093,770483349,23256,964,275
770490638,770487394,770512254,24860,965,275
770519375,770516349,770538142,21793,966,275
770545279,770542252,770564022,21770,967,275
770571311,770568066,770590054,21988,968,275
770597344,770594099,770618010,23911,969,275
770625299,770622055,770645331,23276,970,275
770652619,770649376,770671681,22305,971,275
770678968,770675940,770701238,25298,972,275
770708391,770705364,770728421,23057,973,275
770735574,770732546,770756241,23695,974,275
770763385,770760358,770780865,20507,975,275
770788155,770784910,770809768,24858,976,275
770817055,770813812,770839641,25829,977,275
770846830,770843803,770867496,23693,978,275
770874784,770871540,770896399,24859,979,275
770903551,770900523,770922950,22427,980,275
770930240,770926995,770950905,23910,981,275
770958039,770955013,770977733,22720,982,275
770984910,770981884,771007159,25275,983,275
771014310,771011282,771034322,23040,984,275
771041473,771038446,771061485,23039,985,275
771068772,771065746,771088467,22721,986,275
771095597,771092570,771117846,25276,987,275
771125003,771121976,771144064,22088,988,275
771151229,771148202,771172211,24009,989,275
771179499,771176256,771196661,20405,990,275
771203832,771200804,771224815,24011,991,275
771231886,771228860,771254371,25511,992,275
771261660,771258416,771281037,22621,993,275
771288324,771285081,771311226,26145,994,275
771318515,771315271,771340128,24857,995,275
771347413,771344386,771367761,23375,996,275
771375049,771371805,771394427,22622,997,275
771401716,771398472,771423965,25493,998,275
771431254,771428010,771452553,24543,999,275
771459842,771456598,771482745,26147,1000,275
771490025,771486997,771511661,24664,1001,275
771519039,771515794,771538439,22645,1002,275
771545818,771542573,771569308,26735,1003,275
771576567,771573539,771605000,31461,1004,275
771612378,771609134,771633993,24859,1005,275
771641286,771638259,771663554,25295,1006,275
771670932,771667688,771690310,22622,1007,275
771697563,771694535,771717279,22744,1008,275
771724656,771721412,771746608,25196,1009,275
771753985,771750741,771773998,23257,1010,275
771781374,771778131,771800120,21989,1011,275
771807385,771804358,771829971,25613,1012,275
771837132,771834105,771858669,24564,1013,275
771865926,771862899,771886906,24007,1014,275
771894122,771891095,771915420,24325,1015,275
771922797,771919554,771943461,23907,1016,275
771950840,771947595,771970873,23278,1017,275
771978251,771975006,771999213,24207,1018,275
772006515,772003488,772028468,24980,1019,275
772035684,772032656,772053478,20822,1020,275
772060723,772057695,772082654,24959,1021,275
772090031,772086787,772110380,23593,1022,275
772117670,772114643,772136732,22089,1023,275
772144019,772140992,772164682,23690,1024,275
772171917,772168891,772192898,24007,1025,275
772200164,772197135,772219858,22723,1026,275
772227160,772224133,772246854,22721,1027,275
772254063,772251036,772274411,23375,1028,275
772281644,772278616,772304546,25930,1029,275
772311778,772308751,772330524,21773,1030,275
772337794,772334767,772361351,26584,1031,275
772368635,772365608,772387064,21456,1032,275
772394442,772391198,772415739,24541,1033,275
772422997,772419969,772454720,34751,1034,275
772461973,772458946,772485509,26563,1035,275
772492751,772489723,772514704,24981,1036,275
772522081,772518838,772543381,24543,1037,275
772550667,772547639,772571967,24328,1038,275
772579268,772576241,772601199,24958,1039,275
772608505,772605477,772629171,23694,1040,275
772636432,772633406,772658681,25275,1041,275
772665921,772662894,772686565,23671,1042,275
772693791,772690762,772716694,25932,1043,275
772723925,772720897,772744254,23357,1044,275
772751524,772748498,772771536,23038,1045,275
772778792,772775764,772800092,24328,1046,275
772807308,772804279,772829240,24961,1047,275
772836461,772833434,772855205,21771,1048,275
772862366,772859339,772884197,24858,1049,275
772891442,772888414,772910505,22091,1050,275
772917883,772914639,772938233,23594,1051,275
772945514,772942487,772969388,26901,1052,275
772976633,772973606,772996646,23040,1053,275
773004024,773000780,773024036,23256,1054,275
773031309,773028282,773052587,24305,1055,275
773059852,773056825,773077649,20824,1056,275
773084885,773081858,773106478,24620,1057,275
773113767,773110740,773132512,21772,1058,275
773139891,773136646,773161506,24860,1059,275
773168748,773165720,773188464,22744,1060,275
773195753,773192725,773218022,25297,1061,275
773225305,773222277,773247890,25613,1062,275
773255269,773252025,773276251,24226,1063,275
773283630,773280385,773304613,24228,1064,275
773311899,773308872,773333832,24960,1065,275
773341078,773338051,773360773,22722,1066,275
773368150,773364906,773388795,23889,1067,275
773396046,773393019,773415425,22406,1068,275
773422730,773419702,773444345,24643,1069,275
773451554,773448526,773469351,20825,1070,275
773476728,773473484,773498027,24543,1071,275
773505404,773502160,773525754,23594,1072,275
773533132,773529888,773552826,22938,1073,275
773560105,773557078,773581066,23988,1074,275
773588296,773585269,773608623,23354,1075,275
773616002,773612757,773635697,22940,1076,275
773643073,773639830,773662789,22959,1077,275
773670041,773667014,773691974,24960,1078,275
773699351,773696107,773718750,22643,1079,275
773726127,773722883,773746477,23594,1080,275
773753762,773750736,773774109,23373,1081,275
773781412,773778384,773804631,26247,1082,275
773811874,773808846,773833174,24328,1083,275
773840550,773837307,773861533,24226,1084,275
773868811,773865784,773888842,23058,1085,275
773896103,773893076,773914847,21771,1086,275
773922063,773919036,773942729,23693,1087,275
773950017,773946990,773970049,23059,1088,275
773977427,773974183,773998747,24564,1089,275
774006126,774002881,774025504,22623,1090,275
774032881,774029637,774054519,24882,1091,275
774061764,774058736,774081458,22722,1092,275
774088740,774085712,774110672,24960,1093,275
774117975,774114948,774137986,23038,1094,275
774145364,774142120,774166999,24879,1095,275
774174219,774171192,774193597,22405,1096,275
774200850,774197823,774218329,20506,1097,275
774225706,774222462,774246686,24224,1098,275
774253960,774250932,774272387,21455,1099,275
774279660,774276633,774299692,23059,1100,275
774306951,774303924,774326963,23039,1101,275
774334343,774331097,774355642,24545,1102,275
774362874,774359846,774384173,24327,1103,275
774391550,774388306,774411581,23275,1104,275
774418806,774415780,774438498,22718,1105,275
774445876,774442631,774467176,24545,1106,275
774474555,774471310,774495221,23911,1107,275
774502505,774499478,774525429,25951,1108,275
774532808,774529563,774554107,24544,1109,275
774561484,774558240,774580546,22306,1110,275
774587851,774584823,774607544,22721,1111,275
774614777,774611749,774633839,22090,1112,275
774641000,774637973,774661229,23256,1113,275
774668607,774665362,774689589,24227,1114,275
774696749,774693723,774717632,23909,1115,275
774724862,774721835,774743924,22089,1116,275
774751142,774748115,774769887,21772,1117,275
774777140,774774113,774796540,22427,1118,275
774803795,774800768,774825727,24959,1119,275
774833105,774829861,774854087,24226,1120,275
774861385,774858358,774884288,25930,1121,275
774891533,774888505,774912516,24011,1122,275
774919747,774916720,774939441,22721,1123,275
774946818,774943574,774964930,21356,1124,275
774972308,774969064,774994260,25196,1125,275
775001537,774998509,775022519,24010,1126,275
775029773,775026745,775048201,21456,1127,275
775055442,775052414,775077375,24961,1128,275
775084623,775081597,775107209,25612,1129,275
775114587,775111343,775134915,23572,1130,275
775142201,775139173,775162233,23060,1131,275
775169458,775166431,775188519,22088,1132,275
775195745,775192718,775217698,24980,1133,275
775225076,775221832,775244453,22621,1134,275
775251829,775248586,775270574,21988,1135,275
775277952,775274708,775298618,23910,1136,275
775305840,775302813,775325535,22722,1137,275
775332827,775329800,775353176,23376,1138,275
775360394,775357367,775380743,23376,1139,275
775388122,775384877,775408451,23574,1140,275
775415830,775412585,775436494,23909,1141,275
775443741,775440714,775465335,24621,1142,275
775472579,775469551,775494193,24642,1143,275
775501572,775498327,775523208,24881,1144,275
775530507,775527480,775551174,23694,1145,275
775558554,775555308,775579514,24206,1146,275
775586891,775583648,775607873,24225,1147,275
775615109,775612081,775633538,21457,1148,275
775640777,775637750,775660472,22722,1149,275
775667851,775664606,775689466,24860,1150,275
775696750,775693723,775716126,22403,1151,275
775723504,775720259,775746070,25811,1152,275
775753309,775750281,775774924,24643,1153,275
775782304,775779058,775802000,22942,1154,275
775809277,775806250,775829626,23376,1155,275
775836891,775833864,775858188,24324,1156,275
775865429,775862402,775886729,24327,1157,275
775894017,775890991,775914976,23985,1158,275
775922137,775919110,775943991,24881,1159,275
775951369,775948125,775972668,24543,1160,275
775980046,775976801,776000056,23255,1161,275
776007433,776004189,776027783,23594,1162,275
776035000,776031973,776052796,20823,1163,275
776060174,776056930,776079550,22620,1164,275
776086767,776083739,776105197,21458,1165,275
776112402,776109375,776133679,24304,1166,275
776140897,776137870,776162195,24325,1167,275
776169478,776166451,776190797,24346,1168,275
776198031,776195005,776218696,23691,1169,275
776225973,776222944,776246618,23674,1170,275
776253824,776250797,776274786,23989,1171,275
776282012,776278984,776301391,22407,1172,275
776308675,776305647,776329657,24010,1173,275
776336908,776333880,776357575,23695,1174,275
776364793,776361766,776387041,25275,1175,275
776394249,776391222,776415231,24009,1176,275
776422529,776419502,776441907,22405,1177,275
776449147,776446119,776468208,22089,1178,275
776475426,776472398,776497359,24961,1179,275
776504736,776501493,776527322,25829,1180,275
776534583,776531556,776553328,21772,1181,275
776560607,776557579,776582560,24981,1182,275
776589873,776586845,776611806,24961,1183,275
776619096,776616068,776640415,24347,1184,275
776647792,776644548,776670378,25830,1185,275
776677757,776674512,776697135,22623,1186,275
776704415,776701388,776724110,22722,1187,275
776731272,776728244,776750234,21990,1188,275
776757520,776754492,776778502,24010,1189,275
776785881,776782636,776804625,21989,1190,275
776811860,776808832,776833476,24644,1191,275
776840853,776837609,776861202,23593,1192,275
776868451,776865424,776889433,24009,1193,275
776896667,776893639,776916678,23039,1194,275
776924056,776920812,776942166,21354,1195,275
776949545,776946300,776972764,26464,1196,275
776980041,776977014,777000708,23694,1197,275
777008015,777004988,777030284,25296,1198,275
777037496,777034469,777057845,23376,1199,275
777065123,777062097,777086718,24621,1200,275
777094097,777090852,777113158,22306,1201,275
777120449,777117422,777141430,24008,1202,275
777148722,777145694,777168756,23062,1203,275
777176134,777172890,777195193,22303,1204,275
777202570,777199327,777222285,22958,1205,275
777229664,777226419,777249991,23572,1206,275
777257368,777254124,777276428,22304,1207,275
777283645,777280618,777303361,22743,1208,275
777310738,777307494,777333325,25831,1209,275
777340568,777337542,777362162,24620,1210,275
777369389,777366361,777390392,24031,1211,275
777397654,777394627,777417032,22405,1212,275
777424410,777421166,777447629,26463,1213,275
777454879,777451853,777476177,24324,1214,275
777483458,777480430,777504123,23693,1215,275
777511501,777508257,777531849,23592,1216,275
777539227,777535983,777558920,22937,1217,275
777566081,777563054,777585993,22939,1218,275
777593221,777590193,777612917,22724,1219,275
777620218,777617191,777641833,24642,1220,275
777649211,777645967,777668928,22961,1221,275
777676216,777673188,777695278,22090,1222,275
777702657,777699412,777723956,24544,1223,275
777731171,777728144,777753102,24958,1224,275
777760383,777757356,777779762,22406,1225,275
777787140,777783896,777808776,24880,1226,275
777816018,777812991,777836978,23987,1227,275
777844267,777841239,777864931,23692,1228,275
777872228,777869201,777893526,24325,1229,275
777900904,777897660,777923807,26147,1230,275
777930969,777927941,777954426,26485,1231,275
777961806,777958560,777980867,22307,1232,275
777988134,777985106,778008463,23357,1233,275
778015736,778012709,778036402,23693,1234,275
778043698,778040671,778065016,24345,1235,275
778072393,778069150,778092721,23571,1236,275
778099947,778096920,778120591,23671,1237,275
778127886,778124858,778147920,23062,1238,275
778155131,778152103,778172926,20823,1239,275
778180136,778177108,778198249,21141,1240,275
778205551,778202524,778224296,21772,1241,275
778231582,778228555,778249694,21139,1242,275
778256907,778253880,778274703,20823,1243,275
778282080,778278836,778300193,21357,1244,275
778307440,778304413,778329352,24939,1245,275
778336729,778333485,778356740,23255,1246,275
778364118,778360874,778385121,24247,1247,275
778392499,778389255,778413164,23909,1248,275
778420415,778417388,778441058,23670,1249,275
778448351,778445325,778469651,24326,1250,275
778476880,778473853,778496575,22722,1251,275
778503953,778500708,778522382,21674,1252,275
778529646,778526619,778551578,24959,1253,275
778558795,778555768,778580726,24958,1254,275
778587952,778584925,778607646,22721,1255,275
778614907,778611879,778636544,24665,1256,275
778643778,778640751,778664127,23376,1257,275
778671438,778668409,778690184,21775,1258,275
778697562,778694318,778718227,23909,1259,275
778725435,778722408,778746734,24326,1260,275
778754110,778750867,778774776,23909,1261,275
778782046,778779018,778802712,23694,1262,275
778810090,778806846,778830101,23255,1263,275
778837478,778834234,778857804,23570,1264,275
778865064,778862038,778885730,23692,1265,275
778893022,778889996,778913687,23691,1266,275
778921065,778917821,778943630,25809,1267,275
778950896,778947867,778970275,22408,1268,275
778977503,778974476,778997199,22723,1269,275
779004430,779001403,779024780,23377,1270,275
779032066,779029038,779052099,23061,1271,275
779059477,779056233,779079826,23593,1272,275
779087059,779084033,779108019,23986,1273,275
779115271,779112244,779133066,20822,1274,275
779140444,779137199,779160792,23593,1275,275
779168087,779165060,779189070,24010,1276,275
779196277,779193250,779215992,22742,1277,275
779223285,779220258,779244921,24663,1278,275
779252154,779249127,779274403,25276,1279,275
779281682,779278655,779302348,23693,1280,275
779309637,779306609,779330937,24328,1281,275
779338230,779335203,779358262,23059,1282,275
779365640,779362396,779387572,25176,1283,275
779394798,779391771,779414175,22404,1284,275
779421462,779418435,779444027,25592,1285,275
779451333,779448305,779470396,22091,1286,275
779477774,779474530,779498439,23909,1287,275
779505817,779502573,779525532,22959,1288,275
779532910,779529666,779554524,24858,1289,275
779561828,779558801,779583781,24980,1290,275
779591160,779587914,779611804,23890,1291,275
779619182,779615937,779640164,24227,1292,275
779647544,779644298,779668843,24545,1293,275
779676221,779672976,779695621,22645,1294,275
779702887,779699860,779723533,23673,1295,275
779730911,779727666,779751577,23911,1296,275
779758801,779755774,779777863,22089,1297,275
779785241,779781997,779804303,22306,1298,275
779811463,779808436,779831692,23256,1299,275
779839071,779835826,779861953,26127,1300,275
779869239,779866212,779888935,22723,1301,275
779896314,779893069,779914426,21357,1302,275
779921708,779918681,779943662,24981,1303,275
779950916,779947890,779972827,24937,1304,275
779980069,779977040,779999744,22704,1305,275
780007122,780003878,780026839,22961,1306,275
780034217,780030973,780055200,24227,1307,275
780062580,780059334,780082592,23258,1308,275
780089860,780086833,780110209,23376,1309,275
780117456,780114428,780138415,23987,1310,275
780145659,780142632,780165375,22743,1311,275
780172621,780169592,780195524,25932,1312,275
780202737,780199710,780221165,21455,1313,275
780228378,780225351,780248388,23037,1314,275
780255766,780252522,780275144,22622,1315,275
780282522,780279278,780301583,22305,1316,275
780308862,780305835,780327605,21770,1317,275
780334982,780331738,780355626,23888,1318,275
780362787,780359759,780383964,24205,1319,275
780391208,780388180,780410270,22090,1320,275
780417528,780414501,780439142,24641,1321,275
780446520,780443276,780466531,23255,1322,275
780473820,780470794,780495751,24957,1323,275
780503040,780500013,780522102,22089,1324,275
780529329,780526301,780549658,23357,1325,275
780557036,780553791,780577385,23594,1326,275
780584761,780581518,780605765,24247,1327,275
780613141,780609898,780632518,22620,1328,275
780639766,780636739,780660432,23693,1329,275
780667741,780664714,780690940,26226,1330,275
780698320,780695074,780717697,22623,1331,275
780725075,780721831,780745402,23571,1332,275
780752693,780749664,780773042,23378,1333,275
780780264,780777237,780800909,23672,1334,275
780808198,780805171,780828864,23693,1335,275
780836241,780832997,780856252,23255,1336,275
780863630,780860386,780882692,22306,1337,275
780889933,780886906,780909628,22722,1338,275
780917005,780913761,780937966,24205,1339,275
780945255,780942228,780965921,23693,1340,275
780973301,780970055,780997093,27038,1341,275
781004357,781001330,781022783,21453,1342,275
781030161,781026917,781051459,24542,1343,275
781058748,781055721,781077808,22087,1344,275
781085115,781082088,781105780,23692,1345,275
781113158,781109914,781134118,24204,1346,275
781141495,781138251,781161190,22939,1347,275
781168567,781165323,781189887,24564,1348,275
781197105,781194077,781217769,23692,1349,275
781225148,781221902,781243893,21991,1350,275
781251127,781248100,781272741,24641,1351,275
781280051,781277024,781298163,21139,1352,275
781305383,781302356,781326028,23672,1353,275
781333251,781330223,781352947,22724,1354,275
781360161,781357134,781380825,23691,1355,275
781388078,781385051,781407793,22742,1356,275
781415029,781412001,781436011,24010,1357,275
781443277,781440249,781464576,24327,1358,275
781471813,781468786,781489292,20506,1359,275
781496547,781493519,781516580,23061,1360,275
781523864,781520838,781546133,25295,1361,275
781553405,781550377,781579935,29558,1362,275
781587313,781584069,781607979,23910,1363,275
781615357,781612112,781636973,24861,1364,275
781644192,781641165,781663886,22721,1365,275
781671165,781668137,781691514,23377,1366,275
781698892,781695648,781718924,23276,1367,275
781726168,781723140,781744933,21793,1368,275
781752221,781749193,781771600,22407,1369,275
781778833,781775805,781800765,24960,1370,275
781808142,781804898,781830705,25807,1371,275
781837999,781834972,781858665,23693,1372,275
781866043,781862798,781886076,23278,1373,275
781893453,781890209,781912516,22307,1374,275
781919807,781916780,781941445,24665,1375,275
781948822,781945578,781970121,24543,1376,275
781977499,781974255,781995294,21039,1377,275
782002671,781999428,782023948,24520,1378,275
782031236,782028209,782052852,24643,1379,275
782060062,782057035,782081045,24010,1380,275
782088423,782085179,782109068,23889,1381,275
782116285,782113257,782137267,24010,1382,275
782144531,782141504,782165198,23694,1383,275
782172576,782169332,782193559,24227,1384,275
782200721,782197693,782222236,24543,1385,275
782229614,782226370,782248042,21672,1386,275
782255281,782252253,782276262,24009,1387,275
782283567,782280539,782301680,21141,1388,275
782309058,782305814,782330695,24881,1389,275
782337998,782334971,782359635,24664,1390,275
782366939,782363912,782389843,25931,1391,275
782397082,782394053,782420323,26270,1392,275
782427486,782424457,782446448,21991,1393,275
782453825,782450581,782474490,23909,1394,275
782481698,782478670,782501393,22723,1395,275
782508684,782505657,782528718,23061,1396,275
782536096,782532851,782555810,22959,1397,275
782563187,782559943,782581932,21989,1398,275
782589310,782586066,782610903,24837,1399,275
782618195,782615167,782641436,26269,1400,275
782648815,782645570,782669797,24227,1401,275
782676957,782673931,782696551,22620,1402,275
782703774,782700745,782724419,23674,1403,275
782731699,782728672,782750443,21771,1404,275
782757709,782754681,782779344,24663,1405,275
782786564,782783537,782805646,22109,1406,275
782813024,782809779,782831770,21991,1407,275
782838990,782835963,782860606,24643,1408,275
782867917,782864889,782888267,23378,1409,275
782895521,782892494,782917452,24958,1410,275
782924708,782921680,782947927,26247,1411,275
782955305,782952061,782974051,21990,1412,275
782981430,782978185,783002096,23911,1413,275
783009359,783006331,783028420,22089,1414,275
783035716,783032688,783054798,22110,1415,275
783062030,783059003,783084279,25276,1416,275
783091659,783088413,783113254,24841,1417,275
783120632,783117388,783140031,22643,1418,275
783147191,783144165,783165836,21671,1419,275
783173085,783170057,783195671,25614,1420,275
783202918,783199890,783225208,25318,1421,275
783232516,783229489,783251916,22427,1422,275
783259295,783256050,783279960,23910,1423,275
783287245,783284217,783307256,23039,1424,275
783314634,783311390,783335278,23888,1425,275
783342656,783339412,783362689,23277,1426,275
783369926,783366898,783392196,25298,1427,275
783399473,783396445,783418536,22091,1428,275
783425788,783422762,783444532,21770,1429,275
783451782,783448753,783471815,23062,1430,275
783479193,783475949,783500176,24227,1431,275
783507553,783504310,783527266,22956,1432,275
783534645,783531400,783557230,25830,1433,275
783564465,783561437,783583844,22407,1434,275
783591139,783588111,783611171,23060,1435,275
783618547,783615304,783637945,22641,1436,275
783645183,783642155,783664877,22722,1437,275
783672166,783669139,783692197,23058,1438,275
783699574,783696331,783719606,23275,1439,275
783726861,783723834,783745607,21773,1440,275
783752985,783749741,783772047,22306,1441,275
783779424,783776181,783801356,25175,1442,275
783808665,783805636,783826777,21141,1443,275
783833939,783830911,783856405,25494,1444,275
783863641,783860613,783886882,26269,1445,275
783894259,783891016,783915559,24543,1446,275
783922826,783919799,783944780,24981,1447,275
783952157,783948914,783972822,23908,1448,275
783980084,783977056,784000433,23377,1449,275
784007652,784004623,784027683,23060,1450,275
784034845,784031816,784052858,21042,1451,275
784060168,784057141,784081784,24643,1452,275
784089018,784085991,784107764,21773,1453,275
784114924,784111897,784134542,22645,1454,275
784141829,784138802,784160258,21456,1455,275
784167637,784164392,784185750,21358,1456,275
784193063,784190035,784213411,23376,1457,275
784220618,784217591,784243542,25951,1458,275
784250805,784247778,784273707,25929,1459,275
784280974,784277947,784302272,24325,1460,275
784309650,784306406,784330316,23910,1461,275
784337478,784334450,784356124,21674,1462,275
784363397,784360370,784382458,22088,1463,275
784389722,784386695,784411021,24326,1464,275
784418227,784415200,784438576,23376,1465,275
784445804,784442777,784465499,22722,1466,275
784472878,784469633,784492574,22941,1467,275
784499953,784496708,784519015,22307,1468,275
784526393,784523149,784547038,23889,1469,275
784554270,784551243,784576517,25274,1470,275
784583740,784580712,784602485,21773,1471,275
784609865,784606619,784631817,25198,1472,275
784639195,784635951,784659523,23572,1473,275
784666740,784663713,784688334,24621,1474,275
784695618,784692591,784715334,22743,1475,275
784722712,784719468,784743694,24226,1476,275
784750930,784747903,784770328,22425,1477,275
784777707,784774462,784796452,21990,1478,275
784803828,784800585,784825128,24543,1479,275
784832365,784829338,784851427,22089,1480,275
784858676,784855650,784878708,23058,1481,275
784885944,784882917,784905978,23061,1482,275
784913246,784910218,784932624,22406,1483,275
784940002,784936758,784963559,26801,1484,275
784970809,784967781,784989870,22089,1485,275
784997103,784994076,785018064,23988,1486,275
785025442,785022198,785046403,24205,1487,275
785053648,785050620,785073661,23041,1488,275
785080958,785077931,785100338,22407,1489,275
785107624,785104597,785129577,24980,1490,275
785136803,785133775,785157130,23355,1491,275
785164506,785161263,785185172,23909,1492,275
785192332,785189306,785215789,26483,1493,275
785223167,785219923,785244467,24544,1494,275
785251845,785248601,785271877,23276,1495,275
785279256,785276011,785300555,24544,1496,275
785307774,785304748,785329389,24641,1497,275
785336681,785333655,785357684,24029,1498,275
785365063,785361818,785386384,24566,1499,275
785393763,785390518,785414427,23909,1500,275
785421806,785418561,785440868,22307,1501,275
785448115,785445088,785470067,24979,1502,275
785477304,785474276,785498940,24664,1503,275
785506169,785503141,785529071,25930,1504,275
785536355,785533328,785557674,24346,1505,275
785564897,785561868,785585224,23356,1506,275
785592436,785589409,785611181,21772,1507,275
785618558,785615315,785637619,22304,1508,275
785644997,785641753,785665662,23909,1509,275
785673042,785669796,785694045,24249,1510,275
785701287,785698260,785721319,23059,1511,275
785728696,785725453,785748707,23254,1512,275
785756085,785752841,785777046,24205,1513,275
785784424,785781180,785803802,22622,1514,275
785811103,785808076,785828581,20505,1515,275
785835799,785832772,785857098,24326,1516,275
785864477,785861232,785884509,23277,1517,275
785891778,785888750,785912443,23693,1518,275
785919685,785916657,785939083,22426,1519,275
785946345,785943317,785968593,25276,1520,275
785975972,785972727,785997271,24544,1521,275
786004508,786001481,786025173,23692,1522,275
786032420,786029391,786053086,23695,1523,275
786060317,786057290,786082585,25295,1524,275
786089816,786086790,786109195,22405,1525,275
786116484,786113456,786135882,22426,1526,275
786143173,786140145,786164789,24644,1527,275
786172166,786168923,786190594,21671,1528,275
786197819,786194792,786218485,23693,1529,275
786225771,786222745,786248060,25315,1530,275
786255335,786252308,786276317,24009,1531,275
786283696,786280451,786304045,23594,1532,275
786311353,786308325,786332652,24327,1533,275
786340030,786336786,786358141,21355,1534,275
786365519,786362275,786387154,24879,1535,275
786394366,786391338,786412477,21139,1536,275
786419754,786416727,786439449,22722,1537,275
786446680,786443653,786468296,24643,1538,275
786475674,786472429,786499232,26803,1539,275
786506438,786503410,786528370,24960,1540,275
786535747,786532503,786556413,23910,1541,275
786563720,786560692,786583436,22744,1542,275
786590674,786587647,786610053,22406,1543,275
786617306,786614279,786640210,25931,1544,275
786647588,786644344,786667283,22939,1545,275
786674510,786671483,786693593,22110,1546,275
786700971,786697726,786722924,25198,1547,275
786730152,786727125,786750501,23376,1548,275
786757798,786754771,786777808,23037,1549,275
786785065,786782037,786804782,22745,1550,275
786812160,786808915,786830269,21354,1551,275
786837646,786834402,786858312,23910,1552,275
786865571,786862545,786886237,23692,1553,275
786893475,786890448,786913802,23354,1554,275
786921180,786917936,786941509,23573,1555,275
786948886,786945642,786970185,24543,1556,275
786977418,786974391,786998063,23672,1557,275
787005440,787002197,787024503,22306,1558,275
787031881,787028637,787051913,23276,1559,275
787059224,787056197,787081156,24959,1560,275
787088398,787085371,787105878,20507,1561,275
787113255,787110012,787132950,22938,1562,275
787140329,787137084,787161628,24544,1563,275
787168928,787165901,787189911,24010,1564,275
787197121,787194094,787218083,23989,1565,275
787225306,787222279,787244684,22405,1566,275
787251890,787248863,787269052,20189,1567,275
787276343,787273316,787297028,23712,1568,275
787304404,787301161,787321881,20720,1569,275
787329174,787326147,787349184,23037,1570,275
787356448,787353420,787379034,25614,1571,275
787386321,787383294,787404434,21140,1572,275
787411687,787408659,787434611,25952,1573,275
787441826,787438799,787463462,24663,1574,275
787470765,787467738,787492085,24347,1575,275
787499299,787496272,787519985,23713,1576,275
787527250,787524223,787546312,22089,1577,275
787553690,787550445,787572119,21674,1578,275
787579324,787576297,787598385,22088,1579,275
787605629,787602602,787625977,23375,1580,275
787633235,787630208,787653584,23376,1581,275
787660804,787657777,787680519,22742,1582,275
787687762,787684734,787708429,23695,1583,275
787715717,787712690,787735434,22744,1584,275
787742693,787739665,787764329,24664,1585,275
787771603,787768575,787791635,23060,1586,275
787799012,787795768,787819657,23889,1587,275
787827035,787823791,787846731,22940,1588,275
787854108,787850864,787873508,22644,1589,275
787880731,787877704,787902323,24619,1590,275
787909701,787906457,787931315,24858,1591,275
787938533,787935506,787959830,24324,1592,275
787967042,787964015,787988657,24642,1593,275
787996036,787992791,788016364,23573,1594,275
788023673,788020646,788041151,20505,1595,275
788048362,788045335,788069978,24643,1596,275
788077189,788074163,788097222,23059,1597,275
788104471,788101444,788125767,24323,1598,275
788133144,788129900,788152859,22959,1599,275
788160084,788157057,788183640,26583,1600,275
788190902,788187874,788212853,24979,1601,275
788220232,788216987,788240561,23574,1602,275
788247940,788244695,788266686,21991,1603,275
788273923,788270897,788295243,24346,1604,275
788302620,788299377,788323287,23910,1605,275
788330533,788327505,788348961,21456,1606,275
788356340,788353095,788377005,23910,1607,275
788384245,788381218,788407169,25951,1608,275
788414398,788411370,788436669,25299,1609,275
788444048,788440803,788464692,23889,1610,275
788471854,788468826,788492420,23594,1611,275
788499712,788496684,788522278,25594,1612,275
788529534,788526507,788549543,23036,1613,275
788556751,788553724,788575812,22088,1614,275
788583190,788579946,788604172,24226,1615,275
788611549,788608306,788630927,22621,1616,275
788638215,788635189,788661118,25929,1617,275
788668280,788665253,788689794,24541,1618,275
788697172,788693928,788716233,22305,1619,275
788723611,788720367,788742039,21672,1620,275
788749322,788746295,788769016,22721,1621,275
788776257,788773229,788795318,22089,1622,275
788802581,788799553,788820377,20824,1623,275
788827645,788824618,788847678,23060,1624,275
788854927,788851899,788876542,24643,1625,275
788883920,788880676,788902666,21990,1626,275
788910044,788906800,788928155,21355,1627,275
788935464,788932437,788957713,25276,1628,275
788964946,788961919,788984345,22426,1629,275
788991560,788988534,789012541,24007,1630,275
789019852,789016826,789038598,21772,1631,275
789045901,789042873,789066566,23693,1632,275
789073860,789070833,789095178,24345,1633,275
789102557,789099312,789121618,22306,1634,275
789128908,789125880,789147652,21772,1635,275
789155030,789151786,789175378,23592,1636,275
789182755,789179512,789201816,22304,1637,275
789209089,789206061,789228784,22723,1638,275
789236043,789233015,789257342,24327,1639,275
789264721,789261476,789286357,24881,1640,275
789293618,789290591,789314285,23694,1641,275
789321549,789318522,789343165,24643,1642,275
789350427,789347400,789370776,23376,1643,275
789378155,789374910,789397533,22623,1644,275
789404801,789401774,789426099,24325,1645,275
789433477,789430233,789453805,23572,1646,275
789461053,789458025,789482668,24643,1647,275
789489954,789486927,789509986,23059,1648,275
789517365,789514120,789536446,22326,1649,275
789543823,789540580,789563518,22938,1650,275
789570769,789567741,789590147,22406,1651,275
789597368,789594340,789617696,23356,1652,275
789625075,789621831,789643820,21989,1653,275
789651053,789648026,789672646,24620,1654,275
789680024,789676780,789698453,21673,1655,275
789705831,789702588,789727129,24541,1656,275
789734508,789731263,789755807,24544,1657,275
789763184,789759941,789784164,24223,1658,275
789791325,789788298,789813811,25513,1659,275
789821189,789817945,789840251,22306,1660,275
789847554,789844527,789867566,23039,1661,275
789874851,789871823,789893280,21457,1662,275
789900531,789897503,789919592,22089,1663,275
789926804,789923776,789946500,22724,1664,275
789953731,789950705,789973741,23036,1665,275
789981028,789978001,790002644,24643,1666,275
790009932,790006905,790030893,23988,1667,275
790038130,790035102,790058457,23355,1668,275
790065730,790062702,790088928,26226,1669,275
790096154,790093127,790116799,23672,1670,275
790124023,790120997,790144372,23375,1671,275
790151750,790148506,790170178,21672,1672,275
790177458,790174432,790197783,23351,1673,275
790205027,790202000,790225671,23671,1674,275
790232907,790229880,790252918,23038,1675,275
790260137,790257109,790281119,24010,1676,275
790288417,790285389,790308745,23356,1677,275
790316017,790312990,790336976,23986,1678,275
790344248,790341221,790362044,20823,1679,275
790369321,790366294,790389332,23038,1680,275
790396630,790393603,790416958,23355,1681,275
790424336,790421092,790442447,21355,1682,275
790449661,790446634,790468744,22110,1683,275
790476055,790473028,790493850,20822,1684,275
790501117,790498089,790522394,24305,1685,275
790529680,790526652,790550977,24325,1686,275
790558198,790555169,790577259,22090,1687,275
790584478,790581451,790605439,23988,1688,275
790612816,790609573,790631876,22303,1689,275
790639254,790636010,790660867,24857,1690,275
790668083,790665055,790689043,23988,1691,275
790696420,790693177,790716770,23593,1692,275
790724058,790721031,790742803,21772,1693,275
790750181,790746937,790770529,23592,1694,275
790777769,790774741,790797144,22403,1695,275
790804427,790801401,790825073,23672,1696,275
790832288,790829262,790851666,22404,1697,275
790859044,790855800,790880343,24543,1698,275
790887609,790884582,790905404,20822,1699,275
790912649,790909623,790933610,23987,1700,275
790940856,790937828,790960889,23061,1701,275
790968136,790965108,790988485,23377,1702,275
790995751,790992723,791017048,24325,1703,275
791024320,791021292,791045280,23988,1704,275
791052658,791049414,791073303,23889,1705,275
791080530,791077502,791103432,25930,1706,275
791110811,791107567,791130190,22623,1707,275
791137568,791134324,791156629,22305,1708,275
791163847,791160820,791183859,23039,1709,275
791191149,791188122,791214051,25929,1710,275
791221266,791218240,791241614,23374,1711,275
791248857,791245829,791268236,22407,1712,275
791275470,791272444,791296134,23690,1713,275
791303443,791300414,791325058,24644,1714,275
791332316,791329289,791352983,23694,1715,275
791360276,791357248,791381870,24622,1716,275
791389176,791386149,791409820,23671,1717,275
791417132,791414104,791436194,22090,1718,275
791443498,791440471,791463847,23376,1719,275
791471090,791468062,791489518,21456,1720,275
791496741,791493714,791515801,22087,1721,275
791523055,791520027,791542749,22722,1722,275
791549995,791546968,791575852,28884,1723,275
791583015,791579987,791607072,27085,1724,275
791614453,791611207,791635456,24249,1725,275
791642739,791639711,791665303,25592,1726,275
791672579,791669551,791692611,23060,1727,275
791699856,791696829,791721787,24958,1728,275
791729006,791725979,791750622,24643,1729,275
791757850,791754823,791778831,24008,1730,275
791786050,791783023,791806693,23670,1731,275
791814071,791810827,791833449,22622,1732,275
791840737,791837711,791861719,24008,1733,275
791869006,791865979,791890306,24327,1734,275
791897594,791894567,791919843,25276,1735,275
791927107,791924078,791946169,22091,1736,275
791953449,791950420,791973145,22725,1737,275
791980524,791977279,792001845,24566,1738,275
792009008,792005980,792030840,24860,1739,275
792038082,792035055,792058092,23037,1740,275
792065471,792062226,792085483,23257,1741,275
792092694,792089666,792112389,22723,1742,275
792119669,792116642,792140948,24306,1743,275
792148236,792145209,792167931,22722,1744,275
792175092,792172065,792195953,23888,1745,275
792203218,792200191,792223884,23693,1746,275
792231262,792228018,792250323,22305,1747,275
792257701,792254457,792276764,22307,1748,275
792283926,792280899,792304155,23256,1749,275
792311413,792308386,792332057,23671,1750,275
792339435,792336191,792359763,23572,1751,275
792366988,792363961,792388288,24327,1752,275
792395666,792392422,792416015,23593,1753,275
792423318,792420290,792445251,24961,1754,275
792452493,792449464,792472821,23357,1755,275
792480057,792477030,792498802,21772,1756,275
792506180,792502936,792526192,23256,1757,275
792533570,792530326,792553602,23276,1758,275
792560868,792557840,792582503,24663,1759,275
792589737,792586710,792609452,22742,1760,275
792616830,792613586,792637157,23571,1761,275
792644536,792641292,792664546,23254,1762,275
792671923,792668680,792692272,23592,1763,275
792699649,792696406,792720947,24541,1764,275
792728190,792725162,792745985,20823,1765,275
792753223,792750195,792772917,22722,1766,275
792780296,792777051,792798724,21673,1767,275
792805981,792802953,792827597,24644,1768,275
792834975,792831731,792855956,24225,1769,275
792863239,792860212,792882302,22090,1770,275
792889592,792886565,792907072,20507,1771,275
792914376,792911349,792935654,24305,1772,275
792942901,792939874,792963229,23355,1773,275
792970391,792967364,792989671,22307,1774,275
792996897,792993869,793017880,24011,1775,275
793025110,793022084,793045775,23691,1776,275
793053153,793049909,793074790,24881,1777,275
793082026,793078999,793102059,23060,1778,275
793109437,793106193,793132003,25810,1779,275
793139383,793136138,793161335,25197,1780,275
793168615,793165587,793189281,23694,1781,275
793196532,793193504,793215593,22089,1782,275
793222809,793219782,793242820,23038,1783,275
793249982,793246955,793269575,22620,1784,275
793276783,793273756,793296161,22405,1785,275
793303539,793300295,793325788,25493,1786,275
793333002,793329974,793352062,22088,1787,275
793359274,793356247,793378970,22723,1788,275
793386348,793383104,793407012,23908,1789,275
793414390,793411146,793434738,23592,1790,275
793442026,793438999,793462037,23038,1791,275
793469321,793466293,793489017,22724,1792,275
793496252,793493225,793516262,23037,1793,275
793523470,793520442,793543164,22722,1794,275
793550543,793547299,793571209,23910,1795,275
793578497,793575469,793598824,23355,1796,275
793606094,793603065,793628997,25932,1797,275
793636243,793633216,793656909,23693,1798,275
793664199,793661171,793685496,24325,1799,275
793692726,793689698,793714319,24621,1800,275
793721697,793718453,793741390,22937,1801,275
793748689,793745660,793768383,22723,1802,275
793775761,793772517,793796722,24205,1803,275
793803958,793800931,793822070,21139,1804,275
793829280,793826253,793851529,25276,1805,275
793858906,793855663,793882463,26800,1806,275
793889843,793886598,793911141,24543,1807,275
793918397,793915370,793939673,24303,1808,275
793946885,793943858,793967528,23670,1809,275
793974690,793971662,793996521,24859,1810,275
794003899,794000655,794023299,22644,1811,275
794030677,794027433,794051976,24543,1812,275
794059354,794056110,794081939,25829,1813,275
794089318,794086074,794110280,24206,1814,275
794117660,794114415,794137671,23256,1815,275
794145049,794141805,794166029,24224,1816,275
794173316,794170289,794192061,21772,1817,275
794199439,794196195,794220738,24543,1818,275
794227900,794224873,794250366,25493,1819,275
794257605,794254578,794279535,24957,1820,275
794286826,794283799,794305888,22089,1821,275
794313265,794310022,794335197,25175,1822,275
794342446,794339419,794364399,24980,1823,275
794371665,794368638,794392626,23988,1824,275
794399863,794396835,794420845,24010,1825,275
794428223,794424979,794448867,23888,1826,275
794456173,794453146,794474602,21456,1827,275
794481829,794478802,794502156,23354,1828,275
794509433,794506405,794530732,24327,1829,275
794537957,794534930,794558601,23671,1830,275
794565979,794562736,794587277,24541,1831,275
794594569,794591541,794617766,26225,1832,275
794625145,794621901,794643573,21672,1833,275
794650825,794647798,794672440,24642,1834,275
794679675,794676647,794700636,23989,1835,275
794707890,794704863,794726635,21772,1836,275
794734015,794730769,794755947,25178,1837,275
794763325,794760081,794786227,26146,1838,275
794793607,794790362,794814252,23890,1839,275
794821631,794818387,794843225,24838,1840,275
794850510,794847482,794868622,21140,1841,275
794876000,794872756,794898566,25810,1842,275
794905946,794902701,794926906,24205,1843,275
794934161,794931133,794953855,22722,1844,275
794961144,794958116,794979888,21772,1845,275
794987111,794984084,795008072,23988,1846,275
795015451,795012206,795036097,23891,1847,275
795043476,795040231,795064119,23888,1848,275
795071497,795068253,795092164,23911,1849,275
795099542,795096298,795121157,24859,1850,275
795128378,795125352,795147121,21769,1851,275
795154392,795151365,795175353,23988,1852,275
795182600,795179572,795203879,24307,1853,275
795211259,795208013,795229687,21674,1854,275
795236916,795233888,795258848,24960,1855,275
795266105,795263078,795284217,21139,1856,275
795291508,795288481,795313441,24960,1857,275
795320819,795317575,795342773,25198,1858,275
795350150,795346907,795372102,25195,1859,275
795379481,795376237,795399175,22938,1860,275
795406429,795403403,795426441,23038,1861,275
795433682,795430655,795455931,25276,1862,275
795463166,795460139,795485076,24937,1863,275
795492454,795489210,795511833,22623,1864,275
795519137,795516109,795537565,21456,1865,275
795544797,795541770,795564808,23038,1866,275
795571971,795568943,795591881,22938,1867,275
795599262,795596016,795620560,24544,1868,275
795627939,795624695,795646050,21355,1869,275
795653352,795650323,795673068,22745,1870,275
795680341,795677314,795701957,24643,1871,275
795709259,795706232,795729902,23670,1872,275
795737192,795734164,795756887,22723,1873,275
795764137,795761109,795783515,22406,1874,275
795790894,795787649,795813796,26147,1875,275
795821175,795817931,795842156,24225,1876,275
795849536,795846291,795868278,21987,1877,275
795875558,795872531,795895253,22722,1878,275
795902471,795899444,795920900,21456,1879,275
795928278,795925034,795947973,22939,1880,275
795955217,795952188,795973646,21458,1881,275
795980920,795977893,796002219,24326,1882,275
796009598,796006354,796031551,25197,1883,275
796038929,796035686,796059257,23571,1884,275
796066553,796063526,796084981,21455,1885,275
796092251,796089224,796114205,24981,1886,275
796121460,796118432,796144701,26269,1887,275
796151919,796148892,796172879,23987,1888,275
796180130,796177104,796200457,23353,1889,275
796207748,796204721,796229361,24640,1890,275
796236602,796233574,796255664,22090,1891,275
796262961,796259934,796282994,23060,1892,275
796290373,796287129,796310069,22940,1893,275
796317291,796314263,796335719,21456,1894,275
796343098,796339853,796365051,25198,1895,275
796372316,796369289,796390426,21137,1896,275
796397684,796394657,796419300,24643,1897,275
796426680,796423434,796445425,21991,1898,275
796452667,796449640,796472993,23353,1899,275
796480371,796477127,796499432,22305,1900,275
796506692,796503664,796525120,21456,1901,275
796532499,796529254,796552825,23571,1902,275
796560052,796557025,796581688,24663,1903,275
796588988,796585960,796609654,23694,1904,275
796617032,796613788,796638014,24226,1905,275
796645391,796642148,796665085,22937,1906,275
796672330,796669303,796692361,23058,1907,275
796699740,796696495,796720068,23573,1908,275
796727301,796724274,796749887,25613,1909,275
796757265,796754022,796778246,24224,1910,275
796785625,796782381,796804371,21990,1911,275
796811611,796808585,796832593,24008,1912,275
796839971,796836727,796862557,25830,1913,275
796869936,796866692,796891867,25175,1914,275
796899106,796896079,796919117,23038,1915,275
796926419,796923392,796947739,24347,1916,275
796955026,796951999,796974743,22744,1917,275
796982021,796978994,797002685,23691,1918,275
797009935,797006907,797030283,23376,1919,275
797037662,797034418,797058328,23910,1920,275
797065706,797062462,797085083,22621,1921,275
797092364,797089338,797113029,23691,1922,275
797120190,797117163,797140122,22959,1923,275
797147501,797144256,797168800,24544,1924,275
797176180,797172934,797196190,23256,1925,275
797203408,797200380,797221837,21457,1926,275
797229215,797225971,797250830,24859,1927,275
797258068,797255041,797278711,23670,1928,275
797285976,797282949,797303453,20504,1929,275
797310664,797307636,797332301,24665,1930,275
797339679,797336435,797360978,24543,1931,275
797368357,797365112,797390268,25156,1932,275
797397499,797394471,797416562,22091,1933,275
797423811,797420784,797447348,26564,1934,275
797454727,797451483,797475076,23593,1935,275
797482342,797479314,797503008,23694,1936,275
797510386,797507142,797529764,22622,1937,275
797536970,797533943,797557615,23672,1938,275
797564993,797561749,797585658,23909,1939,275
797592894,797589867,797611955,22088,1940,275
797619332,797616089,797638709,22620,1941,275
797645932,797642903,797666599,23696,1942,275
797673836,797670809,797695451,24642,1943,275
797702732,797699704,797724368,24664,1944,275
797731746,797728502,797751463,22961,1945,275
797758624,797755597,797778535,22938,1946,275
797785916,797782669,797805632,22963,1947,275
797812897,797809871,797834196,24325,1948,275
797841475,797838447,797862457,24010,1949,275
797869707,797866680,797890351,23671,1950,275
797897590,797894563,797919206,24643,1951,275
797926586,797923341,797946618,23277,1952,275
797953902,797950875,797975223,24348,1953,275
797982602,797979358,798003901,24543,1954,275
798011280,798008035,798030342,22307,1955,275
798037637,798034609,798058915,24306,1956,275
798066132,798063105,798087430,24325,1957,275
798094653,798091626,798113082,21456,1958,275
798120296,798117268,798140942,23674,1959,275
798148322,798145077,798168017,22940,1960,275
798175292,798172265,798196612,24347,1961,275
798203991,798200747,798226895,26148,1962,275
798234160,798231132,798255459,24327,1963,275
798262733,798259705,798282450,22745,1964,275
798289722,798286695,798311020,24325,1965,275
798318398,798315154,798336195,21041,1966,275
798343572,798340329,798363266,22937,1967,275
798370645,798367401,798389072,21671,1968,275
798396312,798393285,798415691,22406,1969,275
798422929,798419901,798443575,23674,1970,275
798450736,798447709,798470330,22621,1971,275
798477621,798474594,798498919,24325,1972,275
798506227,798503197,798527207,24010,1973,275
798534452,798531425,798553197,21772,1974,275
798560464,798557437,798580475,23038,1975,275
798587718,798584691,798607731,23040,1976,275
798615109,798611866,798638329,26463,1977,275
798645707,798642464,798667956,25492,1978,275
798675207,798672179,798695852,23673,1979,275
798703157,798700129,798721584,21455,1980,275
798728963,798725719,798749924,24205,1981,275
798757153,798754125,798777481,23356,1982,275
798784773,798781746,798802885,21139,1983,275
798810102,798807074,798828212,21138,1984,275
798835507,798832479,798857142,24663,1985,275
798864410,798861382,798886046,24664,1986,275
798893425,798890180,798912486,22306,1987,275
798919865,798916620,798940825,24205,1988,275
798948087,798945060,798968435,23375,1989,275
798975689,798972663,798996018,23355,1990,275
799003396,799000152,799022458,22306,1991,275
799029838,799026593,799050482,23889,1992,275
799057860,799054616,799080425,25809,1993,275
799087632,799084605,799107011,22406,1994,275
799114390,799111145,799133135,21990,1995,275
799140513,799137269,799158940,21671,1996,275
799166246,799163220,799186892,23672,1997,275
799194269,799191026,799214936,23910,1998,275
799222315,799219071,799243930,24859,1999,275
799251236,799248208,799270613,22405,2000,275
799277992,799274748,799300896,26148,2001,275
799308277,799305032,799330842,25810,2002,275
799338223,799334978,799359817,24839,2003,275
799367122,799364094,799388737,24643,2004,275
799395898,799392871,799419314,26443,2005,275
799426565,799423536,799446281,22745,2006,275
799453536,799450508,799475149,24641,2007,275
799482404,799479377,799503069,23692,2008,275
799510448,799507204,799530776,23572,2009,275
799538065,799535038,799557126,22088,2010,275
799564334,799561307,799586604,25297,2011,275
799593982,799590738,799613043,22305,2012,275
799620343,799617315,799639110,21795,2013,275
799646353,799643324,799668284,24960,2014,275
799675663,799672419,799694408,21989,2015,275
799701787,799698543,799720869,22326,2016,275
799728087,799725059,799747487,22428,2017,275
799754865,799751622,799774877,23255,2018,275
799782090,799779062,799802440,23378,2019,275
799809819,799806575,799828901,22326,2020,275
799836132,799833105,799855849,22744,2021,275
799863134,799860106,799882195,22089,2022,275
799889576,799886330,799911212,24882,2023,275
799918512,799915485,799938861,23376,2024,275
799946152,799943125,799968106,24981,2025,275
799975393,799972366,799997979,25613,2026,275
800005280,800002253,800025944,23691,2027,275
800033227,800030198,800052604,22406,2028,275
800059982,800056738,800079675,22937,2029,275
800086955,800083928,800105700,21772,2030,275
800113077,800109834,800134059,24225,2031,275
800141436,800138193,800162417,24224,2032,275
800169795,800166551,800190122,23571,2033,275
800197500,800194257,800216584,22327,2034,275
800223792,800220764,800243170,22406,2035,275
800250393,800247366,800271375,24009,2036,275
800278753,800275509,800297815,22306,2037,275
800305028,800302000,800326644,24644,2038,275
800334023,800330779,800351503,20724,2039,275
800358883,800355637,800379865,24228,2040,275
800387100,800384074,800409687,25613,2041,275
800416923,800413896,800436935,23039,2042,275
800444147,800441120,800464179,23059,2043,275
800471557,800468313,800493171,24858,2044,275
800500549,800497305,800522164,24859,2045,275
800529542,800526299,800550208,23909,2046,275
800557586,800554342,800578568,24226,2047,275
800585948,800582702,800605327,22625,2048,275
800612490,800609461,800634026,24565,2049,275
800641258,800638231,800660636,22405,2050,275
800667874,800664847,800688857,24010,2051,275
800696096,800693069,800717395,24326,2052,275
800724637,800721610,800745303,23693,2053,275
800752580,800749553,800772592,23039,2054,275
800779844,800776818,800801144,24326,2055,275
800808454,800805426,800828148,22722,2056,275
800835354,800832328,800856651,24323,2057,275
800863878,800860850,800881357,20507,2058,275
800888606,800885579,800908639,23060,2059,275
800915920,800912893,800934981,22088,2060,275
800942269,800939242,800962618,23376,2061,275
800969996,800966752,800990325,23573,2062,275
800997542,800994515,801017554,23039,2063,275
801024866,801021839,801046818,24979,2064,275
801054197,801050953,801077099,26146,2065,275
801084479,801081234,801105756,24522,2066,275
801113133,801109890,801134432,24542,2067,275
801141730,801138704,801161107,22403,2068,275
801168487,801165242,801190102,24860,2069,275
801197482,801194237,801216226,21989,2070,275
801223388,801220361,801244609,24248,2071,275
801251841,801248812,801274406,25594,2072,275
801281700,801278672,801302703,24031,2073,275
801309949,801306921,801330299,23378,2074,275
801337561,801334533,801356939,22406,2075,275
801364317,801361073,801384665,23592,2076,275
801392042,801388799,801412707,23908,2077,275
801420087,801416842,801441701,24859,2078,275
801449080,801445836,801470694,24858,2079,275
801477962,801474935,801497657,22722,2080,275
801504865,801501837,801527451,25614,2081,275
801534831,801531586,801553259,21673,2082,275
801560639,801557394,801582571,25177,2083,275
801589951,801586705,801609330,22625,2084,275
801616580,801613552,801635979,22427,2085,275
801643358,801640113,801664340,24227,2086,275
801671717,801668474,801691412,22938,2087,275
801698789,801695546,801716582,21036,2088,275
801723804,801720777,801745420,24643,2089,275
801752798,801749555,801771859,22304,2090,275
801779238,801775994,801800559,24565,2091,275
801807766,801804739,801829381,24642,2092,275
801836760,801833516,801857742,24226,2093,275
801865120,801861876,801884181,22305,2094,275
801891457,801888430,801913073,24643,2095,275
801920452,801917208,801939198,21990,2096,275
801946481,801943455,801968117,24662,2097,275
801975416,801972389,801997030,24641,2098,275
802004282,802001255,802023661,22406,2099,275
802030951,802027924,802052544,24620,2100,275
802059766,802056739,802081087,24348,2101,275
802088349,802085322,802108045,22723,2102,275
802115425,802112180,802135774,23594,2103,275
802143017,802139990,802164000,24010,2104,275
802171274,802168245,802189070,20825,2105,275
802196354,802193326,802215754,22428,2106,275
802222993,802219966,802243005,23039,2107,275
802250284,802247257,802268713,21456,2108,275
802275937,802272910,802296918,24008,2109,275
802304153,802301125,802323551,22426,2110,275
802330782,802327754,802349211,21457,2111,275
802356463,802353436,802378415,24979,2112,275
802385795,802382550,802403591,21041,2113,275
802410869,802407841,802431219,23378,2114,275
802438507,802435479,802460756,25277,2115,275
802467994,802464967,802490897,25930,2116,275
802498131,802495103,802520695,25592,2117,275
802527967,802524940,802546396,21456,2118,275
802553682,802550655,802575318,24663,2119,275
802582620,802579593,802603918,24325,2120,275
802611203,802608176,802630286,22110,2121,275
802637665,802634421,802658329,23908,2122,275
802665608,802662581,802685006,22425,2123,275
802692282,802689255,802712610,23355,2124,275
802719862,802716835,802739871,23036,2125,275
802747139,802744112,802767784,23672,2126,275
802775163,802771919,802793592,21673,2127,275
802800808,802797781,802820818,23037,2128,275
802828196,802824953,802849493,24540,2129,275
802856714,802853688,802878014,24326,2130,275
802885271,802882244,802908828,26584,2131,275
802916067,802913039,802936395,23356,2132,275
802943637,802940611,802963332,22721,2133,275
802970710,802967466,802990088,22622,2134,275
802997323,802994295,803018959,24664,2135,275
803026250,803023222,803048202,24980,2136,275
803055464,803052438,803076762,24324,2137,275
803084052,803081025,803106300,25275,2138,275
803113563,803110536,803132941,22405,2139,275
803140322,803137076,803159383,22307,2140,275
803166694,803163666,803185438,21772,2141,275
803192662,803189635,803213326,23691,2142,275
803220542,803217514,803241525,24011,2143,275
803248809,803245781,803269474,23693,2144,275
803276722,803273694,803296733,23039,2145,275
803303985,803300958,803325305,24347,2146,275
803332683,803329439,803353011,23572,2147,275
803360256,803357228,803382188,24960,2148,275
803389567,803386322,803409261,22939,2149,275
803416486,803413459,803436835,23376,2150,275
803444044,803441017,803463126,22109,2151,275
803470410,803467383,803488837,21454,2152,275
803496215,803492971,803518462,25491,2153,275
803525676,803522650,803544420,21770,2154,275
803551670,803548643,803570097,21454,2155,275
803577476,803574232,803596854,22622,2156,275
803604135,803601107,803626089,24982,2157,275
803633468,803630224,803651896,21672,2158,275
803659276,803656031,803679604,23573,2159,275
803686901,803683874,803704694,20820,2160,275
803711968,803708940,803731999,23059,2161,275
803739224,803736197,803759257,23060,2162,275
803766635,803763392,803786351,22959,2163,275
803793638,803790610,803815592,24982,2164,275
803822842,803819814,803840952,21138,2165,275
803848185,803845158,803868851,23693,2166,275
803876130,803873103,803896141,23038,2167,275
803903518,803900275,803924181,23906,2168,275
803931397,803928371,803951091,22720,2169,275
803958398,803955370,803980013,24643,2170,275
803987392,803984148,804005821,21673,2171,275
804013200,804009955,804034182,24227,2172,275
804041434,804038407,804062100,23693,2173,275
804069398,804066371,804087827,21456,2174,275
804095065,804092038,804114126,22088,2175,275
804121419,804118391,804142084,23693,2176,275
804149246,804146219,804168841,22622,2177,275
804176049,804173022,804196398,23376,2178,275
804203615,804200588,804224596,24008,2179,275
804231882,804228855,804252548,23693,2180,275
804259927,804256683,804281839,25156,2181,275
804289067,804286040,804309394,23354,2182,275
804316773,804313529,804336151,22622,2183,275
804343531,804340286,804366097,25811,2184,275
804373475,804370232,804394774,24542,2185,275
804402003,804398975,804423639,24664,2186,275
804431017,804427774,804453582,25808,2187,275
804460861,804457834,804482813,24979,2188,275
804490076,804487048,804509454,22406,2189,275
804516716,804513689,804537699,24010,2190,275
804544991,804541964,804565655,23691,2191,275
804572953,804569926,804593596,23670,2192,275
804600808,804597781,804619870,22089,2193,275
804627107,804624080,804649039,24959,2194,275
804656324,804653296,804678277,24981,2195,275
804685657,804682412,804705668,23256,2196,275
804712939,804709913,804733605,23692,2197,275
804740877,804737849,804762493,24644,2198,275
804769725,804766697,804791656,24959,2199,275
804798866,804795838,804818266,22428,2200,275
804825526,804822499,804846171,23672,2201,275
804853392,804850365,804872770,22405,2202,275
804880149,804876905,804900182,23277,2203,275
804907560,804904316,804929514,25198,2204,275
804936893,804933649,804956905,23256,2205,275
804964112,804961086,804985410,24324,2206,275
804992699,804989672,805012393,22721,2207,275
805019652,805016624,805039051,22427,2208,275
805046430,805043186,805068699,25513,2209,275
805075935,805072906,805098204,25298,2210,275
805105435,805102408,805125152,22744,2211,275
805132395,805129367,805151773,22406,2212,275
805159151,805155907,805179161,23254,2213,275
805186401,805183374,805207699,24325,2214,275
805215078,805211833,805235742,23909,2215,275
805242991,805239964,805263657,23693,2216,275
805270893,805267866,805291242,23376,2217,275
805298468,805295441,805319134,23693,2218,275
805326419,805323392,805349006,25614,2219,275
805356262,805353234,805376905,23671,2220,275
805384198,805381169,805404843,23674,2221,275
805412006,805408978,805432571,23593,2222,275
805439951,805436706,805461567,24861,2223,275
805468947,805465702,805489296,23594,2224,275
805496531,805493503,805518781,25278,2225,275
805526023,805522995,805545399,22404,2226,275
805552684,805549656,805574003,24347,2227,275
805581381,805578138,805604622,26484,2228,275
805612002,805608758,805632646,23888,2229,275
805639869,805636842,805658615,21773,2230,275
805665878,805662852,805686861,24009,2231,275
805694097,805691070,805712843,21773,2232,275
805720070,805717042,805740101,23059,2233,275
805747370,805744343,805769302,24959,2234,275
805776592,805773564,805797891,24327,2235,275
805805181,805802153,805826460,24307,2236,275
805833703,805830677,805855657,24980,2237,275
805862895,805859868,805885164,25296,2238,275
805892543,805889299,805912554,23255,2239,275
805919799,805916770,805941753,24983,2240,275
805948978,805945952,805970931,24979,2241,275
805978216,805975187,806001098,25911,2242,275
806008390,806005363,806029036,23673,2243,275
806036277,806033249,806056943,23694,2244,275
806064321,806061078,806084038,22960,2245,275
806091330,806088303,806110392,22089,2246,275
806117694,806114667,806138044,23377,2247,275
806145271,806142243,806166886,24643,2248,275
806174118,806171090,806194445,23355,2249,275
806201824,806198580,806220570,21990,2250,275
806227855,806224828,806248816,23988,2251,275
806256061,806253034,806273540,20506,2252,275
806280757,806277730,806300453,22723,2253,275
806307720,806304692,806329990,25298,2254,275
806337273,806334245,806356969,22724,2255,275
806364197,806361170,806384207,23037,2256,275
806391586,806388342,806410649,22307,2257,275
806417859,806414833,806437554,22721,2258,275
806444795,806441767,806465124,23357,2259,275
806472341,806469313,806494273,24960,2260,275
806501529,806498502,806523145,24643,2261,275
806530525,806527280,806551190,23910,2262,275
806558570,806555325,806579215,23890,2263,275
806586515,806583487,806605893,22406,2264,275
806613193,806610166,806634492,24326,2265,275
806641871,806638627,806662200,23573,2266,275
806669485,806666457,806689834,23377,2267,275
806697107,806694078,806716801,22723,2268,275
806724030,806721003,806745329,24326,2269,275
806752567,806749540,806773550,24010,2270,275
806780929,806777685,806803809,26124,2271,275
806811097,806808070,806831762,23692,2272,275
806839140,806835897,806858518,22621,2273,275
806865811,806862783,806886159,23376,2274,275
806893443,806890416,806913138,22722,2275,275
806920421,806917394,806942690,25296,2276,275
806949851,806946824,806969467,22643,2277,275
806976698,806973670,806997976,24306,2278,275
807005208,807002179,807025556,23377,2279,275
807032841,807029814,807051585,21771,2280,275
807058811,807055784,807080089,24305,2281,275
807087467,807084224,807107796,23572,2282,275
807115090,807112061,807135101,23040,2283,275
807142406,807139380,807161466,22086,2284,275
807168681,807165656,807189662,24006,2285,275
807196898,807193871,807216910,23039,2286,275
807224290,807221045,807247826,26781,2287,275
807255128,807252101,807276109,24008,2288,275
807283369,807280342,807304351,24009,2289,275
807311607,807308578,807332589,24011,2290,275
807339821,807336793,807357933,21140,2291,275
807365312,807362068,807386589,24521,2292,275
807393815,807390789,807412878,22089,2293,275
807420258,807417013,807441241,24228,2294,275
807448523,807445497,807468554,23057,2295,275
807475931,807472688,807497228,24540,2296,275
807504510,807501482,807525809,24327,2297,275
807533187,807529944,807554506,24562,2298,275
807561751,807558725,807582099,23374,2299,275
807589354,807586326,807609366,23040,2300,275
807616651,807613623,807635712,22089,2301,275
807642943,807639916,807660738,20822,2302,275
807668117,807664873,807686545,21672,2303,275
807693924,807690680,807714273,23593,2304,275
807721518,807718492,807741846,23354,2305,275
807749154,807746127,807767899,21772,2306,275
807775278,807772033,807796577,24544,2307,275
807803956,807800712,807823988,23276,2308,275
807831244,807828217,807852859,24642,2309,275
807860095,807857066,807879495,22429,2310,275
807886748,807883720,807907413,23693,2311,275
807914712,807911685,807934408,22723,2312,275
807941621,807938594,807965178,26584,2313,275
807972386,807969359,807992418,23059,2314,275
807999796,807996553,808019196,22643,2315,275
808026431,808023403,808046780,23377,2316,275
808054069,808051041,808075980,24939,2317,275
808083246,808080218,808104883,24665,2318,275
808112263,808109018,808133561,24543,2319,275
808140812,808137785,808160844,23059,2320,275
808168114,808165087,808188125,23038,2321,275
808195414,808192387,808217049,24662,2322,275
808224301,808221274,808246212,24938,2323,275
808253509,808250482,808272254,21772,2324,275
808279632,808276388,808299644,23256,2325,275
808306806,808303779,808327371,23592,2326,275
808334615,808331586,808354647,23061,2327,275
808361886,808358859,808381580,22721,2328,275
808388959,808385715,808408676,22961,2329,275
808416054,808412811,808435749,22938,2330,275
808443001,808439974,808463013,23039,2331,275
808470231,808467204,808489293,22089,2332,275
808496456,808493428,808516706,23278,2333,275
808523963,808520936,808542707,21771,2334,275
808550009,808546983,808571625,24642,2335,275
808579004,808575760,808602541,26781,2336,275
808609921,808606677,808629932,23255,2337,275
808637196,808634169,808658515,24346,2338,275
808665805,808662776,808688391,25615,2339,275
808695652,808692626,808717583,24957,2340,275
808724834,808721807,808745795,23988,2341,275
808753063,808750036,808771808,21772,2342,275
808778970,808775943,808798248,22305,2343,275
808805545,808802518,808825556,23038,2344,275
808832834,808829805,808853161,23356,2345,275
808860467,808857438,808881767,24329,2346,275
808889076,808886049,808908453,22404,2347,275
808915733,808912706,808936400,23694,2348,275
808943619,808940592,808962048,21456,2349,275
808969426,808966182,808989438,23256,2350,275
808996817,808993572,809017482,23910,2351,275
809024861,809021617,809045526,23909,2352,275
809052760,809049733,809073740,24007,2353,275
809081009,809077981,809101042,23061,2354,275
809108299,809105272,809128627,23355,2355,275
809136007,809132762,809156988,24226,2356,275
809164270,809161243,809185252,24009,2357,275
809192631,809189387,809213930,24543,2358,275
809221149,809218122,809240528,22406,2359,275
809247822,809244795,809269121,24326,2360,275
809276500,809273256,809298748,25492,2361,275
809306033,809303005,809326383,23378,2362,275
809333762,809330518,809353456,22938,2363,275
809360695,809357668,809380411,22743,2364,275
809387649,809384623,809409264,24641,2365,275
809416643,809413399,809436969,23570,2366,275
809444201,809441173,809464550,23377,2367,275
809471767,809468740,809492749,24009,2368,275
809499910,809496884,809520455,23571,2369,275
809527753,809524727,809549367,24640,2370,275
809556600,809553571,809578848,25277,2371,275
809586078,809583051,809607694,24643,2372,275
809614973,809611947,809636905,24958,2373,275
809644283,809641040,809662710,21670,2374,275
809669986,809666959,809689999,23040,2375,275
809697241,809694214,809719173,24959,2376,275
809726399,809723371,809746095,22724,2377,275
809753258,809750230,809775091,24861,2378,275
809782472,809779226,809803137,23911,2379,275
809810300,809807272,809830528,23256,2380,275
809837818,809834791,809859455,24664,2381,275
809866701,809863674,809887978,24304,2382,275
809895196,809892169,809913942,21773,2383,275
809921172,809918145,809942788,24643,2384,275
809950028,809947001,809970673,23672,2385,275
809977896,809974869,809997592,22723,2386,275
810004831,810001805,810025496,23691,2387,275
810032775,810029747,810053757,24010,2388,275
810060978,810057951,810081960,24009,2389,275
810089341,810086095,810110322,24227,2390,275
810117700,810114457,810139315,24858,2391,275
810146589,810143560,810165967,22407,2392,275
810173247,810170220,810192940,22720,2393,275
810200231,810197205,810219925,22720,2394,275
810227304,810224060,810247019,22959,2395,275
810254331,810251304,810274996,23692,2396,275
810282375,810279131,810300486,21355,2397,275
810307788,810304761,810326849,22088,2398,275
810334062,810331035,810353124,22089,2399,275
810360356,810357328,810379735,22407,2400,275
810387113,810383869,810407462,23593,2401,275
810414843,810411597,810434243,22646,2402,275
810441482,810438455,810461493,23038,2403,275
810468717,810465690,810488410,22720,2404,275
810495691,810492664,810515089,22425,2405,275
810522325,810519297,810541704,22407,2406,275
810548993,810545964,810570292,24328,2407,275
810577598,810574571,810597925,23354,2408,275
810605305,810602060,810624684,22624,2409,275
810631933,810628906,810652598,23692,2410,275
810659873,810656845,810679567,22722,2411,275
810686863,810683836,810707507,23671,2412,275
810714803,810711773,810736419,24646,2413,275
810743715,810740689,810765351,24662,2414,275
810772640,810769613,810790752,21139,2415,275
810798035,810795008,810819016,24008,2416,275
810826275,810823248,810846919,23671,2417,275
810854298,810851054,810875912,24858,2418,275
810883293,810880047,810902672,22625,2419,275
810909886,810906858,810932155,25297,2420,275
810939427,810936400,810957855,21455,2421,275
810965233,810961990,810986531,24541,2422,275
810993770,810990743,811014098,23355,2423,275
811021350,811018323,811042964,24641,2424,275
811050190,811047163,811069253,22090,2425,275
811076633,811073388,811098271,24883,2426,275
811105650,811102406,811124078,21672,2427,275
811131357,811128331,811150418,22087,2428,275
811157684,811154656,811179322,24666,2429,275
811186552,811183524,811207533,24009,2430,275
811214766,811211738,811234481,22743,2431,275
811241718,811238691,811262384,23693,2432,275
811269639,811266610,811289649,23039,2433,275
811296860,811293833,811319446,25613,2434,275
811326672,811323645,811346999,23354,2435,275
811354287,811351260,811373981,22721,2436,275
811381192,811378166,811400909,22743,2437,275
811408133,811405105,811429429,24324,2438,275
811436678,811433651,811458292,24641,2439,275
811465671,811462427,811484414,21987,2440,275
811491793,811488549,811514696,26147,2441,275
811522076,811518832,811541771,22939,2442,275
811549057,811546030,811577298,31268,2443,275
811584677,811581433,811605025,23592,2444,275
811612404,811609160,811634041,24881,2445,275
811641316,811638290,811662615,24325,2446,275
811669905,811666878,811691204,24326,2447,275
811698583,811695339,811717646,22307,2448,275
811724947,811721920,811747194,25274,2449,275
811754506,811751479,811772935,21456,2450,275
811780173,811777145,811799572,22427,2451,275
811806952,811803707,811828546,24839,2452,275
811835925,811832681,811857562,24881,2453,275
811864800,811861773,811885149,23376,2454,275
811892313,811889284,811913175,23891,2455,275
811920554,811917310,811942486,25176,2456,275
811949740,811946712,811970385,23673,2457,275
811977638,811974610,811999570,24960,2458,275
812006949,812003705,812027616,23911,2459,275
812034995,812031751,812053423,21672,2460,275
812060802,812057558,812082439,24881,2461,275
812089708,812086681,812109719,23038,2462,275
812116961,812113934,812137942,24008,2463,275
812145169,812142142,812166152,24010,2464,275
812173424,812170397,812194406,24009,2465,275
812201706,812198679,812222688,24009,2466,275
812229981,812226954,812249991,23037,2467,275
812257243,812254217,812278522,24305,2468,275
812285902,812282657,812305280,22623,2469,275
812312497,812309470,812332192,22722,2470,275
812339463,812336435,812360446,24011,2471,275
812367824,812364581,812388785,24204,2472,275
812396163,812392920,812414909,21989,2473,275
812422197,812419170,812444783,25613,2474,275
812452043,812449015,812474945,25930,2475,275
812482324,812479081,812502672,23591,2476,275
812509898,812506871,812529908,23037,2477,275
812537157,812534130,812557169,23039,2478,275
812564466,812561439,812586082,24643,2479,275
812593461,812590217,812614442,24225,2480,275
812621821,812618577,812641199,22622,2481,275
812648440,812645413,812668155,22742,2482,275
812675534,812672290,812698752,26462,2483,275
812706001,812702974,812726034,23060,2484,275
812733338,812730310,812754319,24009,2485,275
812761700,812758454,812780128,21674,2486,275
812787379,812784351,812807094,22743,2487,275
812814386,812811359,812834734,23375,2488,275
812842112,812838868,812863749,24881,2489,275
812871058,812868032,812890456,22424,2490,275
812897836,812894591,812919155,24564,2491,275
812926365,812923338,812947348,24010,2492,275
812954627,812951600,812975948,24348,2493,275
812983206,812980179,813004821,24642,2494,275
813012049,813009022,813034318,25296,2495,275
813041697,813038453,813062995,24542,2496,275
813070373,813067129,813092009,24880,2497,275
813099387,813096143,813120686,24543,2498,275
813127925,813124897,813148887,23990,2499,275
813156145,813153117,813176810,23693,2500,275
813184097,813181070,813202210,21140,2501,275
813209373,813206345,813230571,24226,2502,275
813237733,813234706,813257961,23255,2503,275
813265248,813262221,813283359,21138,2504,275
813290614,813287586,813310941,23355,2505,275
813318234,813315208,813339217,24009,2506,275
813346469,813343442,813370004,26562,2507,275
813377239,813374212,813398537,24325,2508,275
813405916,813402672,813424977,22305,2509,275
813432356,813429112,813452368,23256,2510,275
813459747,813456503,813479757,23254,2511,275
813486964,813483936,813506342,22406,2512,275
813513621,813510593,813533950,23357,2513,275
813541176,813538149,813561208,23059,2514,275
813568586,813565343,813588911,23568,2515,275
813596290,813593046,813617589,24543,2516,275
813624802,813621774,813644835,23061,2517,275
813652212,813648969,813672877,23908,2518,275
813680159,813677131,813700487,23356,2519,275
813707789,813704761,813728139,23378,2520,275
813735423,813732396,813756090,23694,2521,275
813763470,813760225,813782531,22306,2522,275
813789786,813786759,813810748,23989,2523,275
813818033,813815005,813837750,22745,2524,275
813845029,813842001,813865694,23693,2525,275
813873072,813869829,813895025,25196,2526,275
813902334,813899306,813922999,23693,2527,275
813930228,813927202,813949923,22721,2528,275
813957301,813954058,813978261,24203,2529,275
813985564,813982536,814007179,24643,2530,275
814014408,814011381,814034420,23039,2531,275
814041667,814038640,814061700,23060,2532,275
814069078,814065835,814089089,23254,2533,275
814096468,814093224,814116816,23592,2534,275
814124193,814120951,814145808,24857,2535,275
814153055,814150028,814175640,25612,2536,275
814182804,814179776,814204002,24226,2537,275
814211381,814208137,814232026,23889,2538,275
814239405,814236161,814260704,24543,2539,275
814268082,814264839,814288115,23276,2540,275
814295417,814292390,814316081,23691,2541,275
814323459,814320216,814343807,23591,2542,275
814351185,814347942,814372168,24226,2543,275
814379450,814376423,814400749,24326,2544,275
814408056,814405029,814427455,22426,2545,275
814434710,814431683,814455037,23354,2546,275
814462347,814459320,814484299,24979,2547,275
814491527,814488498,814514747,26249,2548,275
814521910,814518882,814541525,22643,2549,275
814548804,814545777,814571706,25929,2550,275
814578927,814575900,814600246,24346,2551,275
814607471,814604443,814627819,23376,2552,275
814635198,814631954,814657467,25513,2553,275
814664756,814661729,814685422,23693,2554,275
814692650,814689623,814714920,25297,2555,275
814722299,814719055,814742332,23277,2556,275
814749626,814746599,814771895,25296,2557,275
814779111,814776084,814799460,23376,2558,275
814806839,814803595,814825267,21672,2559,275
814832645,814829402,814852677,23275,2560,275
814860057,814856812,814882327,25515,2561,275
814889582,814886554,814911197,24643,2562,275
814918469,814915442,814939451,24009,2563,275
814946675,814943648,814966686,23038,2564,275
814973901,814970875,814994229,23354,2565,275
815001525,814998497,815021873,23376,2566,275
815029253,815026008,815050552,24544,2567,275
815057931,815054688,815077627,22939,2568,275
815084848,815081820,815105197,23377,2569,275
815112577,815109333,815131955,22622,2570,275
815139265,815136236,815158643,22407,2571,275
815166021,815162778,815185737,22959,2572,275
815192992,815189964,815213973,24009,2573,275
815221230,815218203,815240609,22406,2574,275
815247988,815244744,815268654,23910,2575,275
815275944,815272916,815295955,23039,2576,275
815303237,815300210,815321032,20822,2577,275
815328411,815325167,815348105,22938,2578,275
815355484,815352240,815375811,23571,2579,275
815383053,815380027,815405638,25611,2580,275
815412930,815409903,815432941,23038,2581,275
815440321,815437077,815459381,22304,2582,275
815466658,815463631,815488252,24621,2583,275
815495541,815492514,815518128,25614,2584,275
815525292,815522264,815544254,21990,2585,275
815551634,815548390,815573567,25177,2586,275
815580948,815577703,815601613,23910,2587,275
815608901,815605873,815627647,21774,2588,275
815634870,815631843,815655536,23693,2589,275
815662915,815659671,815682611,22940,2590,275
815689840,815686813,815711454,24641,2591,275
815718834,815715590,815737579,21989,2592,275
815744887,815741860,815765552,23692,2593,275
815772834,815769806,815795082,25276,2594,275
815802461,815799218,815823127,23909,2595,275
815830506,815827263,815852122,24859,2596,275
815859368,815856340,815880371,24031,2597,275
815887617,815884590,815906679,22089,2598,275
815913841,815910814,815934723,23909,2599,275
815941886,815938859,815962767,23908,2600,275
815969988,815966961,815989703,22742,2601,275
815997082,815993838,816018675,24837,2602,275
816025964,816022937,816047242,24305,2603,275
816054622,816051378,816074950,23572,2604,275
816082328,816079085,816102023,22938,2605,275
816109404,816106159,816130387,24228,2606,275
816137766,816134522,816158728,24206,2607,275
816165975,816162947,816188222,25275,2608,275
816195469,816192441,816214848,22407,2609,275
816222087,816219060,816244336,25276,2610,275
816251583,816248554,816272565,24011,2611,275
816279945,816276701,816300632,23931,2612,275
816307854,816304826,816328539,23713,2613,275
816335919,816332674,816358505,25831,2614,275
816365885,816362641,816385262,22621,2615,275
816392543,816389515,816413843,24328,2616,275
816421122,816418095,816442420,24325,2617,275
816449800,816446555,816469198,22643,2618,275
816476411,816473384,816497077,23693,2619,275
816504458,816501213,816525440,24227,2620,275
816532724,816529695,816553053,23358,2621,275
816560290,816557264,816581589,24325,2622,275
816588800,816585773,816609149,23376,2623,275
816616444,816613417,816638081,24664,2624,275
816645351,816642323,816665383,23060,2625,275
816672762,816669518,816693744,24226,2626,275
816700999,816697972,816720692,22720,2627,275
816727912,816724885,816747289,22404,2628,275
816754668,816751424,816773096,21672,2629,275
816780335,816777306,816801001,23695,2630,275
816808380,816805137,816829995,24858,2631,275
816837375,816834130,816857725,23595,2632,275
816864970,816861942,816885319,23377,2633,275
816892609,816889581,816914879,25298,2634,275
816922115,816919088,816943098,24010,2635,275
816950389,816947362,816970083,22721,2636,275
816977340,816974311,816999610,25299,2637,275
817006990,817003746,817028626,24880,2638,275
817035885,817032857,817055895,23038,2639,275
817063274,817060031,817083602,23571,2640,275
817090838,817087810,817110239,22429,2641,275
817117619,817114375,817138284,23909,2642,275
817145496,817142469,817164559,22090,2643,275
817171938,817168694,817191337,22643,2644,275
817198616,817195588,817221202,25614,2645,275
817228419,817225391,817249402,24011,2646,275
817256635,817253608,817276983,23375,2647,275
817284248,817281220,817303944,22724,2648,275
817311223,817308196,817330601,22405,2649,275
817337834,817334807,817359132,24325,2650,275
817366421,817363394,817385503,22109,2651,275
817392882,817389638,817412914,23276,2652,275
817420223,817417195,817442491,25296,2653,275
817449870,817446626,817472456,25830,2654,275
817479836,817476592,817500816,24224,2655,275
817508048,817505021,817529686,24665,2656,275
817536926,817533899,817556642,22743,2657,275
817563806,817560778,817585004,24226,2658,275
817592384,817589140,817614632,25492,2659,275
817622011,817618767,817642021,23254,2660,275
817649256,817646228,817668632,22404,2661,275
817675842,817672814,817698110,25296,2662,275
817705387,817702360,817725736,23376,2663,275
817732965,817729938,817752996,23058,2664,275
817760375,817757131,817781357,24226,2665,275
817788618,817785589,817810548,24959,2666,275
817817855,817814829,817837865,23036,2667,275
817845147,817842119,817868345,26226,2668,275
817875576,817872550,817894638,22088,2669,275
817902017,817898773,817922999,24226,2670,275
817930243,817927216,817949620,22404,2671,275
817957000,817953755,817977982,24227,2672,275
817985195,817982166,818007466,25300,2673,275
818014845,818011601,818036440,24839,2674,275
818043820,818040576,818063514,22938,2675,275
818070801,818067773,818089864,22091,2676,275
818097171,818094142,818116886,22744,2677,275
818124156,818121129,818144167,23038,2678,275
818151442,818148416,818172424,24008,2679,275
818179686,818176658,818202270,25612,2680,275
818209648,818206405,818228710,22305,2681,275
818235943,818232916,818254055,21139,2682,275
818261349,818258321,818282648,24327,2683,275
818289955,818286927,818309353,22426,2684,275
818316640,818313613,818336651,23038,2685,275
818343934,818340906,818364599,23693,2686,275
818371843,818368816,818390587,21771,2687,275
818397967,818394722,818419265,24543,2688,275
818426517,818423490,818445579,22089,2689,275
818452959,818449715,818474258,24543,2690,275
818481639,818478394,818505194,26800,2691,275
818512477,818509450,818532805,23355,2692,275
818540054,818537026,818560720,23694,2693,275
818568101,818564856,818590688,25832,2694,275
818597916,818594887,818619214,24327,2695,275
818626594,818623350,818648210,24860,2696,275
818655438,818652410,818674818,22408,2697,275
818682110,818679083,818702142,23059,2698,275
818709406,818706378,818726885,20507,2699,275
818734265,818731020,818753032,22012,2700,275
818760413,818757168,818779496,22328,2701,275
818786706,818783679,818808027,24348,2702,275
818815303,818812276,818837550,25274,2703,275
818844930,818841686,818864623,22937,2704,275
818871847,818868820,818890592,21772,2705,275
818897872,818894844,818916934,22090,2706,275
818924143,818921117,818945146,24029,2707,275
818952420,818949393,818971820,22427,2708,275
818979108,818976081,819001378,25297,2709,275
819008610,819005583,819030562,24979,2710,275
819037942,819034698,819057341,22643,2711,275
819064721,819061477,819085046,23569,2712,275
819092316,819089288,819113931,24643,2713,275
819121179,819118152,819141528,23376,2714,275
819148788,819145761,819168799,23038,2715,275
819176049,819173021,819197348,24327,2716,275
819204728,819201484,819225371,23887,2717,275
819232609,819229582,819251353,21771,2718,275
819258664,819255637,819279647,24010,2719,275
819286808,819283781,819306403,22622,2720,275
819313636,819310609,819333667,23058,2721,275
819340932,819337905,819360330,22425,2722,275
819367619,819364591,819387945,23354,2723,275
819395224,819392196,819418779,26583,2724,275
819426019,819422992,819447949,24957,2725,275
819455329,819452084,819478887,26803,2726,275
819486096,819483068,819505474,22406,2727,275
819512735,819509708,819532133,22425,2728,275
819539382,819536355,819558759,22404,2729,275
819566020,819562993,819586347,23354,2730,275
819593727,819590482,819615658,25176,2731,275
819622949,819619922,819644245,24323,2732,275
819651488,819648461,819670548,22087,2733,275
819677775,819674748,819698736,23988,2734,275
819706116,819702871,819724859,21988,2735,275
819732088,819729060,819750831,21771,2736,275
819758135,819755108,819777194,22086,2737,275
819784573,819781329,819804288,22959,2738,275
819811668,819808423,819831362,22939,2739,275
819838740,819835497,819860690,25193,2740,275
819867983,819864956,819889280,24324,2741,275
819896659,819893415,819915404,21989,2742,275
819922701,819919673,819940814,21141,2743,275
819948192,819944949,819967569,22620,2744,275
819974947,819971704,819995613,23909,2745,275
820002825,819999796,820024122,24326,2746,275
820031501,820028257,820052145,23888,2747,275
820059445,820056417,820079140,22723,2748,275
820086518,820083275,820109419,26144,2749,275
820116582,820113555,820135228,21673,2750,275
820142447,820139419,820161213,21794,2751,275
820168476,820165449,820188804,23355,2752,275
820196083,820193055,820217360,24305,2753,275
820224662,820221633,820247228,25595,2754,275
820254441,820251413,820276708,25295,2755,275
820284018,820280989,820307238,26249,2756,275
820314617,820311374,820334965,23591,2757,275
820342191,820339163,820361251,22088,2758,275
820368507,820365480,820391387,25907,2759,275
820398625,820395597,820418974,23377,2760,275
820426236,820423209,820445952,22743,2761,275
820453332,820450087,820476233,26146,2762,275
820483478,820480451,820504776,24325,2763,275
820512154,820508911,820535709,26798,2764,275
820542957,820539930,820561068,21138,2765,275
820568447,820565203,820590717,25514,2766,275
820597940,820594913,820618942,24029,2767,275
820626320,820623077,820647619,24542,2768,275
820654997,820651754,820672793,21039,2769,275
820680084,820677057,820699484,22427,2770,275
820706797,820703769,820726512,22743,2771,275
820733737,820730709,820752481,21772,2772,275
820759794,820756767,820779488,22721,2773,275
820786745,820783717,820807410,23693,2774,275
820814789,820811545,820836426,24881,2775,275
820843805,820840561,820864470,23909,2776,275
820871689,820868662,820893008,24346,2777,275
820900283,820897255,820922216,24961,2778,275
820929456,820926429,820948854,22425,2779,275
820956155,820953128,820977790,24662,2780,275
820985082,820982054,821004778,22724,2781,275
821012158,821008913,821033458,24545,2782,275
821040766,821037739,821061115,23376,2783,275
821068351,821065323,821089331,24008,2784,275
821096710,821093466,821116742,23276,2785,275
821124018,821120991,821144979,23988,2786,275
821152218,821149190,821175120,25930,2787,275
821182392,821179365,821203056,23691,2788,275
821210435,821207191,821230446,23255,2789,275
821237726,821234699,821258055,23356,2790,275
821265350,821262322,821286945,24623,2791,275
821294325,821291080,821314674,23594,2792,275
821322053,821318809,821341135,22326,2793,275
821348391,821345364,821368740,23376,2794,275
821376027,821373000,821395741,22741,2795,275
821403024,821399996,821423055,23059,2796,275
821430273,821427245,821451255,24010,2797,275
821458551,821455525,821478583,23058,2798,275
821485963,821482718,821507895,25177,2799,275
821515274,821512030,821534336,22306,2800,275
821541615,821538587,821561331,22744,2801,275
821568710,821565466,821592711,27245,2802,275
821599944,821596917,821620926,24009,2803,275
821628207,821625179,821650139,24960,2804,275
821657518,821654274,821679133,24859,2805,275
821686512,821683268,821706229,22961,2806,275
821713390,821710364,821736509,26145,2807,275
821743889,821740645,821765208,24563,2808,275
821772586,821769343,821793569,24226,2809,275
821800777,821797749,821823340,25591,2810,275
821830586,821827558,821852835,25277,2811,275
821860213,821856970,821881829,24859,2812,275
821889095,821886067,821908473,22406,2813,275
821915782,821912754,821936427,23673,2814,275
821943648,821940620,821962393,21773,2815,275
821969771,821966528,821989782,23254,2816,275
821997161,821993917,822014957,21040,2817,275
822022337,822019092,822043001,23909,2818,275
822050238,822047210,822069954,22744,2819,275
822077333,822074089,822097050,22961,2820,275
822104319,822101293,822123381,22088,2821,275
822130672,822127645,822151654,24009,2822,275
822159033,822155789,822177800,22011,2823,275
822185087,822182060,822206385,24325,2824,275
822213764,822210520,822234747,24227,2825,275
822241961,822238934,822262648,23714,2826,275
822270026,822266783,822289405,22622,2827,275
822296693,822293666,822317676,24010,2828,275
822324963,822321936,822345628,23692,2829,275
822352934,822349906,822373599,23693,2830,275
822380761,822377734,822401011,23277,2831,275
822408391,822405146,822429690,24544,2832,275
822437000,822433973,822457328,23355,2833,275
822464598,822461571,822487185,25614,2834,275
822494496,822491469,822514191,22722,2835,275
822521422,822518395,822540821,22426,2836,275
822548080,822545053,822567457,22404,2837,275
822574749,822571722,822593810,22088,2838,275
822601032,822598005,822622965,24960,2839,275
822630218,822627192,822649597,22405,2840,275
822656976,822653732,822677959,24227,2841,275
822685337,822682094,822705052,22958,2842,275
822712431,822709187,822732779,23592,2843,275
822740159,822736915,822761774,24859,2844,275
822768989,822765960,822790288,24328,2845,275
822797666,822794423,822817380,22957,2846,275
822824685,822821658,822845033,23375,2847,275
822852320,822849293,822873619,24326,2848,275
822880998,822877754,822902276,24522,2849,275
822909655,822906411,822931903,25492,2850,275
822939121,822936094,822959153,23059,2851,275
822966316,822963288,822987494,24206,2852,275
822994754,822991727,823013183,21456,2853,275
823020562,823017318,823040594,23276,2854,275
823047854,823044826,823069448,24622,2855,275
823076827,823073583,823096544,22961,2856,275
823103925,823100680,823124274,23594,2857,275
823131438,823128410,823154873,26463,2858,275
823162253,823159009,823185494,26485,2859,275
823192656,823189630,823212905,23275,2860,275
823220208,823217182,823240873,23691,2861,275
823248111,823245084,823270042,24958,2862,275
823277354,823274327,823298970,24643,2863,275
823306206,823303177,823327820,24643,2864,275
823335033,823332007,823354727,22720,2865,275
823361967,823358939,823383581,24642,2866,275
823390825,823387798,823412122,24324,2867,275
823419500,823416257,823440167,23910,2868,275
823447546,823444302,823469161,24859,2869,275
823476539,823473296,823497837,24541,2870,275
823505102,823502075,823525766,23691,2871,275
823533060,823530033,823554042,24009,2872,275
823561296,823558270,823583566,25296,2873,275
823590945,823587701,823611927,24226,2874,275
823619208,823616179,823637636,21457,2875,275
823644941,823641915,823664655,22740,2876,275
823671900,823668873,823692566,23693,2877,275
823699945,823696701,823721243,24542,2878,275
823728622,823725378,823749584,24206,2879,275
823756854,823753826,823775938,22112,2880,275
823783206,823780178,823801318,21140,2881,275
823808697,823805453,823828414,22961,2882,275
823835792,823832549,823856753,24204,2883,275
823863960,823860933,823885914,24981,2884,275
823893293,823890049,823914275,24226,2885,275
823921529,823918501,823940927,22426,2886,275
823948209,823945180,823967271,22091,2887,275
823974553,823971526,823992980,21454,2888,275
824000359,823997115,824020686,23571,2889,275
824027986,824024959,824050235,25276,2890,275
824057469,824054442,824079084,24642,2891,275
824086335,824083307,824107951,24644,2892,275
824115330,824112086,824133442,21356,2893,275
824140821,824137577,824161487,23910,2894,275
824168799,824165772,824189781,24009,2895,275
824197027,824193999,824217376,23377,2896,275
824224657,824221631,824247559,25928,2897,275
824254781,824251754,824274791,23037,2898,275
824282170,824278926,824305389,26463,2899,275
824312769,824309525,824333436,23911,2900,275
824340723,824337696,824361052,23356,2901,275
824368357,824365330,824389339,24009,2902,275
824396592,824393565,824418524,24959,2903,275
824425902,824422659,824444014,21355,2904,275
824451391,824448149,824470768,22619,2905,275
824478021,824474991,824496767,21776,2906,275
824504051,824501024,824523427,22403,2907,275
824530805,824527562,824552420,24858,2908,275
824559582,824556555,824580463,23908,2909,275
824587841,824584598,824607241,22643,2910,275
824614620,824611376,824634336,22960,2911,275
824641576,824638549,824661587,23038,2912,275
824668965,824665722,824687393,21671,2913,275
824694772,824691528,824713855,22327,2914,275
824721092,824718065,824743678,25613,2915,275
824750913,824747886,824769974,22088,2916,275
824777205,824774177,824796583,22406,2917,275
824803815,824800787,824823193,22406,2918,275
824830447,824827419,824852062,24643,2919,275
824859363,824856336,824878424,22088,2920,275
824885685,824882658,824904428,21770,2921,275
824911740,824908712,824934325,25613,2922,275
824941607,824938578,824960035,21457,2923,275
824967339,824964312,824988638,24326,2924,275
824996017,824992773,825014445,21672,2925,275
825021823,825018580,825044408,25828,2926,275
825051687,825048661,825073303,24642,2927,275
825080531,825077504,825101830,24326,2928,275
825109050,825106022,825128745,22723,2929,275
825136036,825133009,825155751,22742,2930,275
825162976,825159949,825184929,24980,2931,275
825192160,825189133,825213122,23989,2932,275
825220500,825217257,825242768,25511,2933,275
825250148,825246903,825270794,23891,2934,275
825278099,825275071,825296211,21140,2935,275
825303460,825300433,825323156,22723,2936,275
825330388,825327360,825350082,22722,2937,275
825357461,825354217,825376837,22620,2938,275
825384133,825381105,825404483,23378,2939,275
825411789,825408762,825431167,22405,2940,275
825438405,825435376,825458120,22744,2941,275
825465330,825462302,825483759,21457,2942,275
825491010,825487983,825511042,23059,2943,275
825518421,825515177,825538433,23256,2944,275
825545709,825542682,825565108,22426,2945,275
825572487,825569244,825592182,22938,2946,275
825599480,825596452,825618880,22428,2947,275
825626259,825623015,825645975,22960,2948,275
825653354,825650110,825675285,25175,2949,275
825682665,825679420,825701092,21672,2950,275
825708471,825705227,825729454,24227,2951,275
825736834,825733589,825759102,25513,2952,275
825766481,825763237,825787779,24542,2953,275
825795029,825792002,825815378,23376,2954,275
825822758,825819513,825842789,23276,2955,275
825850070,825847042,825871347,24305,2956,275
825878629,825875601,825897690,22089,2957,275
825905002,825901975,825925984,24009,2958,275
825933279,825930252,825956836,26584,2959,275
825964062,825961035,825985361,24326,2960,275
825992586,825989557,826013567,24010,2961,275
826020798,826017771,826038593,20822,2962,275
826045972,826042728,826067606,24878,2963,275
826074831,826071802,826095495,23693,2964,275
826102751,826099723,826122446,22723,2965,275
826129825,826126581,826149521,22940,2966,275
826156900,826153656,826176595,22939,2967,275
826183837,826180809,826206105,25296,2968,275
826213407,826210380,826232786,22406,2969,275
826240075,826237047,826260741,23694,2970,275
826268003,826264975,826287066,22091,2971,275
826294352,826291324,826315334,24010,2972,275
826322628,826319602,826342324,22722,2973,275
826349553,826346524,826371190,24666,2974,275
826378568,826375325,826398896,23571,2975,275
826406275,826403031,826425358,22327,2976,275
826432644,826429616,826453309,23693,2977,275
826460575,826457548,826481556,24008,2978,275
826488936,826485691,826509919,24228,2979,275
826517298,826514054,826538913,24859,2980,275
826546135,826543107,826564564,21457,2981,275
826571839,826568811,826593455,24644,2982,275
826600690,826597661,826620069,22408,2983,275
826627447,826624204,826647163,22959,2984,275
826654432,826651404,826674442,23038,2985,275
826681822,826678577,826703142,24565,2986,275
826710521,826707277,826733106,25829,2987,275
826740346,826737319,826760379,23060,2988,275
826767758,826764514,826789056,24542,2989,275
826796292,826793264,826817295,24031,2990,275
826824547,826821520,826842343,20823,2991,275
826849631,826846605,826867744,21139,2992,275
826875123,826871879,826896402,24523,2993,275
826903680,826900653,826926267,25614,2994,275
826933430,826930403,826953047,22644,2995,275
826960426,826957182,826980438,23256,2996,275
826987818,826984574,827006879,22305,2997,275
827014258,827011015,827035896,24881,2998,275
827043130,827040103,827064407,24304,2999,275
827071685,827068658,827091718,23060,3000,275
827098968,827095940,827119613,23673,3001,275
827126992,827123748,827148923,25175,3002,275
827156215,827153187,827178485,25298,3003,275
827185728,827182700,827207027,24327,3004,275
827214405,827211162,827235071,23909,3005,275
827242286,827239259,827264218,24959,3006,275
827271450,827268423,827292115,23692,3007,275
827299494,827296250,827317921,21671,3008,275
827325205,827322178,827343632,21454,3009,275
827350920,827347893,827372199,24306,3010,275
827379579,827376335,827400223,23888,3011,275
827407602,827404358,827429555,25197,3012,275
827436788,827433761,827455849,22088,3013,275
827463126,827460099,827485395,25296,3014,275
827492624,827489596,827514557,24961,3015,275
827521806,827518778,827542473,23695,3016,275
827549711,827546684,827571622,24938,3017,275
827578868,827575841,827598564,22723,3018,275
827605802,827602775,827624546,21771,3019,275
827631923,827628681,827653222,24541,3020,275
827660521,827657493,827682454,24961,3021,275
827689709,827686682,827711639,24957,3022,275
827718892,827715865,827740508,24643,3023,275
827747671,827744643,827769504,24861,3024,275
827776882,827773639,827797548,23909,3025,275
827804823,827801797,827824519,22722,3026,275
827831783,827828755,827851478,22723,3027,275
827858695,827855667,827875856,20189,3028,275
827883144,827880116,827902522,22406,3029,275
827909903,827906658,827928649,21991,3030,275
827936027,827932784,827955089,22305,3031,275
827962470,827959225,827983452,24227,3032,275
827990832,827987588,828011794,24206,3033,275
828019174,828015929,828040472,24543,3034,275
828047852,828044608,828067231,22623,3035,275
828074610,828071367,828094304,22937,3036,275
828101545,828098518,828123498,24980,3037,275
828130749,828127722,828151709,23987,3038,275
828158918,828155891,828180216,24325,3039,275
828187474,828184448,828209088,24640,3040,275
828216391,828213363,828236084,22721,3041,275
828243337,828240310,828263054,22744,3042,275
828270279,828267251,828289974,22723,3043,275
828297354,828294109,828318654,24545,3044,275
828326034,828322789,828347017,24228,3045,275
828354397,828351153,828374092,22939,3046,275
828381473,828378228,828402136,23908,3047,275
828409404,828406377,828429415,23038,3048,275
828436708,828433680,828456402,22722,3049,275
828463654,828460626,828485269,24643,3050,275
828492494,828489467,828511240,21773,3051,275
828518619,828515375,828537680,22305,3052,275
828544910,828541883,828565576,23693,3053,275
828572785,828569758,828595372,25614,3054,275
828602660,828599633,828622989,23356,3055,275
828630255,828627227,828649317,22090,3056,275
828656528,828653500,828675907,22407,3057,275
828683161,828680134,828705091,24957,3058,275
828712313,828709285,828731693,22408,3059,275
828738929,828735901,828758960,23059,3060,275
828766223,828763196,828787204,24008,3061,275
828794424,828791397,828813802,22405,3062,275
828821181,828817937,828840242,22305,3063,275
828847481,828844454,828868464,24010,3064,275
828875695,828872667,828897648,24981,3065,275
828904868,828901840,828922029,20189,3066,275
828929271,828926245,828948649,22404,3067,275
828955904,828952876,828977857,24981,3068,275
828985081,828982052,829004458,22406,3069,275
829011719,829008692,829032386,23694,3070,275
829039690,829036663,829058435,21772,3071,275
829065713,829062685,829084773,22088,3072,275
829092023,829088996,829110136,21140,3073,275
829117355,829114328,829136416,22088,3074,275
829143797,829140551,829164146,23595,3075,275
829171444,829168417,829192129,23712,3076,275
829199418,829196390,829220738,24348,3077,275
829228050,829225023,829246477,21454,3078,275
829253855,829250612,829273571,22959,3079,275
829280800,829277773,829299229,21456,3080,275
829306484,829303455,829325546,22091,3081,275
829332774,829329747,829353102,23355,3082,275
829360480,829357237,829381779,24542,3083,275
829389159,829385915,829408242,22327,3084,275
829415494,829412466,829435188,22722,3085,275
829442428,829439400,829463073,23673,3086,275
829470356,829467329,829490705,23376,3087,275
829498084,829494840,829517146,22306,3088,275
829524417,829521390,829546031,24641,3089,275
829553410,829550166,829572472,22306,3090,275
829579747,829576719,829600750,24031,3091,275
829608129,829604885,829628794,23909,3092,275
829636004,829632975,829657283,24308,3093,275
829664662,829661418,829687566,26148,3094,275
829694946,829691702,829715272,23570,3095,275
829722493,829719465,829741871,22406,3096,275
829749121,829746094,829767233,21139,3097,275
829774612,829771368,829795594,24226,3098,275
829802820,829799793,829823169,23376,3099,275
829830468,829827441,829849530,22089,3100,275
829856786,829853758,829876481,22723,3101,275
829883860,829880616,829904841,24225,3102,275
829912220,829908976,829933181,24205,3103,275
829940560,829937316,829962829,25513,3104,275
829970208,829966964,829991188,24224,3105,275
829998474,829995448,830016904,21456,3106,275
830024136,830021109,830045751,24642,3107,275
830052985,830049957,830075888,25931,3108,275
830083122,830080095,830104757,24662,3109,275
830111983,830108956,830133598,24642,3110,275
830140830,830137802,830161474,23672,3111,275
830168740,830165712,830191958,26246,3112,275
830199234,830196208,830219582,23374,3113,275
830226961,830223717,830248555,24838,3114,275
830255773,830252745,830273884,21139,3115,275
830281264,830278020,830300960,22940,3116,275
830308339,830305095,830327084,21989,3117,275
830334320,830331293,830353719,22426,3118,275
830361017,830357991,830383264,25273,3119,275
830390643,830387400,830407805,20405,3120,275
830415184,830411940,830434562,22622,3121,275
830441801,830438774,830462466,23692,3122,275
830469744,830466716,830492646,25930,3123,275
830499942,830496913,830521240,24327,3124,275
830528477,830525449,830547538,22089,3125,275
830554766,830551738,830574796,23058,3126,275
830582013,830578987,830602995,24008,3127,275
830610303,830607276,830630313,23037,3128,275
830637557,830634530,830658223,23693,3129,275
830665528,830662501,830687144,24643,3130,275
830694524,830691279,830713901,22622,3131,275
830721282,830718037,830741293,23256,3132,275
830748552,830745525,830771454,25929,3133,275
830778833,830775590,830799815,24225,3134,275
830807060,830804033,830828042,24009,3135,275
830835343,830832315,830856959,24644,3136,275
830864338,830861095,830885004,23909,3137,275
830892383,830889139,830912416,23277,3138,275
830919637,830916610,830939331,22721,3139,275
830946621,830943593,830966336,22743,3140,275
830973716,830970472,830995333,24861,3141,275
831002715,830999469,831020511,21042,3142,275
831027747,831024720,831049679,24959,3143,275
831056893,831053865,831077558,23693,3144,275
831084937,831081694,831105286,23592,3145,275
831112516,831109488,831133181,23693,3146,275
831140422,831137394,831159485,22091,3147,275
831166745,831163717,831186123,22406,3148,275
831193503,831190258,831213218,22960,3149,275
831220598,831217354,831238393,21039,3150,275
831245774,831242529,831268044,25515,3151,275
831275424,831272179,831297357,25178,3152,275
831304736,831301492,831324135,22643,3153,275
831331515,831328271,831350260,21989,3154,275
831357640,831354395,831376386,21991,3155,275
831383765,831380521,831404432,23911,3156,275
831411811,831408567,831433742,25175,3157,275
831441121,831437878,831461788,23910,3158,275
831469080,831466053,831490064,24011,3159,275
831497226,831494199,831516505,22306,3160,275
831523737,831520710,831544720,24010,3161,275
831552099,831548855,831587644,38789,3162,275
831594941,831591912,831616893,24981,3163,275
831624273,831621028,831644305,23277,3164,275
831651554,831648527,831669667,21140,3165,275
831676898,831673870,831697247,23377,3166,275
831704540,831701512,831726155,24643,3167,275
831733317,831730290,831754199,23909,3168,275
831761435,831758408,831784317,25909,3169,275
831791697,831788453,831812973,24520,3170,275
831820353,831817109,831841968,24859,3171,275
831849130,831846103,831870646,24543,3172,275
831878026,831874782,831895820,21038,3173,275
831903043,831900016,831922421,22405,3174,275
831929801,831926557,831950467,23910,3175,275
831957687,831954659,831977382,22723,3176,275
831984672,831981645,832004999,23354,3177,275
832012259,832009231,832034168,24937,3178,275
832041479,832038452,832059590,21138,3179,275
832066970,832063725,832087319,23594,3180,275
832094482,832091454,832115703,24249,3181,275
832122997,832119969,832144930,24961,3182,275
832152210,832149182,832174457,25275,3183,275
832181758,832178732,832201158,22426,3184,275
832208409,832205382,832228104,22722,3185,275
832235482,832232239,832258067,25828,3186,275
832265342,832262315,832287589,25274,3187,275
832294894,832291867,832316509,24642,3188,275
832323770,832320744,832344119,23375,3189,275
832351392,832348364,832371720,23356,3190,275
832379098,832375855,832400714,24859,3191,275
832408016,832404989,832429949,24960,3192,275
832437329,832434084,832458945,24861,3193,275
832466325,832463080,832485070,21990,3194,275
832492290,832489263,832514876,25613,3195,275
832522154,832519127,832541215,22088,3196,275
832548438,832545410,832570051,24641,3197,275
832577430,832574186,832596513,22327,3198,275
832603821,832600793,832624169,23376,3199,275
832631455,832628427,832653386,24959,3200,275
832660766,832657521,832679532,22011,3201,275
832686811,832683784,832706842,23058,3202,275
832714131,832711103,832734797,23694,3203,275
832742008,832738980,832761702,22722,3204,275
832768990,832765962,832789972,24010,3205,275
832797350,832794107,832818017,23910,3206,275
832825233,832822206,832845899,23693,3207,275
832853278,832850034,832875210,25176,3208,275
832882589,832879345,832902938,23593,3209,275
832910217,832907189,832930882,23693,3210,275
832938262,832935017,832961144,26127,3211,275
832968405,832965378,832988731,23353,3212,275
832996111,832992866,833016142,23276,3213,275
833023426,833020398,833042826,22428,3214,275
833050107,833047080,833069823,22743,3215,275
833077203,833073958,833098186,24228,3216,275
833105484,833102457,833125833,23376,3217,275
833133073,833130046,833152135,22089,3218,275
833159516,833156270,833181469,25199,3219,275
833188847,833185604,833210167,24563,3220,275
833217409,833214381,833239004,24623,3221,275
833246307,833243279,833267607,24328,3222,275
833274880,833271852,833294912,23060,3223,275
833302291,833299047,833319771,20724,3224,275
833327021,833323994,833348320,24326,3225,275
833355598,833352570,833378501,25931,3226,275
833385796,833382768,833406144,23376,3227,275
833413397,833410370,833434379,24009,3228,275
833441759,833438514,833463394,24880,3229,275
833470617,833467589,833492570,24981,3230,275
833499875,833496848,833521194,24346,3231,275
833528574,833525330,833547320,21990,3232,275
833554555,833551527,833574271,22744,3233,275
833581506,833578479,833601518,23039,3234,275
833608737,833605709,833628747,23038,3235,275
833636126,833632883,833656158,23275,3236,275
833663537,833660293,833685785,25492,3237,275
833693164,833689920,833713491,23571,3238,275
833720870,833717626,833741852,24226,3239,275
833749078,833746051,833770377,24326,3240,275
833777625,833774597,833797636,23039,3241,275
833804902,833801875,833824934,23059,3242,275
833832314,833829069,833852642,23573,3243,275
833859954,833856926,833880281,23355,3244,275
833887660,833884416,833906406,21990,3245,275
833913644,833910616,833935281,24665,3246,275
833942541,833939514,833960334,20820,3247,275
833967712,833964469,833988693,24224,3248,275
833995934,833992906,834014995,22089,3249,275
834022374,834019130,834044622,25492,3250,275
834051907,834048880,834071918,23038,3251,275
834079202,834076175,834101768,25593,3252,275
834109147,834105903,834127258,21355,3253,275
834134492,834131465,834153554,22089,3254,275
834160781,834157753,834181426,23673,3255,275
834188658,834185630,834208374,22744,3256,275
834215599,834212572,834236263,23691,3257,275
834243556,834240529,834266142,25613,3258,275
834273522,834270278,834292603,22325,3259,275
834299836,834296808,834320184,23376,3260,275
834327446,834324419,834346530,22111,3261,275
834353909,834350666,834373308,22642,3262,275
834380687,834377443,834401036,23593,3263,275
834408289,834405262,834427034,21772,3264,275
834434268,834431241,834455568,24327,3265,275
834462949,834459704,834482644,22940,3266,275
834489856,834486830,834510817,23987,3267,275
834518197,834514953,834537893,22940,3268,275
834545161,834542134,834565489,23355,3269,275
834572728,834569700,834590524,20824,3270,275
834597805,834594777,834618787,24010,3271,275
834626166,834622922,834644911,21989,3272,275
834652213,834649186,834670958,21772,3273,275
834678210,834675183,834699193,24010,3274,275
834706573,834703328,834725973,22645,3275,275
834733205,834730179,834754503,24324,3276,275
834761760,834758732,834783376,24644,3277,275
834790756,834787512,834810471,22959,3278,275
834817849,834814606,834838515,23909,3279,275
834845895,834842651,834864639,21988,3280,275
834872017,834868774,834892683,23909,3281,275
834900063,834896818,834922016,25198,3282,275
834929396,834926151,834951328,25177,3283,275
834958541,834955513,834978890,23377,3284,275
834986269,834983025,835006301,23276,3285,275
835013681,835010436,835035297,24861,3286,275
835042676,835039433,835061421,21988,3287,275
835068801,835065557,835089446,23889,3288,275
835096827,835093581,835119076,25495,3289,275
835126316,835123289,835146666,23377,3290,275
835153963,835150936,835173657,22721,3291,275
835180883,835177857,835199627,21770,3292,275
835207006,835203762,835225434,21672,3293,275
835232717,835229690,835255303,25613,3294,275
835262683,835259439,835280794,21355,3295,275
835288069,835285041,835308102,23061,3296,275
835315335,835312308,835336971,24663,3297,275
835344192,835341164,835366461,25297,3298,275
835373757,835370730,835394719,23989,3299,275
835401937,835398909,835420682,21773,3300,275
835427927,835424899,835446039,21140,3301,275
835453319,835450292,835475903,25611,3302,275
835483183,835480156,835505432,25276,3303,275
835512684,835509657,835532380,22723,3304,275
835539619,835536592,835558047,21455,3305,275
835565342,835562314,835586008,23694,3306,275
835593290,835590262,835614273,24011,3307,275
835621523,835618496,835643476,24980,3308,275
835650855,835647611,835674074,26463,3309,275
835681328,835678300,835701677,23377,3310,275
835708921,835705894,835727665,21771,3311,275
835734954,835731927,835756548,24621,3312,275
835763773,835760745,835782517,21772,3313,275
835789740,835786713,835810068,23355,3314,275
835817446,835814203,835836192,21989,3315,275
835843571,835840327,835865503,25176,3316,275
835872794,835869766,835895696,25930,3317,275
835902969,835899942,835924900,24958,3318,275
835932279,835929035,835952946,23911,3319,275
835960216,835957189,835981198,24009,3320,275
835988575,835985333,836008291,22958,3321,275
836015584,836012557,836034012,21455,3322,275
836041290,836038262,836062272,24010,3323,275
836069584,836066557,836087696,21139,3324,275
836094908,836091881,836115891,24010,3325,275
836123122,836120095,836143155,23060,3326,275
836150385,836147357,836169129,21772,3327,275
836176372,836173344,836199590,26246,3328,275
836206881,836203855,836227842,23987,3329,275
836235128,836232100,836254823,22723,3330,275
836262050,836259022,836282398,23376,3331,275
836289626,836286600,836311896,25296,3332,275
836319153,836316125,836339503,23378,3333,275
836346797,836343769,836367779,24010,3334,275
836374993,836371967,836394054,22087,3335,275
836401432,836398189,836422097,23908,3336,275
836429318,836426290,836451588,25298,3337,275
836458824,836455798,836477252,21454,3338,275
836484540,836481513,836510101,28588,3339,275
836517325,836514296,836538919,24623,3340,275
836546132,836543105,836564875,21770,3341,275
836572084,836569056,836592749,23693,3342,275
836600129,836596884,836619506,22622,3343,275
836626885,836623641,836649786,26145,3344,275
836657166,836653922,836678149,24227,3345,275
836685423,836682395,836706069,23674,3346,275
836713332,836710305,836736235,25930,3347,275
836743498,836740471,836763846,23375,3348,275
836771126,836768098,836794682,26584,3349,275
836801969,836798942,836822952,24010,3350,275
836830240,836827213,836852508,25295,3351,275
836859752,836856724,836880101,23377,3352,275
836887329,836884301,836905759,21458,3353,275
836913138,836909894,836933149,23255,3354,275
836940529,836937284,836960560,23276,3355,275
836967940,836964695,836987003,22308,3356,275
836994383,836991138,837015049,23911,3357,275
837022342,837019315,837044253,24938,3358,275
837051514,837048487,837073130,24643,3359,275
837080380,837077353,837100413,23060,3360,275
837107642,837104615,837128604,23989,3361,275
837135983,837132739,837154094,21355,3362,275
837161383,837158356,837181731,23375,3363,275
837189110,837185866,837209142,23276,3364,275
837216386,837213359,837236736,23377,3365,275
837243958,837240931,837264308,23377,3366,275
837271690,837268443,837290433,21990,3367,275
837297721,837294695,837320625,25930,3368,275
837328005,837324761,837347700,22939,3369,275
837354938,837351911,837375287,23376,3370,275
837382666,837379422,837403964,24542,3371,275
837411243,837408215,837430008,21793,3372,275
837437386,837434143,837458368,24225,3373,275
837465747,837462503,837487047,24544,3374,275
837494426,837491182,837514121,22939,3375,275
837521364,837518338,837541691,23353,3376,275
837549070,837545827,837570075,24248,3377,275
837577293,837574266,837599563,25297,3378,275
837606842,837603815,837627171,23356,3379,275
837634435,837631406,837652546,21140,3380,275
837659804,837656776,837680764,23988,3381,275
837688007,837684980,837708335,23355,3382,275
837715623,837712596,837737893,25297,3383,275
837745272,837742028,837763383,21355,3384,275
837770610,837767581,837789355,21774,3385,275
837796590,837793562,837818860,25298,3386,275
837826240,837822995,837844986,21991,3387,275
837852263,837849234,837874512,25278,3388,275
837881790,837878763,837900536,21773,3389,275
837907916,837904671,837930502,25831,3390,275
837937726,837934699,837958391,23692,3391,275
837965661,837962633,837988227,25594,3392,275
837995453,837992427,838015803,23376,3393,275
838023181,838019938,838042896,22958,3394,275
838050178,838047150,838069241,22091,3395,275
838076621,838073376,838098553,25177,3396,275
838105817,838102790,838126799,24009,3397,275
838134178,838130935,838154526,23591,3398,275
838161766,838158738,838182094,23356,3399,275
838189397,838186369,838209429,23060,3400,275
838216809,838213565,838237159,23594,3401,275
838244422,838241393,838267007,25614,3402,275
838274292,838271265,838295930,24665,3403,275
838303160,838300133,838322537,22404,3404,275
838329822,838326795,838350170,23375,3405,275
838357548,838354305,838378191,23886,3406,275
838385571,838382327,838404317,21990,3407,275
838411699,838408453,838433313,24860,3408,275
838440586,838437560,838459668,22108,3409,275
838467048,838463803,838488346,24543,3410,275
838495590,838492562,838517543,24981,3411,275
838524850,838521823,838544228,22405,3412,275
838551607,838548363,838569718,21355,3413,275
838577097,838573853,838597107,23254,3414,275
838604487,838601243,838622598,21355,3415,275
838629817,838626789,838650166,23377,3416,275
838657418,838654391,838677114,22723,3417,275
838684385,838681358,838702815,21457,3418,275
838710091,838707062,838731073,24011,3419,275
838738452,838735209,838757196,21987,3420,275
838764479,838761452,838786094,24642,3421,275
838793375,838790347,838815010,24663,3422,275
838822391,838819146,838841453,22307,3423,275
838848679,838845652,838869344,23692,3424,275
838876648,838873620,838895709,22089,3425,275
838903087,838899843,838923750,23907,3426,275
838930991,838927964,838951339,23375,3427,275
838958718,838955474,838978729,23255,3428,275
838985940,838982912,839005952,23040,3429,275
839013331,839010087,839031759,21672,3430,275
839039138,839035894,839059148,23254,3431,275
839066447,839063418,839088398,24980,3432,275
839095642,839092615,839115675,23060,3433,275
839122957,839119930,839145838,25908,3434,275
839153218,839149974,839172300,22326,3435,275
839179679,839176435,839200640,24205,3436,275
839208020,839204775,839229001,24226,3437,275
839236246,839233220,839254991,21771,3438,275
839262233,839259206,839281926,22720,3439,275
839289306,839286061,839308703,22642,3440,275
839316082,839312838,839335778,22940,3441,275
839343024,839339997,839362740,22743,3442,275
839370018,839366991,839391317,24326,3443,275
839398623,839395596,839419604,24008,3444,275
839426983,839423739,839449569,25830,3445,275
839456950,839453705,839478248,24543,3446,275
839485628,839482383,839505004,22621,3447,275
839512241,839509214,839532252,23038,3448,275
839539633,839536387,839562537,26150,3449,275
839569916,839566672,839590245,23573,3450,275
839597624,839594380,839617953,23573,3451,275
839625331,839622088,839646312,24224,3452,275
839653530,839650502,839677066,26564,3453,275
839684320,839681293,839703698,22405,3454,275
839710940,839707913,839729051,21138,3455,275
839736342,839733315,839757007,23692,3456,275
839764386,839761142,839784078,22936,3457,275
839791354,839788328,839810731,22403,3458,275
839818019,839814992,839839634,24642,3459,275
839847014,839843769,839865759,21990,3460,275
839873138,839869894,839895069,25175,3461,275
839902360,839899332,839923025,23693,3462,275
839930404,839927160,839949803,22643,3463,275
839957181,839953937,839977191,23254,3464,275
839984466,839981439,840004498,23059,3465,275
840011707,840008680,840031738,23058,3466,275
840039046,840036017,840059394,23377,3467,275
840066682,840063655,840087663,24008,3468,275
840094939,840091911,840114023,22112,3469,275
840121403,840118158,840143652,25494,3470,275
840151031,840147787,840172666,24879,3471,275
840180045,840176801,840202947,26146,3472,275
840210191,840207164,840229591,22427,3473,275
840236752,840233726,840257951,24225,3474,275
840265208,840262179,840285874,23695,3475,275
840293253,840290009,840312948,22939,3476,275
840320111,840317083,840342575,25492,3477,275
840349953,840346710,840370303,23593,3478,275
840377567,840374540,840400787,26247,3479,275
840408166,840404922,840426593,21671,3480,275
840433755,840430728,840454637,23909,3481,275
840461879,840458851,840482227,23376,3482,275
840489606,840486362,840512825,26463,3483,275
840520068,840517041,840539128,22087,3484,275
840546413,840543385,840567076,23691,3485,275
840574454,840571211,840595773,24562,3486,275
840603058,840600032,840624039,24007,3487,275
840631261,840628234,840650005,21771,3488,275
840657229,840654201,840677894,23693,3489,275
840685056,840682029,840703384,21355,3490,275
840710763,840707519,840730795,23276,3491,275
840738174,840734930,840757551,22621,3492,275
840764930,840761686,840784624,22938,3493,275
840791786,840788759,840813301,24542,3494,275
840820574,840817547,840839953,22406,3495,275
840847116,840844088,840869601,25513,3496,275
840876982,840873736,840895410,21674,3497,275
840902643,840899616,840924259,24643,3498,275
840931563,840928536,840951892,23356,3499,275
840959191,840956164,840979540,23376,3500,275
840986703,840983675,841011723,28048,3501,275
841018989,841015963,841039969,24006,3502,275
841047349,841044104,841069280,25176,3503,275
841076505,841073477,841099722,26245,3504,275
841107102,841103857,841129349,25492,3505,275
841136632,841133604,841156643,23039,3506,275
841163949,841160922,841183961,23039,3507,275
841191340,841188096,841213272,25176,3508,275
841220489,841217462,841240205,22743,3509,275
841247496,841244469,841267844,23375,3510,275
841275078,841272049,841297327,25278,3511,275
841304631,841301603,841324663,23060,3512,275
841331955,841328926,841352916,23990,3513,275
841360222,841357195,841380571,23376,3514,275
841387802,841384774,841410685,25911,3515,275
841417923,841414894,841437639,22745,3516,275
841444800,841441774,841464393,22619,3517,275
841471772,841468528,841499887,31359,3518,275
841507267,841504023,841526961,22938,3519,275
841534208,841531180,841554558,23378,3520,275
841561814,841558787,841581825,23038,3521,275
841589033,841586005,841608748,22743,3522,275
841615993,841612965,841633788,20823,3523,275
841641072,841638044,841661399,23355,3524,275
841668779,841665534,841688790,23256,3525,275
841696168,841692925,841718122,25197,3526,275
841725353,841722326,841746632,24306,3527,275
841753872,841750846,841773567,22721,3528,275
841780833,841777806,841800526,22720,3529,275
841807752,841804725,841827130,22405,3530,275
841834370,841831343,841853749,22406,3531,275
841860959,841857932,841879703,21771,3532,275
841886911,841883884,841906605,22721,3533,275
841913848,841910821,841933246,22425,3534,275
841940538,841937510,841961519,24009,3535,275
841968774,841965747,841989123,23376,3536,275
841996502,841993258,842018116,24858,3537,275
842025372,842022345,842045067,22722,3538,275
842052318,842049290,842073320,24030,3539,275
842080599,842077572,842101559,23987,3540,275
842108807,842105780,842130107,24327,3541,275
842137350,842134322,842158648,24326,3542,275
842165925,842162899,842186907,24008,3543,275
842194126,842191097,842215086,23989,3544,275
842222349,842219321,842243964,24643,3545,275
842251343,842248099,842271672,23573,3546,275
842278943,842275916,842301192,25276,3547,275
842308424,842305395,842330988,25593,3548,275
842338289,842335262,842360537,25275,3549,275
842367916,842364672,842388580,23908,3550,275
842395798,842392770,842417392,24622,3551,275
842424771,842421527,842445118,23591,3552,275
842452337,842449309,842472666,23357,3553,275
842479903,842476875,842500253,23378,3554,275
842507493,842504465,842528159,23694,3555,275
842535409,842532382,842557340,24958,3556,275
842564719,842561475,842585384,23909,3557,275
842592764,842589519,842613092,23573,3558,275
842620338,842617310,842640667,23357,3559,275
842647959,842644932,842667653,22721,3560,275
842675032,842671788,842694747,22959,3561,275
842702032,842699005,842721727,22722,3562,275
842728966,842725938,842750582,24644,3563,275
842757961,842754717,842778627,23910,3564,275
842785886,842782859,842806847,23988,3565,275
842814226,842810982,842835842,24860,3566,275
842843136,842840108,842864435,24327,3567,275
842871814,842868570,842889925,21355,3568,275
842897230,842894204,842916290,22086,3569,275
842923540,842920513,842945156,24643,3570,275
842952537,842949291,842974153,24862,3571,275
842981437,842978411,843001471,23060,3572,275
843008850,843005606,843028544,22938,3573,275
843035777,843032748,843057094,24346,3574,275
843064473,843061229,843084168,22939,3575,275
843091547,843088303,843110924,22621,3576,275
843118144,843115118,843139442,24324,3577,275
843146665,843143638,843167965,24327,3578,275
843175251,843172224,843193680,21456,3579,275
843200918,843197890,843221899,24009,3580,275
843229118,843226090,843248496,22406,3581,275
843255741,843252713,843277039,24326,3582,275
843284418,843281174,843303479,22305,3583,275
843310718,843307692,843329780,22088,3584,275
843337160,843333915,843356559,22644,3585,275
843363786,843360759,843386057,25298,3586,275
843393435,843390192,843413130,22938,3587,275
843420443,843417416,843442058,24642,3588,275
843449436,843446193,843468813,22620,3589,275
843476069,843473040,843495468,22428,3590,275
843502849,843499603,843522566,22963,3591,275
843529946,843526701,843551561,24860,3592,275
843558808,843555781,843577552,21771,3593,275
843584841,843581815,843602951,21136,3594,275
843610229,843607202,843631845,24643,3595,275
843639224,843635980,843659869,23889,3596,275
843667248,843664004,843686647,22643,3597,275
843693875,843690847,843714857,24010,3598,275
843722134,843719107,843741829,22722,3599,275
843749207,843745964,843769535,23571,3600,275
843776767,843773738,843798066,24328,3601,275
843805325,843802298,843825336,23038,3602,275
843832623,843829596,843852972,23376,3603,275
843860262,843857235,843880590,23355,3604,275
843887828,843884799,843907523,22724,3605,275
843914793,843911766,843933854,22088,3606,275
843941232,843937989,843963480,25491,3607,275
843970717,843967689,843992966,25277,3608,275
844000259,843997232,844020925,23693,3609,275
844028304,844025060,844047366,22306,3610,275
844054613,844051585,844074940,23355,3611,275
844082184,844079157,844105402,26245,3612,275
844112655,844109627,844133318,23691,3613,275
844140542,844137515,844160870,23355,3614,275
844168077,844165050,844189375,24325,3615,275
844196754,844193510,844216133,22623,3616,275
844223342,844220315,844242721,22406,3617,275
844250014,844246987,844268442,21455,3618,275
844275734,844272706,844295428,22722,3619,275
844302712,844299685,844322428,22743,3620,275
844329705,844326678,844350349,23671,3621,275
844357729,844354484,844377741,23257,3622,275
844385019,844381992,844406001,24009,3623,275
844413163,844410136,844432126,21990,3624,275
844439368,844436339,844462585,26246,3625,275
844469966,844466721,844491899,25178,3626,275
844499278,844496034,844518678,22644,3627,275
844526057,844522813,844549276,26463,3628,275
844556655,844553412,844576348,22936,3629,275
844583617,844580590,844603651,23061,3630,275
844610875,844607848,844631541,23693,3631,275
844638787,844635760,844659452,23692,3632,275
844666684,844663657,844687350,23693,3633,275
844694643,844691616,844715604,23988,3634,275
844722984,844719739,844743966,24227,3635,275
844751224,844748198,844770306,22108,3636,275
844777606,844774580,844797616,23036,3637,275
844804861,844801833,844823605,21772,3638,275
844830849,844827821,844852146,24325,3639,275
844859524,844856281,844881455,25174,3640,275
844888833,844885590,844910447,24857,3641,275
844917688,844914661,844937403,22742,3642,275
844944640,844941613,844967859,26246,3643,275
844975102,844972075,844996696,24621,3644,275
845003922,845000895,845023954,23059,3645,275
845031193,845028166,845051858,23692,3646,275
845059142,845056114,845081390,25276,3647,275
845088658,845085630,845109007,23377,3648,275
845116259,845113232,845136291,23059,3649,275
845143670,845140426,845163363,22937,3650,275
845170643,845167614,845190020,22406,3651,275
845197399,845194155,845218065,23910,3652,275
845225310,845222283,845246313,24030,3653,275
845253602,845250574,845273614,23040,3654,275
845280918,845277891,845302851,24960,3655,275
845310142,845307116,845332728,25612,3656,275
845340108,845336864,845361723,24859,3657,275
845368960,845365931,845390258,24327,3658,275
845397478,845394451,845419093,24642,3659,275
845426366,845423338,845447009,23671,3660,275
845454274,845451247,845473653,22406,3661,275
845480885,845477858,845503470,25612,3662,275
845510849,845507605,845529279,21674,3663,275
845536485,845533459,845559217,25758,3664,275
845566595,845563352,845585656,22304,3665,275
845592909,845589882,845615158,25276,3666,275
845622447,845619420,845642796,23376,3667,275
845650038,845647010,845670366,23356,3668,275
845677611,845674583,845697307,22724,3669,275
845704536,845701507,845722964,21457,3670,275
845730219,845727191,845751834,24643,3671,275
845759082,845756055,845777510,21455,3672,275
845784890,845781645,845802367,20722,3673,275
845809650,845806623,845828395,21772,3674,275
845835605,845832577,845856566,23989,3675,275
845863945,845860701,845884905,24204,3676,275
845892157,845889130,845910269,21139,3677,275
845917491,845914463,845935920,21457,3678,275
845943204,845940178,845962603,22425,3679,275
845969883,845966854,845989578,22724,3680,275
845996857,845993829,846018787,24958,3681,275
846026003,846022976,846048907,25931,3682,275
846056285,846053042,846077921,24879,3683,275
846085160,846082131,846106776,24645,3684,275
846114154,846110911,846134186,23275,3685,275
846141566,846138321,846162231,23910,3686,275
846169609,846166366,846191878,25512,3687,275
846199106,846196079,846222010,25931,3688,275
846229390,846226146,846248451,22305,3689,275
846255660,846252633,846276641,24008,3690,275
846283880,846280854,846304863,24009,3691,275
846312159,846309132,846334406,25274,3692,275
846341786,846338541,846363065,24524,3693,275
846370355,846367328,846392941,25613,3694,275
846400171,846397144,846420182,23038,3695,275
846427391,846424363,846448689,24326,3696,275
846455905,846452877,846474986,22109,3697,275
846482273,846479246,846503593,24347,3698,275
846510878,846507850,846531542,23692,3699,275
846538921,846535677,846558300,22623,3700,275
846565680,846562436,846587927,25491,3701,275
846595145,846592117,846614544,22427,3702,275
846621923,846618679,846644193,25514,3703,275
846651433,846648406,846672712,24306,3704,275
846680020,846676993,846701002,24009,3705,275
846708286,846705259,846728298,23039,3706,275
846735535,846732507,846756518,24011,3707,275
846763897,846760653,846784583,23930,3708,275
846791963,846788718,846811974,23256,3709,275
846819223,846816196,846841176,24980,3710,275
846848410,846845382,846870025,24643,3711,275
846877299,846874272,846898280,24008,3712,275
846905494,846902467,846926476,24009,3713,275
846933638,846930611,846954520,23909,3714,275
846961683,846958655,846980961,22306,3715,275
846988339,846985096,847009953,24857,3716,275
847017333,847014088,847035445,21357,3717,275
847042705,847039678,847062421,22743,3718,275
847069659,847066633,847088087,21454,3719,275
847095467,847092222,847114528,22306,3720,275
847121818,847118791,847143095,24304,3721,275
847150379,847147351,847170093,22742,3722,275
847177472,847174228,847200354,26126,3723,275
847207615,847204588,847227963,23375,3724,275
847235342,847232098,847253455,21357,3725,275
847260710,847257683,847281060,23377,3726,275
847288298,847285271,847308625,23354,3727,275
847316006,847312760,847337621,24861,3728,275
847344842,847341816,847365529,23713,3729,275
847372908,847369664,847393553,23889,3730,275
847400838,847397810,847421483,23673,3731,275
847428730,847425703,847450325,24622,3732,275
847457629,847454601,847479898,25297,3733,275
847487134,847484107,847508453,24346,3734,275
847515834,847512588,847535529,22941,3735,275
847542807,847539779,847565373,25594,3736,275
847572655,847569628,847591716,22088,3737,275
847598987,847595960,847618681,22721,3738,275
847625972,847622945,847645984,23039,3739,275
847653213,847650186,847676771,26585,3740,275
847684017,847680990,847706897,25907,3741,275
847714179,847711151,847733558,22407,3742,275
847740821,847737794,847759546,21752,3743,275
847766795,847763768,847787777,24009,3744,275
847795156,847791912,847815168,23256,3745,275
847822458,847819431,847841518,22087,3746,275
847848801,847845774,847869445,23671,3747,275
847876824,847873580,847898122,24542,3748,275
847905371,847902344,847926331,23987,3749,275
847933586,847930558,847953934,23376,3750,275
847961313,847958069,847979741,21672,3751,275
847986985,847983958,848008918,24960,3752,275
848016169,848013142,848036497,23355,3753,275
848043804,848040776,848066052,25276,3754,275
848073354,848070326,848094631,24305,3755,275
848101926,848098899,848122254,23355,3756,275
848129633,848126389,848148693,22304,3757,275
848155994,848152967,848178264,25297,3758,275
848185545,848182518,848205556,23038,3759,275
848212863,848209835,848234162,24327,3760,275
848241400,848238370,848263649,25279,3761,275
848271028,848267784,848291673,23889,3762,275
848298904,848295878,848320815,24937,3763,275
848328194,848324950,848348860,23910,3764,275
848356109,848353082,848376120,23038,3765,275
848383498,848380255,848402560,22305,3766,275
848409841,848406814,848433713,26899,3767,275
848440956,848437929,848459068,21139,3768,275
848466448,848463203,848485826,22623,3769,275
848493055,848490028,848514985,24957,3770,275
848522364,848519120,848542711,23591,3771,275
848549972,848546942,848572538,25596,3772,275
848579747,848576719,848600074,23355,3773,275
848607365,848604338,848628327,23989,3774,275
848635590,848632563,848653702,21139,3775,275
848661082,848657837,848681093,23256,3776,275
848688320,848685293,848708649,23356,3777,275
848715880,848712853,848737475,24622,3778,275
848744764,848741736,848765725,23989,3779,275
848773105,848769860,848793749,23889,3780,275
848800971,848797944,848821003,23059,3781,275
848828224,848825197,848849503,24306,3782,275
848856882,848853638,848876578,22940,3783,275
848883956,848880713,848904939,24226,3784,275
848912206,848909179,848934138,24959,3785,275
848941415,848938388,848963030,24642,3786,275
848970251,848967225,848989946,22721,3787,275
848997170,848994143,849018131,23988,3788,275
849025509,849022266,849047758,25492,3789,275
849054988,849051960,849075000,23040,3790,275
849082223,849079196,849101601,22405,3791,275
849108980,849105736,849128695,22959,3792,275
849136074,849132830,849157036,24206,3793,275
849164262,849161235,849185877,24642,3794,275
849193185,849190157,849213850,23693,3795,275
849221228,849217985,849242190,24205,3796,275
849249443,849246416,849271690,25274,3797,275
849278927,849275900,849302800,26900,3798,275
849310067,849307040,849328812,21772,3799,275
849336193,849332947,849357808,24861,3800,275
849365186,849361943,849385536,23593,3801,275
849392915,849389671,849414192,24521,3802,275
849421570,849418327,849442531,24204,3803,275
849449810,849446782,849469189,22407,3804,275
849476568,849473324,849495967,22643,3805,275
849503202,849500174,849522916,22742,3806,275
849530227,849527199,849549922,22723,3807,275
849557301,849554057,849576046,21989,3808,275
849583426,849580181,849600905,20724,3809,275
849608164,849605136,849630115,24979,3810,275
849637494,849634250,849658139,23889,3811,275
849665351,849662323,849686017,23694,3812,275
849693297,849690269,849713644,23375,3813,275
849721025,849717779,849739770,21991,3814,275
849747018,849743990,849768633,24643,3815,275
849775866,849772840,849796531,23691,3816,275
849803693,849800666,849822020,21354,3817,275
849829399,849826155,849849411,23256,3818,275
849856790,849853546,849879017,25471,3819,275
849886232,849883205,849908165,24960,3820,275
849915463,849912436,849935495,23059,3821,275
849942708,849939681,849961452,21771,3822,275
849968709,849965682,849989057,23375,3823,275
849996268,849993241,850018538,25297,3824,275
850025766,850022738,850046116,23378,3825,275
850053393,850050367,850074374,24007,3826,275
850081617,850078589,850103232,24643,3827,275
850110469,850107441,850129215,21774,3828,275
850136444,850133417,850154556,21139,3829,275
850161936,850158691,850181313,22622,3830,275
850188601,850185574,850211505,25931,3831,275
850218885,850215641,850239234,23593,3832,275
850246612,850243369,850269516,26147,3833,275
850276896,850273652,850296273,22621,3834,275
850303564,850300536,850322941,22405,3835,275
850330244,850327215,850351543,24328,3836,275
850358851,850355822,850378862,23040,3837,275
850386241,850382997,850404669,21672,3838,275
850411905,850408878,850433837,24959,3839,275
850441216,850437972,850461882,23910,3840,275
850469189,850466162,850491141,24979,3841,275
850498354,850495327,850519337,24010,3842,275
850526575,850523548,850547536,23988,3843,275
850554787,850551759,850575136,23377,3844,275
850582515,850579271,850603498,24227,3845,275
850610750,850607722,850630127,22405,3846,275
850637391,850634363,850658985,24622,3847,275
850666365,850663120,850686715,23595,3848,275
850694094,850690850,850715393,24543,3849,275
850722627,850719600,850745845,26245,3850,275
850753007,850749980,850776127,26147,3851,275
850783392,850780365,850805661,25296,3852,275
850813041,850809796,850834993,25197,3853,275
850842221,850839194,850863521,24327,3854,275
850870773,850867746,850890150,22404,3855,275
850897529,850894285,850917223,22938,3856,275
850924603,850921358,850945903,24545,3857,275
850953124,850950096,850973473,23377,3858,275
850980726,850977700,851000421,22721,3859,275
851007800,851004556,851029435,24879,3860,275
851036686,851033658,851059251,25593,3861,275
851066468,851063441,851087114,23673,3862,275
851094493,851091249,851116446,25197,3863,275
851123735,851120708,851142163,21455,3864,275
851149392,851146365,851171346,24981,3865,275
851178639,851175612,851197384,21772,3866,275
851204640,851201613,851225939,24326,3867,275
851233244,851230216,851253573,23357,3868,275
851260833,851257806,851279894,22088,3869,275
851287112,851284085,851305539,21454,3870,275
851312828,851309800,851333809,24009,3871,275
851341188,851337944,851363141,25197,3872,275
851370519,851367276,851389919,22643,3873,275
851397229,851394201,851418548,24347,3874,275
851425928,851422683,851445327,22644,3875,275
851452601,851449573,851472633,23060,3876,275
851480013,851476768,851497808,21040,3877,275
851505039,851502011,851524099,22088,3878,275
851531317,851528290,851551667,23377,3879,275
851558962,851555934,851580556,24622,3880,275
851587796,851584768,851608460,23692,3881,275
851615703,851612674,851638606,25932,3882,275
851645876,851642848,851665886,23038,3883,275
851673130,851670103,851696034,25931,3884,275
851703250,851700223,851721678,21455,3885,275
851728962,851725936,851750578,24642,3886,275
851757870,851754841,851777566,22725,3887,275
851784842,851781815,851804852,23037,3888,275
851812015,851808987,851832580,23593,3889,275
851839959,851836715,851859336,22621,3890,275
851866554,851863527,851887536,24009,3891,275
851894915,851891671,851912710,21039,3892,275
851920088,851916845,851941070,24225,3893,275
851948292,851945265,851966721,21456,3894,275
851974099,851970856,851994765,23909,3895,275
852002144,851998900,852025046,26146,3896,275
852032425,852029181,852050851,21670,3897,275
852058013,852054986,852079213,24227,3898,275
852086592,852083348,852109494,26146,3899,275
852116872,852113629,852135932,22303,3900,275
852143224,852140197,852163235,23038,3901,275
852170614,852167370,852189991,22621,3902,275
852197239,852194212,852218537,24325,3903,275
852225762,852222735,852248665,25930,3904,275
852255885,852252857,852275285,22428,3905,275
852282663,852279419,852303329,23910,3906,275
852310567,852307539,852328995,21456,3907,275
852336374,852333129,852357038,23909,3908,275
852364269,852361242,852385883,24641,3909,275
852393132,852390105,852413480,23375,3910,275
852420859,852417615,852441188,23573,3911,275
852448490,852445463,852467235,21772,3912,275
852474490,852471460,852493552,22092,3913,275
852500932,852497687,852519359,21672,3914,275
852526738,852523494,852546454,22960,3915,275
852553832,852550589,852573525,22936,3916,275
852580802,852577775,852601131,23356,3917,275
852608384,852605357,852629028,23671,3918,275
852636252,852633225,852656285,23060,3919,275
852663501,852660474,852683829,23355,3920,275
852691208,852687964,852711555,23591,3921,275
852718833,852715806,852739160,23354,3922,275
852746409,852743382,852766737,23355,3923,275
852773980,852770952,852796544,25592,3924,275
852803847,852800820,852824827,24007,3925,275
852832118,852829090,852850862,21772,3926,275
852858070,852855043,852876498,21455,3927,275
852883722,852880695,852905040,24345,3928,275
852912290,852909262,852935193,25931,3929,275
852942485,852939458,852963467,24009,3930,275
852970759,852967731,852993345,25614,3931,275
853000575,852997546,853021558,24012,3932,275
853028838,853025811,853051403,25592,3933,275
853058646,853055619,853078658,23039,3934,275
853086037,853082793,853107651,24858,3935,275
853114962,853111933,853136260,24327,3936,275
853143639,853140395,853166225,25830,3937,275
853173605,853170360,853193636,23276,3938,275
853200927,853197900,853219038,21138,3939,275
853226417,853223173,853248645,25472,3940,275
853256023,853252780,853275106,22326,3941,275
853282484,853279241,853303464,24223,3942,275
853310672,853307645,853330702,23057,3943,275
853338081,853334837,853359381,24544,3944,275
853366618,853363591,853387262,23671,3945,275
853394537,853391509,853415813,24304,3946,275
853423116,853420089,853445680,25591,3947,275
853452928,853449901,853472644,22743,3948,275
853479955,853476927,853498701,21774,3949,275
853505913,853502885,853527527,24642,3950,275
853534819,853531791,853557067,25276,3951,275
853564276,853561248,853584940,23692,3952,275
853592231,853589204,853611924,22720,3953,275
853619176,853616149,853640811,24662,3954,275
853648190,853644946,853667252,22306,3955,275
853674529,853671501,853692640,21139,3956,275
853699855,853696827,853718283,21456,3957,275
853725661,853722418,853746642,24224,3958,275
853753889,853750861,853774534,23673,3959,275
853781774,853778747,853803726,24979,3960,275
853811011,853807983,853833258,25275,3961,275
853840485,853837458,853860812,23354,3962,275
853868192,853864947,853887253,22306,3963,275
853894468,853891441,853912896,21455,3964,275
853920187,853917160,853940199,23039,3965,275
853947427,853944400,853967122,22722,3966,275
853974420,853971393,853995739,24346,3967,275
854002980,853999955,854021408,21453,3968,275
854028634,854025607,854050882,25275,3969,275
854058111,854055084,854076223,21139,3970,275
854083438,854080411,854100916,20505,3971,275
854108295,854105051,854127354,22303,3972,275
854134579,854131551,854156195,24644,3973,275
854163573,854160330,854182635,22305,3974,275
854189929,854186903,854210256,23353,3975,275
854217554,854214526,854238851,24325,3976,275
854246231,854242986,854266873,23887,3977,275
854274109,854271081,854294754,23673,3978,275
854302133,854298889,854322483,23594,3979,275
854329758,854326731,854350717,23986,3980,275
854358001,854354973,854378012,23039,3981,275
854385393,854382147,854406691,24544,3982,275
854413973,854410945,854431135,20190,3983,275
854438512,854435270,854459157,23887,3984,275
854466536,854463292,854488151,24859,3985,275
854495390,854492363,854517005,24642,3986,275
854524311,854521285,854544638,23353,3987,275
854551799,854548773,854572027,23254,3988,275
854579405,854576162,854602286,26124,3989,275
854609665,854606422,854629359,22937,3990,275
854636739,854633494,854656750,23256,3991,275
854664130,854660885,854685746,24861,3992,275
854692909,854689881,854713454,23573,3993,275
854720689,854717662,854739117,21455,3994,275
854746429,854743401,854765808,22407,3995,275
854773072,854770045,854795002,24957,3996,275
854802223,854799196,854823185,23989,3997,275
854830347,854827320,854850890,23570,3998,275
854858268,854855025,854880853,25828,3999,275
854888233,854884989,854908898,23909,4000,275
854916277,854913033,854936920,23887,4001,275
854944174,854941146,854962601,21455,4002,275
854969832,854966805,854988261,21456,4003,275
854995639,854992396,855016285,23889,4004,275
855023447,855020420,855043991,23571,4005,275
855051238,855048210,855071587,23377,4006,275
855078803,855075776,855100735,24959,4007,275
855107987,855104959,855128632,23673,4008,275
855135840,855132813,855156802,23989,4009,275
855164091,855161064,855183469,22405,4010,275
855190849,855187604,855211832,24228,4011,275
855219054,855216027,855238749,22722,4012,275
855245979,855242952,855268542,25590,4013,275
855275705,855272677,855298487,25810,4014,275
855305867,855302623,855327462,24839,4015,275
855334842,855331597,855356436,24839,4016,275
855363816,855360571,855383826,23255,4017,275
855391089,855388062,855412051,23989,4018,275
855419430,855416186,855441046,24860,4019,275
855448425,855445181,855468751,23570,4020,275
855476011,855472982,855497605,24623,4021,275
855504839,855501812,855524872,23060,4022,275
855532103,855529075,855551165,22090,4023,275
855558414,855555387,855576842,21455,4024,275
855584132,855581105,855604482,23377,4025,275
855611860,855608617,855632187,23570,4026,275
855639349,855636322,855659892,23570,4027,275
855667155,855664128,855688455,24327,4028,275
855695759,855692732,855716721,23989,4029,275
855723962,855720934,855743024,22090,4030,275
855750402,855747159,855772313,25154,4031,275
855779547,855776520,855799876,23356,4032,275
855807113,855804085,855829340,25255,4033,275
855836559,855833532,855856570,23038,4034,275
855863822,855860795,855885122,24327,4035,275
855892501,855889257,855911879,22622,4036,275
855919258,855916014,855940893,24879,4037,275
855948272,855945028,855967670,22642,4038,275
855974912,855971884,855994923,23039,4039,275
856002142,855999114,856021203,22089,4040,275
856028583,856025339,856047644,22305,4041,275
856055022,856051779,856077272,25493,4042,275
856084434,856081407,856106562,25155,4043,275
856113798,856110771,856133491,22720,4044,275
856140870,856137626,856160584,22958,4045,275
856167963,856164719,856188925,24206,4046,275
856196163,856193136,856215540,22404,4047,275
856222782,856219754,856240261,20507,4048,275
856247641,856244396,856268285,23889,4049,275
856275666,856272420,856295065,22645,4050,275
856302305,856299278,856322655,23377,4051,275
856329882,856326855,856350843,23988,4052,275
856358086,856355059,856380335,25276,4053,275
856387569,856384541,856406969,22428,4054,275
856414349,856411104,856434380,23276,4055,275
856441630,856438602,856463563,24961,4056,275
856470791,856467765,856492068,24303,4057,275
856499447,856496203,856519480,23277,4058,275
856526858,856523615,856546870,23255,4059,275
856554106,856551079,856575088,24009,4060,275
856582364,856579336,856602059,22723,4061,275
856609350,856606322,856629362,23040,4062,275
856636741,856633497,856658017,24520,4063,275
856665396,856662152,856685407,23255,4064,275
856692787,856689542,856714086,24544,4065,275
856721465,856718221,856742447,24226,4066,275
856749826,856746582,856770470,23888,4067,275
856777849,856774605,856797227,22622,4068,275
856804444,856801415,856823822,22407,4069,275
856831067,856828040,856851416,23376,4070,275
856858715,856855686,856879379,23693,4071,275
856886758,856883514,856908689,25175,4072,275
856915920,856912891,856938169,25278,4073,275
856945548,856942304,856966530,24226,4074,275
856973785,856970758,856995085,24327,4075,275
857002294,856999266,857022305,23039,4076,275
857029685,857026440,857051004,24564,4077,275
857058302,857055275,857079263,23988,4078,275
857086642,857083398,857106041,22643,4079,275
857113419,857110176,857132163,21987,4080,275
857139453,857136426,857160435,24009,4081,275
857167662,857164634,857187335,22701,4082,275
857194554,857191526,857212983,21457,4083,275
857220259,857217232,857238369,21137,4084,275
857245749,857242504,857267702,25198,4085,275
857275081,857271837,857296717,24880,4086,275
857303992,857300964,857324318,23354,4087,275
857331591,857328562,857352256,23694,4088,275
857359533,857356505,857379544,23039,4089,275
857386923,857383679,857405035,21356,4090,275
857412333,857409306,857429812,20506,4091,275
857437044,857434018,857458342,24324,4092,275
857465592,857462565,857484971,22406,4093,275
857492200,857489172,857512211,23039,4094,275
857519590,857516346,857538968,22622,4095,275
857546220,857543192,857564965,21773,4096,275
857572271,857569242,857590067,20825,4097,275
857597318,857594290,857616696,22406,4098,275
857623937,857620911,857645891,24980,4099,275
857653122,857650095,857673470,23375,4100,275
857680761,857677733,857701088,23355,4101,275
857708333,857705304,857728661,23357,4102,275
857736040,857732796,857754785,21989,4103,275
857762097,857759069,857783712,24643,4104,275
857790923,857787895,857812875,24980,4105,275
857820253,857817010,857841847,24837,4106,275
857849084,857846057,857870382,24325,4107,275
857877671,857874644,857896732,22088,4108,275
857904112,857900867,857924777,23910,4109,275
857932041,857929014,857953318,24304,4110,275
857960586,857957559,857980597,23038,4111,275
857987852,857984825,858007229,22404,4112,275
858014520,858011493,858034216,22723,4113,275
858041434,858038406,858064021,25615,4114,275
858071264,858068237,858093196,24959,4115,275
858100492,858097464,858122087,24623,4116,275
858129382,858126353,858151335,24982,4117,275
858158612,858155585,858179256,23671,4118,275
858186634,858183391,858207596,24205,4119,275
858214813,858211786,858235161,23375,4120,275
858242415,858239389,858264030,24641,4121,275
858271299,858268270,858291308,23038,4122,275
858298564,858295537,858319547,24010,4123,275
858326769,858323741,858347118,23377,4124,275
858354404,858351376,858373782,22406,4125,275
858381058,858378029,858401723,23694,4126,275
858409102,858405858,858428164,22306,4127,275
858435427,858432400,858454827,22427,4128,275
858462116,858459088,858481177,22089,4129,275
858488418,858485390,858507797,22407,4130,275
858515036,858512008,858534096,22088,4131,275
858541327,858538298,858560389,22091,4132,275
858567643,858564617,858587021,22404,4133,275
858594258,858591230,858617161,25931,4134,275
858624445,858621417,858645109,23692,4135,275
858652327,858649299,858674596,25297,4136,275
858681838,858678810,858701216,22406,4137,275
858708596,858705351,858727658,22307,4138,275
858735038,858731793,858754100,22307,4139,275
858761479,858758235,858782441,24206,4140,275
858789720,858786693,858811990,25297,4141,275
858819368,858816125,858839717,23592,4142,275
858847095,858843852,858866157,22305,4143,275
858873536,858870293,858892598,22305,4144,275
858899859,858896832,858920209,23377,4145,275
858927371,858924344,858949204,24860,4146,275
858956582,858953339,858976277,22938,4147,275
858983657,858980412,859002719,22307,4148,275
859009970,859006943,859030003,23060,4149,275
859037242,859034215,859057590,23375,4150,275
859064843,859061817,859085487,23670,4151,275
859092866,859089622,859113826,24204,4152,275
859121206,859117961,859141215,23254,4153,275
859148502,859145474,859167246,21772,4154,275
859174525,859171497,859196772,25275,4155,275
859204002,859200976,859222747,21771,4156,275
859230034,859227007,859249729,22722,4157,275
859256892,859253864,859275220,21356,4158,275
859282441,859279412,859303106,23694,4159,275
859310486,859307241,859329231,21990,4160,275
859336610,859333366,859355355,21989,4161,275
859362586,859359558,859383230,23672,4162,275
859390463,859387435,859411128,23693,4163,275
859418401,859415375,859440650,25275,4164,275
859448030,859444785,859467408,22623,4165,275
859474787,859471543,859496424,24881,4166,275
859503804,859500559,859523816,23257,4167,275
859531065,859528038,859551731,23693,4168,275
859559110,859555866,859580093,24227,4169,275
859587472,859584228,859608116,23888,4170,275
859615496,859612252,859636163,23911,4171,275
859643543,859640298,859665811,25513,4172,275
859673094,859670067,859693104,23037,4173,275
859700363,859697335,859720711,23376,4174,275
859728091,859724846,859749390,24544,4175,275
859756671,859753644,859776683,23039,4176,275
859783973,859780946,859805270,24324,4177,275
859812499,859809471,859833460,23989,4178,275
859840840,859837596,859862455,24859,4179,275
859869834,859866590,859892103,25513,4180,275
859899355,859896328,859921604,25276,4181,275
859928847,859925819,859948880,23061,4182,275
859956260,859953015,859976292,23277,4183,275
859983671,859980427,860006258,25831,4184,275
860013498,860010470,860035767,25297,4185,275
860043068,860040041,860065971,25930,4186,275
860073179,860070152,860090658,20506,4187,275
860097926,860094896,860118887,23991,4188,275
860126171,860123143,860145233,22090,4189,275
860152614,860149369,860172942,23573,4190,275
860180163,860177136,860198908,21772,4191,275
860206214,860203188,860226245,23057,4192,275
860233623,860230380,860254289,23909,4193,275
860261668,860258424,860284233,25809,4194,275
860291473,860288446,860310872,22426,4195,275
860318083,860315056,860338411,23355,4196,275
860345789,860342546,860364533,21987,4197,275
860371790,860368763,860392139,23376,4198,275
860399429,860396402,860420390,23988,4199,275
860427689,860424661,860446752,22091,4200,275
860454130,860450887,860473826,22939,4201,275
860481070,860478043,860501397,23354,4202,275
860508683,860505656,860528399,22743,4203,275
860535658,860532632,860555691,23059,4204,275
860563071,860559826,860583418,23592,4205,275
860590640,860587613,860611623,24010,4206,275
860618882,860615854,860639209,23355,4207,275
860646588,860643344,860668540,25196,4208,275
860675828,860672801,860696176,23375,4209,275
860703555,860700311,860724875,24564,4210,275
860732181,860729154,860753501,24347,4211,275
860760787,860757761,860780799,23038,4212,275
860787961,860784934,860807872,22938,4213,275
860815251,860812007,860837521,25514,4214,275
860844831,860841804,860866445,24641,4215,275
860873824,860870580,860895757,25177,4216,275
860903137,860899892,860923782,23890,4217,275
860930998,860927972,860953901,25929,4218,275
860961063,860958037,860982263,24226,4219,275
860989642,860986398,861008703,22305,4220,275
861016082,861012838,861037063,24225,4221,275
861044442,861041198,861062871,21673,4222,275
861070250,861067006,861089966,22960,4223,275
861097271,861094244,861117304,23060,4224,275
861124521,861121494,861144869,23375,4225,275
861152248,861149004,861172597,23593,4226,275
861179976,861176732,861201592,24860,4227,275
861208971,861205727,861229952,24225,4228,275
861237206,861234179,861256900,22721,4229,275
861264194,861261167,861283909,22742,4230,275
861291191,861288164,861312194,24030,4231,275
861319573,861316329,861341821,25492,4232,275
861349200,861345956,861369866,23910,4233,275
861377246,861374001,861398545,24544,4234,275
861405793,861402766,861425509,22743,4235,275
861432759,861429732,861454057,24325,4236,275
861461327,861458300,861480389,22089,4237,275
861487768,861484524,861507146,22622,4238,275
861514454,861511427,861536068,24641,4239,275
861543314,861540286,861568876,28590,4240,275
861576123,861573097,861599027,25930,4241,275
861606325,861603299,861627624,24325,4242,275
861635003,861631759,861654697,22938,4243,275
861661987,861658960,861681999,23039,4244,275
861689263,861686236,861711196,24960,4245,275
861718490,861715463,861736283,20820,4246,275
861743531,861740504,861763226,22722,4247,275
861770507,861767480,861792755,25275,4248,275
861800019,861796992,861820031,23039,4249,275
861827315,861824288,861847346,23058,4250,275
861854724,861851481,861874103,22622,4251,275
861881264,861878238,861901175,22937,4252,275
861908412,861905385,861930344,24959,4253,275
861937722,861934479,861955834,21355,4254,275
861963213,861959969,861983857,23888,4255,275
861991236,861987992,862010615,22623,4256,275
862017867,862014839,862040116,25277,4257,275
862047348,862044319,862069617,25298,4258,275
862076895,862073868,862097243,23375,4259,275
862104476,862101449,862125142,23693,4260,275
862132354,862129326,862151731,22405,4261,275
862158945,862155918,862177058,21140,4262,275
862184290,862181263,862203035,21772,4263,275
862210316,862207288,862228745,21457,4264,275
862235978,862232951,862255355,22404,4265,275
862262517,862259490,862281479,21989,4266,275
862288718,862285690,862307780,22090,4267,275
862315161,862311916,862336775,24859,4268,275
862344087,862341058,862363780,22722,4269,275
862371160,862367915,862391194,23279,4270,275
862398435,862395408,862417180,21772,4271,275
862424467,862421440,862445133,23693,4272,275
862452429,862449402,862470224,20822,4273,275
862477459,862474432,862496837,22405,4274,275
862504120,862501093,862525102,24009,4275,275
862532371,862529345,862552383,23038,4276,275
862559626,862556600,862580923,24323,4277,275
862588163,862585134,862609484,24350,4278,275
862616775,862613749,862637756,24007,4279,275
862645135,862641891,862665167,23276,4280,275
862672387,862669360,862693031,23671,4281,275
862700337,862697309,862718448,21139,4282,275
862725695,862722668,862747627,24959,4283,275
862754862,862751834,862776139,24305,4284,275
862783428,862780402,862802174,21772,4285,275
862809395,862806368,862828139,21771,4286,275
862835518,862832274,862856795,24521,4287,275
862864046,862861018,862885681,24663,4288,275
862893061,862889816,862914358,24542,4289,275
862921653,862918626,862939766,21140,4290,275
862947017,862943990,862966712,22722,4291,275
862974092,862970848,862997312,26464,4292,275
863004600,863001573,863026551,24978,4293,275
863033821,863030794,863052567,21773,4294,275
863059794,863056767,863080777,24010,4295,275
863088155,863084912,863105951,21039,4296,275
863113330,863110086,863135284,25198,4297,275
863142577,863139550,863161005,21455,4298,275
863168168,863165140,863191287,26147,4299,275
863198596,863195570,863219263,23693,4300,275
863226642,863223398,863246021,22623,4301,275
863253241,863250214,863274202,23988,4302,275
863281457,863278429,863302121,23692,4303,275
863309501,863306256,863331117,24861,4304,275
863338400,863335373,863358115,22742,4305,275
863365350,863362323,863388569,26246,4306,275
863395949,863392705,863414378,21673,4307,275
863421667,863418640,863443936,25296,4308,275
863451220,863448192,863470598,22406,4309,275
863477978,863474733,863495140,20407,4310,275
863502519,863499275,863523818,24543,4311,275
863531117,863528090,863550179,22089,4312,275
863557464,863554437,863581022,26585,4313,275
863588256,863585228,863610188,24960,4314,275
863617454,863614427,863639092,24665,4315,275
863646327,863643299,863667963,24664,4316,275
863675256,863672229,863695921,23692,4317,275
863703197,863700170,863725782,25612,4318,275
863733074,863730047,863750553,20506,4319,275
863757932,863754688,863777310,22622,4320,275
863784546,863781518,863806161,24643,4321,275
863813403,863810375,863832147,21772,4322,275
863839385,863836357,863859398,23041,4323,275
863866626,863863600,863886660,23060,4324,275
863893877,863890850,863912623,21773,4325,275
863919877,863916849,863938940,22091,4326,275
863946319,863943075,863968250,25175,4327,275
863975629,863972385,863996611,24226,4328,275
864003845,864000817,864022589,21772,4329,275
864029895,864026868,864050243,23375,4330,275
864057622,864054378,864079553,25175,4331,275
864086840,864083812,864106874,23062,4332,275
864114253,864111009,864135553,24544,4333,275
864142785,864139758,864162501,22743,4334,275
864169879,864166636,864189594,22958,4335,275
864196866,864193840,864215294,21454,4336,275
864222579,864219552,864241324,21772,4337,275
864248585,864245558,864270517,24959,4338,275
864277776,864274749,864299708,24959,4339,275
864307001,864303972,864327667,23695,4340,275
864334887,864331859,864356818,24959,4341,275
864364095,864361069,864385711,24642,4342,275
864393090,864389846,864414073,24227,4343,275
864421452,864418208,864441485,23277,4344,275
864448728,864445701,864471314,25613,4345,275
864478592,864475564,864497653,22089,4346,275
864504945,864501918,864524345,22427,4347,275
864531590,864528563,864552889,24326,4348,275
864560098,864557072,864577894,20822,4349,275
864585150,864582123,864605499,23376,4350,275
864612750,864609723,864631495,21772,4351,275
864638774,864635748,864659419,23671,4352,275
864666642,864663616,864685703,22087,4353,275
864692980,864689952,864711408,21456,4354,275
864718639,864715611,864739937,24326,4355,275
864747316,864744072,864767328,23256,4356,275
864774542,864771514,864795502,23988,4357,275
864802880,864799637,864825150,25513,4358,275
864832380,864829353,864853045,23692,4359,275
864860425,864857181,864881092,23911,4360,275
864888473,864885228,864907851,22623,4361,275
864915230,864911986,864939104,27118,4362,275
864946339,864943310,864967003,23693,4363,275
864974315,864971287,864993060,21773,4364,275
865000277,864997249,865020627,23378,4365,275
865027856,865024829,865047233,22404,4366,275
865054611,865051368,865075573,24205,4367,275
865082735,865079708,865103955,24247,4368,275
865111195,865108167,865132177,24010,4369,275
865139412,865136384,865158810,22426,4370,275
865166063,865163036,865186390,23354,4371,275
865193611,865190584,865214593,24009,4372,275
865221818,865218791,865242462,23671,4373,275
865249707,865246679,865269719,23040,4374,275
865276960,865273933,865300496,26563,4375,275
865307748,865304720,865326176,21456,4376,275
865333556,865330311,865351985,21674,4377,275
865359364,865356120,865379712,23592,4378,275
865387093,865383847,865408413,24566,4379,275
865415793,865412548,865438063,25515,4380,275
865445441,865442198,865467076,24878,4381,275
865474455,865471211,865495734,24523,4382,275
865503113,865499869,865524706,24837,4383,275
865532086,865528841,865554017,25176,4384,275
865561300,865558273,865578778,20505,4385,275
865586157,865582913,865606822,23909,4386,275
865613985,865610957,865636451,25494,4387,275
865643681,865640654,865664028,23374,4388,275
865671295,865668268,865689724,21456,4389,275
865697033,865694006,865716094,22088,4390,275
865723339,865720311,865740818,20507,4391,275
865748032,865745005,865768043,23038,4392,275
865775343,865772316,865795058,22742,4393,275
865802356,865799328,865824287,24959,4394,275
865831533,865828505,865851229,22724,4395,275
865858609,865855364,865878621,23257,4396,275
865885854,865882826,865906182,23356,4397,275
865913561,865910317,865934227,23910,4398,275
865941606,865938362,865963221,24859,4399,275
865970601,865967356,865992533,25177,4400,275
865999912,865996668,866021527,24859,4401,275
866028833,866025806,866049794,23988,4402,275
866057028,866053999,866078327,24328,4403,275
866085706,866082462,866108290,25828,4404,275
866115672,866112426,866137920,25494,4405,275
866145157,866142130,866167426,25296,4406,275
866174716,866171689,866196331,24642,4407,275
866203710,866200466,866225008,24542,4408,275
866232300,866229273,866252017,22744,4409,275
866259396,866256152,866281642,25490,4410,275
866288804,866285777,866310003,24226,4411,275
866317255,866314228,866336970,22742,4412,275
866344350,866341105,866365331,24226,4413,275
866372710,866369466,866393712,24246,4414,275
866401091,866397847,866420153,22306,4415,275
866427460,866424433,866449390,24957,4416,275
866456769,866453525,866476484,22959,4417,275
866483748,866480722,866504098,23376,4418,275
866511332,866508304,866531343,23039,4419,275
866538574,866535546,866559852,24306,4420,275
866567104,866564076,866588087,24011,4421,275
866595367,866592338,866617953,25615,4422,275
866625332,866622088,866644394,22306,4423,275
866651773,866648529,866670856,22327,4424,275
866678133,866675105,866700087,24982,4425,275
866707464,866704222,866728764,24542,4426,275
866736142,866732899,866756152,23253,4427,275
866763532,866760287,866783860,23573,4428,275
866791087,866788059,866814306,26247,4429,275
866821599,866818572,866842581,24009,4430,275
866849959,866846716,866868388,21672,4431,275
866875607,866872579,866897244,24665,4432,275
866904467,866901440,866923528,22088,4433,275
866930787,866927760,866949215,21455,4434,275
866956594,866953350,866975339,21989,4435,275
866982567,866979540,867004520,24980,4436,275
867011803,867008774,867033082,24308,4437,275
867040365,867037337,867060059,22722,4438,275
867067437,867064194,867086835,22641,4439,275
867094042,867091014,867115363,24349,4440,275
867122668,867119641,867143648,24007,4441,275
867150903,867147877,867169648,21771,4442,275
867177026,867173783,867198325,24542,4443,275
867205557,867202530,867223964,21434,4444,275
867231250,867228221,867250945,22724,4445,275
867258324,867255080,867279305,24225,4446,275
867286542,867283515,867304970,21455,4447,275
867312210,867309182,867334478,25296,4448,275
867341776,867338749,867364025,25276,4449,275
867371331,867368304,867393896,25592,4450,275
867401121,867398094,867421132,23038,4451,275
867428341,867425314,867448670,23356,4452,275
867456048,867452805,867478634,25829,4453,275
867486015,867482770,867508600,25830,4454,275
867515981,867512736,867534409,21673,4455,275
867541652,867538626,867562951,24325,4456,275
867570113,867567086,867591944,24858,4457,275
867599163,867596136,867619196,23060,4458,275
867626471,867623444,867646483,23039,4459,275
867653863,867650618,867672926,22308,4460,275
867680167,867677140,867701150,24010,4461,275
867708529,867705286,867729510,24224,4462,275
867736747,867733720,867759312,25592,4463,275
867766694,867763448,867786684,23236,4464,275
867794064,867790819,867816627,25808,4465,275
867823855,867820828,867845785,24957,4466,275
867852947,867849920,867873490,23570,4467,275
867880724,867877697,867901391,23694,4468,275
867908771,867905526,867926883,21357,4469,275
867934123,867931096,867954134,23038,4470,275
867961421,867958394,867984640,26246,4471,275
867991914,867988886,868012875,23989,4472,275
868020110,868017083,868041092,24009,4473,275
868048381,868045354,868069997,24643,4474,275
868077261,868074233,868096005,21772,4475,275
868103273,868100245,868121701,21456,4476,275
868128991,868125963,868149971,24008,4477,275
868157350,868154106,868180570,26464,4478,275
868187805,868184778,868207499,22721,4479,275
868214728,868211700,868234423,22723,4480,275
868241802,868238559,868263102,24543,4481,275
868270356,868267328,868289415,22087,4482,275
868296625,868293597,868318558,24961,4483,275
868325787,868322759,868347423,24664,4484,275
868354636,868351608,868374965,23357,4485,275
868382222,868379194,868401936,22742,4486,275
868409203,868406175,868428897,22722,4487,275
868436275,868433032,868455971,22939,4488,275
868463204,868460176,868481317,21141,4489,275
868488543,868485515,868507921,22406,4490,275
868515300,868512056,868534677,22621,4491,275
868541914,868538886,868559709,20823,4492,275
868566939,868563912,868586317,22405,4493,275
868593562,868590535,868613912,23377,4494,275
868621290,868618047,868641322,23275,4495,275
868648587,868645561,868670519,24958,4496,275
868677812,868674784,868697823,23039,4497,275
868705125,868702098,868726422,24324,4498,275
868733802,868730557,868752231,21674,4499,275
868759457,868756429,868780144,23715,4500,275
868787385,868784358,868805813,21455,4501,275
868813071,868810043,868834686,24643,4502,275
868841964,868838937,868859443,20506,4503,275
868866727,868863700,868884207,20507,4504,275
868891588,868888342,868912254,23912,4505,275
868919634,868916389,868941249,24860,4506,275
868948629,868945384,868968979,23595,4507,275
868976358,868973114,868996074,22960,4508,275
869003453,869000209,869024118,23909,4509,275
869031374,869028345,869052989,24644,4510,275
869060239,869057211,869080905,23694,4511,275
869088286,869085041,869107051,22010,4512,275
869114285,869111257,869134613,23356,4513,275
869141821,869138794,869163118,24324,4514,275
869170365,869167337,869192931,25594,4515,275
869200224,869197197,869219602,22405,4516,275
869226853,869223827,869249418,25591,4517,275
869256797,869253553,869279046,25493,4518,275
869286323,869283296,869307284,23988,4519,275
869314663,869311419,869334989,23570,4520,275
869342368,869339124,869360798,21674,4521,275
869368055,869365027,869386483,21456,4522,275
869393727,869390699,869414391,23692,4523,275
869421668,869418641,869441995,23354,4524,275
869449305,869446277,869471257,24980,4525,275
869478557,869475530,869499877,24347,4526,275
869507137,869504109,869526199,22090,4527,275
869533578,869530334,869556142,25808,4528,275
869563429,869560401,869582807,22406,4529,275
869590034,869587005,869611332,24327,4530,275
869618624,869615595,869639900,24305,4531,275
869647149,869644120,869666211,22091,4532,275
869673374,869670346,869693939,23593,4533,275
869701193,869698166,869722175,24009,4534,275
869729555,869726311,869751487,25176,4535,275
869758780,869755753,869778158,22405,4536,275
869785537,869782293,869804916,22623,4537,275
869812157,869809129,869834721,25592,4538,275
869842099,869838856,869860842,21986,4539,275
869868146,869865120,869888473,23353,4540,275
869895755,869892726,869915787,23061,4541,275
869923066,869920038,869941494,21456,4542,275
869948776,869945749,869968470,22721,4543,275
869975720,869972692,869996997,24305,4544,275
870004274,870001247,870024940,23693,4545,275
870032319,870029075,870053302,24227,4546,275
870060681,870057437,870081347,23910,4547,275
870088618,870085590,870108946,23356,4548,275
870116325,870113082,870135704,22622,4549,275
870142986,870139959,870164284,24325,4550,275
870171569,870168543,870192847,24304,4551,275
870200227,870196983,870222477,25494,4552,275
870229701,870226674,870249396,22722,4553,275
870256631,870253602,870275377,21775,4554,275
870282674,870279646,870303951,24305,4555,275
870311183,870308155,870330561,22406,4556,275
870337843,870334815,870358507,23692,4557,275
870365765,870362737,870385775,23038,4558,275
870393155,870389911,870414138,24227,4559,275
870421382,870418354,870442679,24325,4560,275
870449893,870446866,870470220,23354,4561,275
870477513,870474485,870498157,23672,4562,275
870505536,870502292,870525567,23275,4563,275
870532855,870529828,870555714,25886,4564,275
870563093,870559849,870581521,21672,4565,275
870588900,870585656,870607328,21672,4566,275
870614707,870611463,870633452,21989,4567,275
870640719,870637692,870660750,23058,4568,275
870667999,870664972,870689929,24957,4569,275
870697226,870694199,870716921,22722,4570,275
870724302,870721056,870746233,25177,4571,275
870753529,870750502,870774488,23986,4572,275
870781725,870778698,870802390,23692,4573,275
870809769,870806525,870829484,22959,4574,275
870836793,870833765,870857775,24010,4575,275
870865015,870861988,870885996,24008,4576,275
870893303,870890276,870914919,24643,4577,275
870922169,870919143,870944437,25294,4578,275
870951659,870948632,870974245,25613,4579,275
870981518,870978491,871000581,22090,4580,275
871007840,871004812,871029793,24981,4581,275
871037171,871033928,871058786,24858,4582,275
871066038,871063010,871089258,26248,4583,275
871096503,871093476,871115586,22110,4584,275
871122965,871119721,871142048,22327,4585,275
871149358,871146330,871167786,21456,4586,275
871175055,871172028,871198591,26563,4587,275
871205754,871202727,871226931,24204,4588,275
871234186,871231159,871256097,24938,4589,275
871263383,871260356,871284365,24009,4590,275
871291607,871288580,871312927,24347,4591,275
871320232,871317205,871341215,24010,4592,275
871348471,871345444,871367215,21771,4593,275
871374441,871371413,871393819,22406,4594,275
871401037,871398009,871423919,25910,4595,275
871431130,871428103,871454032,25929,4596,275
871461317,871458289,871482953,24664,4597,275
871490332,871487088,871511968,24880,4598,275
871519252,871516225,871540235,24010,4599,275
871547613,871544370,871570957,26587,4600,275
871578336,871575093,871600268,25175,4601,275
871607546,871604518,871628845,24327,4602,275
871636157,871633130,871657475,24345,4603,275
871664730,871661702,871683159,21457,4604,275
871690412,871687384,871711056,23672,4605,275
871718434,871715191,871738467,23276,4606,275
871745773,871742746,871768338,25592,4607,275
871775593,871772566,871794654,22088,4608,275
871802033,871798789,871820779,21990,4609,275
871828158,871824914,871849774,24860,4610,275
871857056,871854029,871877088,23059,4611,275
871884467,871881223,871906420,25197,4612,275
871913800,871910555,871934782,24227,4613,275
871942033,871939006,871961727,22721,4614,275
871969106,871965862,871987849,21987,4615,275
871995228,871991984,872015578,23594,4616,275
872022881,872019853,872044832,24979,4617,275
872052136,872049108,872073435,24327,4618,275
872080688,872077661,872101352,23691,4619,275
872108664,872105637,872127408,21771,4620,275
872134703,872131675,872155368,23693,4621,275
872162632,872159605,872182010,22405,4622,275
872189322,872186294,872212879,26585,4623,275
872220259,872217015,872242529,25514,4624,275
872249774,872246745,872267569,20824,4625,275
872274947,872271704,872295611,23907,4626,275
872302830,872299804,872321890,22086,4627,275
872329132,872326105,872349796,23691,4628,275
872357176,872353931,872377821,23890,4629,275
872385199,872381956,872402996,21040,4630,275
872410310,872407282,872431946,24664,4631,275
872439248,872436222,872459576,23354,4632,275
872466884,872463857,872489154,25297,4633,275
872496379,872493350,872516706,23356,4634,275
872524085,872520841,872542829,21988,4635,275
872550208,872546964,872569903,22939,4636,275
872577157,872574130,872595269,21139,4637,275
872602497,872599469,872622508,23039,4638,275
872629887,872626644,872648632,21988,4639,275
872656011,872652767,872676677,23910,4640,275
872684056,872680812,872704067,23255,4641,275
872711376,872708349,872732674,24325,4642,275
872740054,872736809,872760064,23255,4643,275
872767332,872764305,872786730,22425,4644,275
872793980,872790952,872814942,23990,4645,275
872822164,872819137,872843147,24010,4646,275
872850377,872847349,872868805,21456,4647,275
872876016,872872987,872896028,23041,4648,275
872903407,872900163,872922786,22623,4649,275
872930044,872927017,872950055,23038,4650,275
872957270,872954241,872975067,20826,4651,275
872982447,872979202,873002143,22941,4652,275
873009402,873006374,873028780,22406,4653,275
873036160,873032915,873057458,24543,4654,275
873064688,873061661,873085671,24010,4655,275
873093052,873089807,873113716,23909,4656,275
873121002,873117976,873143905,25929,4657,275
873151153,873148126,873171818,23692,4658,275
873179036,873176009,873199048,23039,4659,275
873206427,873203183,873227389,24206,4660,275
873234768,873231524,873255115,23591,4661,275
873262407,873259379,873284023,24644,4662,275
873291319,873288291,873311963,23672,4663,275
873319208,873316180,873339219,23039,4664,275
873346464,873343437,873366791,23354,4665,275
873374172,873370927,873394519,23592,4666,275
873401829,873398802,873421522,22720,4667,275
873428901,873425657,873449884,24227,4668,275
873457146,873454118,873475574,21456,4669,275
873482852,873479823,873503812,23989,4670,275
873511052,873508025,873531061,23036,4671,275
873538440,873535196,873558472,23276,4672,275
873565714,873562686,873587625,24939,4673,275
873594875,873591848,873617778,25930,4674,275
873625157,873621914,873647405,25491,4675,275
873654784,873651540,873677030,25490,4676,275
873684281,873681254,873705264,24010,4677,275
873712514,873709487,873732841,23354,4678,275
873740082,873737055,873759775,22720,4679,275
873767155,873763910,873786534,22624,4680,275
873793913,873790669,873815191,24522,4681,275
873822441,873819414,873841839,22425,4682,275
873849086,873846059,873869415,23356,4683,275
873876694,873873666,873895755,22089,4684,275
873903133,873899890,873924115,24225,4685,275
873931428,873928400,873954963,26563,4686,275
873962266,873959237,873983565,24328,4687,275
873990871,873987844,874010883,23039,4688,275
874018122,874015094,874039737,24643,4689,275
874047116,874043872,874066810,22938,4690,275
874074189,874070946,874095488,24542,4691,275
874102775,874099748,874125044,25296,4692,275
874132350,874129323,874152700,23377,4693,275
874159942,874156916,874179637,22721,4694,275
874187016,874183772,874208611,24839,4695,275
874215857,874212829,874236186,23357,4696,275
874243428,874240401,874263460,23059,4697,275
874270713,874267686,874291359,23673,4698,275
874298738,874295494,874320692,25198,4699,275
874327938,874324911,874348287,23376,4700,275
874355589,874352561,874375938,23377,4701,275
874383176,874380148,874404158,24010,4702,275
874411436,874408409,874433706,25297,4703,275
874441084,874437841,874461095,23254,4704,275
874468378,874465350,874488390,23040,4705,275
874495604,874492577,874515954,23377,4706,275
874523333,874520089,874546235,26146,4707,275
874553448,874550420,874572826,22406,4708,275
874580048,874577021,874600397,23376,4709,275
874607775,874604532,874628103,23571,4710,275
874635388,874632361,874655717,23356,4711,275
874663001,874659974,874682401,22427,4712,275
874689780,874686536,874712366,25830,4713,275
874719627,874716599,874739005,22406,4714,275
874746246,874743219,874764673,21454,4715,275
874771905,874768877,874794492,25615,4716,275
874801872,874798628,874824139,25511,4717,275
874831378,874828350,874852676,24326,4718,275
874860056,874856812,874877535,20723,4719,275
874884914,874881671,874905264,23593,4720,275
874912644,874909400,874934259,24859,4721,275
874941567,874938540,874963182,24642,4722,275
874970561,874967317,874990277,22960,4723,275
874997578,874994551,875017293,22742,4724,275
875024521,875021494,875047107,25613,4725,275
875054487,875051243,875075153,23910,4726,275
875082416,875079389,875102109,22720,4727,275
875109488,875106245,875130154,23909,4728,275
875137317,875134289,875157545,23256,4729,275
875164834,875161807,875184844,23037,4730,275
875192008,875188979,875212573,23594,4731,275
875219875,875216849,875239570,22721,4732,275
875246869,875243842,875266881,23039,4733,275
875274186,875271159,875296773,25614,4734,275
875304076,875301048,875323454,22406,4735,275
875330685,875327658,875350400,22742,4736,275
875357684,875354657,875380271,25614,4737,275
875387575,875384548,875407587,23039,4738,275
875414965,875411722,875434343,22621,4739,275
875441620,875438593,875463869,25276,4740,275
875471183,875468154,875490582,22428,4741,275
875497860,875494832,875520129,25297,4742,275
875527339,875524312,875547351,23039,4743,275
875554618,875551591,875575601,24010,4744,275
875582980,875579736,875600775,21039,4745,275
875608153,875604910,875629136,24226,4746,275
875636347,875633319,875655726,22407,4747,275
875662977,875659950,875685226,25276,4748,275
875692605,875689361,875715170,25809,4749,275
875722416,875719390,875742766,23376,4750,275
875750146,875746901,875771424,24523,4751,275
875778658,875775629,875796454,20825,4752,275
875803833,875800589,875824793,24204,4753,275
875832092,875829065,875854679,25614,4754,275
875862059,875858815,875884646,25831,4755,275
875891873,875888846,875914777,25931,4756,275
875922081,875919054,875944033,24979,4757,275
875951195,875948168,875972054,23886,4758,275
875979354,875976327,876000991,24664,4759,275
876008263,876005237,876027979,22742,4760,275
876035248,876032221,876058171,25950,4761,275
876065550,876062306,876087164,24858,4762,275
876094546,876091300,876113947,22647,4763,275
876121326,876118082,876143258,25176,4764,275
876150560,876147533,876171542,24009,4765,275
876178704,876175677,876197983,22306,4766,275
876205217,876202191,876225229,23038,4767,275
876232609,876229364,876251671,22307,4768,275
876259050,876255806,876280009,24203,4769,275
876287308,876284281,876307952,23671,4770,275
876315214,876312187,876334614,22427,4771,275
876341777,876338749,876359473,20724,4772,275
876366717,876363690,876385777,22087,4773,275
876393156,876389912,876411268,21356,4774,275
876418550,876415523,876437612,22089,4775,275
876444855,876441826,876465836,24010,4776,275
876473216,876469972,876494853,24881,4777,275
876502149,876499122,876522477,23355,4778,275
876529755,876526728,876550716,23988,4779,275
876558095,876554851,876576207,21356,4780,275
876583440,876580412,876602524,22112,4781,275
876609903,876606659,876628015,21356,4782,275
876635245,876632218,876656860,24642,4783,275
876664237,876660995,876683953,22958,4784,275
876691175,876688149,876712178,24029,4785,275
876719483,876716456,876738228,21772,4786,275
876745606,876742363,876765004,22641,4787,275
876772231,876769204,876792579,23375,4788,275
876799844,876796817,876818906,22089,4789,275
876826284,876823041,876845367,22326,4790,275
876852606,876849579,876871985,22406,4791,275
876879231,876876204,876900213,24009,4792,275
876907591,876904348,876927624,23276,4793,275
876934849,876931823,876955199,23376,4794,275
876962445,876959417,876983745,24328,4795,275
876991122,876987880,877010181,22301,4796,275
877017445,877014418,877036823,22405,4797,275
877044202,877040958,877064868,23910,4798,275
877072245,877069003,877092595,23592,4799,275
877099973,877096730,877118719,21989,4800,275
877126098,877122854,877145792,22938,4801,275
877153053,877150027,877174669,24642,4802,275
877181969,877178943,877202317,23374,4803,275
877209554,877206529,877230199,23670,4804,275
877237472,877234446,877259426,24980,4805,275
877266690,877263663,877287990,24327,4806,275
877295368,877292125,877315695,23570,4807,275
877323074,877319830,877342768,22938,4808,275
877349997,877346970,877372879,25909,4809,275
877380259,877377015,877399637,22622,4810,275
877407016,877403772,877427006,23234,4811,275
877434225,877431198,877453602,22404,4812,275
877460981,877457737,877482279,24542,4813,275
877489504,877486478,877510148,23670,4814,275
877517527,877514283,877547098,32815,4815,275
877554259,877551234,877589986,38752,4816,275
877597205,877594178,877618819,24641,4817,275
877626197,877622954,877645258,22304,4818,275
877652474,877649447,877671852,22405,4819,275
877679074,877676046,877699105,23059,4820,275
877706484,877703240,877725230,21990,4821,275
877732609,877729365,877752642,23277,4822,275
877759867,877756842,877780216,23374,4823,275
877787448,877784421,877808113,23692,4824,275
877815357,877812331,877833786,21455,4825,275
877841039,877838013,877862020,24007,4826,275
877869238,877866210,877889883,23673,4827,275
877897116,877894090,877917443,23353,4828,275
877924687,877921661,877942799,21138,4829,275
877950177,877946934,877968923,21989,4830,275
877976209,877973181,877998458,25277,4831,275
878005750,878002724,878027366,24642,4832,275
878034629,878031604,878054344,22740,4833,275
878061723,878058480,878081419,22939,4834,275
878088797,878085554,878109779,24225,4835,275
878117007,878113980,878138326,24346,4836,275
878145592,878142565,878164991,22426,4837,275
878172369,878169126,878191748,22622,4838,275
878199126,878195883,878219476,23593,4839,275
878226715,878223688,878246727,23039,4840,275
878253888,878250862,878273167,22305,4841,275
878280546,878277302,878301211,23909,4842,275
878308481,878305455,878329461,24006,4843,275
878336686,878333660,878357036,23376,4844,275
878364328,878361302,878385311,24009,4845,275
878392690,878389447,878414936,25489,4846,275
878422236,878419209,878441298,22089,4847,275
878448514,878445488,878469476,23988,4848,275
878476853,878473611,878498469,24858,4849,275
878505727,878502701,878528946,26245,4850,275
878536223,878533197,878554651,21454,4851,275
878561887,878558861,878580948,22087,4852,275
878588180,878585152,878608530,23378,4853,275
878615762,878612736,878635773,23037,4854,275
878643020,878639993,878662420,22427,4855,275
878669652,878666625,878689981,23356,4856,275
878697360,878694116,878717055,22939,4857,275
878724285,878721259,878743345,22086,4858,275
878750722,878747480,878771071,23591,4859,275
878778315,878775289,878797378,22089,4860,275
878804756,878801513,878827025,25512,4861,275
878834405,878831161,878857309,26148,4862,275
878864587,878861560,878886835,25275,4863,275
878894113,878891086,878912858,21772,4864,275
878920157,878917131,878938268,21137,4865,275
878945486,878942460,878968051,25591,4866,275
878975431,878972187,878993543,21356,4867,275
879000774,878997748,879021439,23691,4868,275
879028689,879025662,879049355,23693,4869,275
879056733,879053490,879076427,22937,4870,275
879083588,879080562,879105104,24542,4871,275
879112482,879109239,879131544,22305,4872,275
879138922,879135679,879157350,21671,4873,275
879164587,879161559,879187489,25930,4874,275
879194711,879191685,879216009,24324,4875,275
879223233,879220207,879244215,24008,4876,275
879251510,879248483,879271227,22744,4877,275
879278534,879275508,879299178,23670,4878,275
879306557,879303314,879325619,22305,4879,275
879332998,879329755,879354612,24857,4880,275
879361864,879358838,879383500,24662,4881,275
879390879,879387636,879409623,21987,4882,275
879416866,879413839,879436899,23060,4883,275
879444276,879441034,879463991,22957,4884,275
879471225,879468198,879494444,26246,4885,275
879501823,879498580,879519935,21355,4886,275
879527193,879524167,879551066,26899,4887,275
879558444,879555202,879579743,24541,4888,275
879586977,879583951,879606356,22405,4889,275
879613573,879610547,879632973,22426,4890,275
879640135,879637109,879660364,23255,4891,275
879667527,879664500,879686807,22307,4892,275
879694043,879691016,879713420,22404,4893,275
879720731,879717705,879742028,24323,4894,275
879749271,879746244,879769598,23354,4895,275
879776840,879773814,879794319,20505,4896,275
879801697,879798454,879822026,23572,4897,275
879829259,879826232,879848321,22089,4898,275
879855571,879852545,879875582,23037,4899,275
879882960,879879717,879902655,22938,4900,275
879910032,879906790,879928777,21987,4901,275
879936037,879933010,879957652,24642,4902,275
879964933,879961907,879984332,22425,4903,275
879991624,879988597,880010371,21774,4904,275
880017661,880014634,880038642,24008,4905,275
880045886,880042860,880065579,22719,4906,275
880072880,880069853,880092596,22743,4907,275
880099974,880096731,880120617,23886,4908,275
880127779,880124752,880149949,25197,4909,275
880157242,880154215,880179512,25297,4910,275
880186796,880183770,880209064,25294,4911,275
880216284,880213259,880239841,26582,4912,275
880247066,880244038,880266128,22090,4913,275
880273506,880270263,880295122,24859,4914,275
880302351,880299325,880323649,24324,4915,275
880330926,880327899,880350642,22743,4916,275
880358020,880354777,880377714,22937,4917,275
880385020,880381995,880406298,24303,4918,275
880413532,880410504,880434514,24010,4919,275
880441750,880438721,880462395,23674,4920,275
880469642,880466616,880488387,21771,4921,275
880495695,880492669,880516677,24008,4922,275
880524054,880520812,880544383,23571,4923,275
880551762,880548519,880572745,24226,4924,275
880579979,880576954,880598724,21770,4925,275
880605999,880602973,880626663,23690,4926,275
880634042,880630799,880655341,24542,4927,275
880662503,880659476,880683700,24224,4928,275
880690924,880687897,880710007,22110,4929,275
880717387,880714142,880736133,21991,4930,275
880743421,880740394,880765669,25275,4931,275
880772900,880769873,880792594,22721,4932,275
880799819,880796792,880820802,24010,4933,275
880828180,880824937,880851083,26146,4934,275
880858312,880855285,880878637,23352,4935,275
880886015,880882772,880904445,21673,4936,275
880911686,880908659,880930748,22089,4937,275
880938020,880934993,880958347,23354,4938,275
880965630,880962603,880985344,22741,4939,275
880992622,880989593,881014871,25278,4940,275
881022174,881019148,881043811,24663,4941,275
881051121,881048094,881071765,23671,4942,275
881079008,881075980,881098069,22089,4943,275
881105299,881102272,881124994,22722,4944,275
881132220,881129194,881154805,25611,4945,275
881162013,881158986,881181392,22406,4946,275
881188657,881185630,881207718,22088,4947,275
881215096,881211853,881236395,24542,4948,275
881243627,881240602,881266214,25612,4949,275
881273469,881270442,881294113,23671,4950,275
881301366,881298339,881322960,24621,4951,275
881330180,881327154,881349558,22404,4952,275
881356938,881353693,881378533,24840,4953,275
881385818,881382790,881405513,22723,4954,275
881412758,881409731,881433402,23671,4955,275
881440781,881437538,881461425,23887,4956,275
881468724,881465696,881488100,22404,4957,275
881495479,881492235,881517411,25176,4958,275
881524789,881521546,881545456,23910,4959,275
881552685,881549658,881582257,32599,4960,275
881589474,881586447,881610454,24007,4961,275
881617677,881614651,881637689,23038,4962,275
881644942,881641915,881666895,24980,4963,275
881674274,881671030,881694959,23929,4964,275
881702336,881699094,881721081,21987,4965,275
881728315,881725288,881749297,24009,4966,275
881756675,881753432,881777995,24563,4967,275
881785287,881782260,881805002,22742,4968,275
881812380,881809137,881831442,22305,4969,275
881838665,881835637,881857409,21772,4970,275
881864688,881861662,881886935,25273,4971,275
881894237,881891212,881915874,24662,4972,275
881923145,881920118,881944781,24663,4973,275
881952019,881948992,881970447,21455,4974,275
881977826,881974582,881998470,23888,4975,275
882005714,882002688,882025746,23058,4976,275
882033125,882029881,882054741,24860,4977,275
882062120,882058876,882081814,22938,4978,275
882089058,882086032,882110673,24641,4979,275
882117962,882114935,882137340,22405,4980,275
882144638,882141612,882164670,23058,4981,275
882171964,882168938,882190391,21453,4982,275
882197630,882194604,882219245,24641,4983,275
882226555,882223528,882245301,21773,4984,275
882252563,882249537,882271962,22425,4985,275
882279340,882276097,882299983,23886,4986,275
882307215,882304189,882327544,23355,4987,275
882334774,882331747,882352886,21139,4988,275
882360265,882357021,882381247,24226,4989,275
882388625,882385382,882410241,24859,4990,275
882417493,882414465,882439425,24960,4991,275
882446804,882443561,882467785,24224,4992,275
882475075,882472049,882497345,25296,4993,275
882504621,882501594,882524000,22406,4994,275
882531378,882528135,882552994,24859,4995,275
882560203,882557177,882582788,25611,4996,275
882590040,882587013,882609418,22405,4997,275
882616796,882613553,882637440,23887,4998,275
882644601,882641575,882665799,24224,4999,275
882673016,882669990,882691445,21455,5000,275
882698826,882695643,882720503,24860,1,300
882727636,882724452,882746124,21672,2,300
882753388,882749989,882773797,23808,3,300
882781063,882777663,882803075,25412,4,300
882810341,882806941,882829802,22861,5,300
882837068,882833668,882855577,21909,6,300
882862843,882859442,882884225,24783,7,300
882891492,882888091,882909368,21277,8,300
882916635,882913234,882935779,22545,9,300
882942892,882939708,882963619,23911,10,300
882970973,882967573,882991720,24147,11,300
882999074,882995674,883020454,24780,12,300
883027677,883024493,883047770,23277,13,300
883055124,883051724,883078088,26364,14,300
883085443,883082043,883105219,23176,15,300
883112574,883109174,883132982,23808,16,300
883140209,883137025,883163193,26168,17,300
883170387,883167203,883193033,25830,18,300
883200390,883196988,883221117,24129,19,300
883228473,883225071,883250825,25754,20,300
883258180,883254780,883278611,23831,21,300
883285794,883282611,883308440,25829,22,300
883315795,883312395,883336543,24148,23,300
883343899,883340498,883365258,24760,24,300
883372538,883369354,883394552,25198,25,300
883401907,883398507,883422654,24147,26,300
883430010,883426609,883449786,23177,27,300
883457142,883453741,883477869,24128,28,300
883485225,883481824,883505654,23830,29,300
883512855,883509671,883530709,21038,30,300
883538009,883534825,883559072,24247,31,300
883566429,883563027,883586185,23158,32,300
883593413,883590230,883612874,22644,33,300
883620230,883616829,883640302,23473,34,300
883647657,883644257,883665830,21573,35,300
883673185,883669785,883694248,24463,36,300
883701472,883698289,883720617,22328,37,300
883727810,883724626,883748536,23910,38,300
883755890,883752491,883777250,24759,39,300
883784485,883781301,883808102,26801,40,300
883815458,883812057,883834285,22228,41,300
883841641,883838240,883862683,24443,42,300
883870038,883866638,883890785,24147,43,300
883898141,883894740,883920154,25414,44,300
883927509,883924109,883947602,23493,45,300
883954844,883951661,883973354,21693,46,300
883980710,883977309,884003674,26365,47,300
884010966,884007783,884031038,23255,48,300
884038393,884034993,884060745,25752,49,300
884068024,884064840,884087483,22643,50,300
884094772,884091589,884112627,21038,51,300
884119981,884116582,884140709,24127,52,300
884148066,884144664,884167187,22523,53,300
884174543,884171142,884196555,25413,54,300
884203910,884200510,884224320,23810,55,300
884231599,884228415,884252662,24247,56,300
884259961,884256777,884280349,23572,57,300
884287704,884284304,884308429,24125,58,300
884315784,884312384,884336848,24464,59,300
884344203,884340803,884364276,23473,60,300
884371556,884368372,884391986,23614,61,300
884399278,884396095,884420342,24247,62,300
884427640,884424457,884447731,23274,63,300
884455088,884451686,884475815,24129,64,300
884483170,884479770,884504235,24465,65,300
884511591,884508190,884531685,23495,66,300
884538968,884535784,884559039,23255,67,300
884566393,884562994,884587457,24463,68,300
884594813,884591412,884614907,23495,69,300
884622263,884618862,884642040,23178,70,300
884649394,884645995,884670436,24441,71,300
884677791,884674391,884698517,24126,72,300
884705872,884702473,884727885,25412,73,300
884735113,884731929,884756196,24267,74,300
884763551,884760151,884781091,20940,75,300
884788446,884785046,884808540,23494,76,300
884815897,884812495,884836958,24463,77,300
884844312,884840913,884866009,25096,78,300
884873363,884869963,884894089,24126,79,300
884901442,884898043,884923773,25730,80,300
884931128,884927728,884953458,25730,81,300
884960813,884957413,884983459,26046,82,300
884990767,884987582,885009593,22011,83,300
885016947,885013548,885038624,25076,84,300
885045979,885042579,885065101,22522,85,300
885072367,885069183,885092142,22959,86,300
885099392,885096207,885120139,23932,87,300
885127494,885124093,885147923,23830,88,300
885155278,885151878,885175370,23492,89,300
885182601,885179418,885202378,22960,90,300
885209733,885206333,885228560,22227,91,300
885235915,885232515,885256662,24147,92,300
885264018,885260617,885283815,23198,93,300
885291082,885287898,885312779,24881,94,300
885320087,885316904,885339209,22305,95,300
885346564,885343164,885366318,23154,96,300
885373613,885370431,885392757,22326,97,300
885400057,885396874,885419537,22663,98,300
885426892,885423492,885446668,23176,99,300
885454024,885450623,885475067,24444,100,300
885482510,885479110,885504524,25414,101,300
885511967,885508567,885533326,24759,102,300
885540629,885537446,885562957,25511,103,300
885570401,885567001,885592730,25729,104,300
885600174,885596774,885618367,21593,105,300
885625810,885622410,885647507,25097,106,300
885654799,885651615,885675842,24227,107,300
885683172,885679989,885702928,22939,108,300
885710374,885706972,885731417,24445,109,300
885738725,885735541,885758184,22643,110,300
885765458,885762275,885784286,22011,111,300
885791730,885788329,885812159,23830,112,300
885819491,885816308,885840218,23910,113,300
885847569,885844386,885869265,24879,114,300
885876554,885873372,885895698,22326,115,300
885903142,885899742,885923572,23830,116,300
885931015,885927616,885952712,25096,117,300
885960042,885956859,885982688,25829,118,300
885990132,885986732,886013432,26700,119,300
886020876,886017476,886041307,23831,120,300
886048751,886045351,886068527,23176,121,300
886075860,886072677,886094687,22010,122,300
886102129,886098730,886124143,25413,123,300
886131588,886128187,886151678,23491,124,300
886159122,886155721,886177950,22229,125,300
886185277,886182094,886205371,23277,126,300
886212815,886209415,886233541,24126,127,300
886240984,886237584,886264284,26700,128,300
886271729,886268328,886293426,25098,129,300
886300709,886297524,886321436,23912,130,300
886328740,886325556,886348833,23277,131,300
886356127,886352943,886377802,24859,132,300
886385245,886381845,886403439,21594,133,300
886410884,886407483,886431292,23809,134,300
886438567,886435384,886457710,22326,135,300
886465154,886461753,886485565,23812,136,300
886492856,886489673,886511977,22304,137,300
886519421,886516021,886542385,26364,138,300
886549829,886546429,886571525,25096,139,300
886578968,886575568,886598408,22840,140,300
886605851,886602452,886625945,23493,141,300
886633388,886629988,886653165,23177,142,300
886660610,886657209,886680071,22862,143,300
886687513,886684114,886706974,22860,144,300
886714419,886711018,886732593,21575,145,300
886740038,886736637,886760785,24148,146,300
886768066,886764882,886788159,23277,147,300
886795509,886792324,886815601,23277,148,300
886823044,886819644,886844087,24443,149,300
886851532,886848131,886874812,26681,150,300
886882256,886878856,886900743,21887,151,300
886908188,886904787,886928936,24149,152,300
886936213,886933031,886956284,23253,153,300
886963628,886960445,886984037,23592,154,300
886991483,886988081,887012863,24782,155,300
887020307,887016907,887041666,24759,156,300
887048986,887045802,887068108,22306,157,300
887075552,887072152,887099486,27334,158,300
887106779,887103595,887128476,24881,159,300
887135762,887132578,887156489,23911,160,300
887163933,887160533,887184025,23492,161,300
887191470,887188069,887212195,24126,162,300
887219639,887216239,887240997,24758,163,300
887248442,887245041,887267586,22545,164,300
887275031,887271630,887295441,23811,165,300
887302886,887299486,887322347,22861,166,300
887329663,887326479,887352648,26169,167,300
887359997,887356814,887381378,24564,168,300
887388733,887385550,887410113,24563,169,300
887417412,887414229,887440714,26485,170,300
887448011,887444829,887468103,23274,171,300
887475548,887472147,887496929,24782,172,300
887504274,887501091,887526604,25513,173,300
887533939,887530755,887555319,24564,174,300
887562765,887559363,887584126,24763,175,300
887591570,887588170,887611979,23809,176,300
887619280,887616096,887639374,23278,177,300
887646664,887643481,887667390,23909,178,300
887674834,887671434,887694295,22861,179,300
887701739,887698339,887722463,24124,180,300
887729908,887726507,887749684,23177,181,300
887757130,887753729,887778195,24466,182,300
887785639,887782239,887805733,23494,183,300
887813090,887809905,887835421,25516,184,300
887842866,887839466,887863907,24441,185,300
887871351,887867951,887893702,25751,186,300
887901148,887897747,887922823,25076,187,300
887930268,887926867,887950676,23809,188,300
887958120,887954720,887979163,24443,189,300
887986475,887983292,888006569,23277,190,300
888014013,888010613,888033473,22860,191,300
888040918,888037517,888061012,23495,192,300
888068456,888065056,888087914,22858,193,300
888095358,888091958,888117054,25096,194,300
888124385,888121201,888145766,24565,195,300
888153056,888149871,888176356,26485,196,300
888183802,888180401,888202311,21910,197,300
888209754,888206355,888231451,25096,198,300
888238896,888235495,888259623,24128,199,300
888266976,888263792,888286415,22623,200,300
888293860,888290460,888312684,22224,201,300
888320129,888316729,888340538,23809,202,300
888347824,888344641,888368867,24226,203,300
888376173,888372989,888397870,24881,204,300
888405315,888401914,888426040,24126,205,300
888433486,888430085,888451976,21891,206,300
888459421,888456020,888478228,22208,207,300
888485673,888482273,888520159,37886,208,300
888527606,888524204,888560847,36643,209,300
888568136,888564953,888588229,23276,210,300
888595674,888592274,888618659,26385,211,300
888626104,888622704,888645563,22859,212,300
888653007,888649608,888671813,22205,213,300
888679108,888675924,888705702,29778,214,300
888713147,888709747,888735160,25413,215,300
888742451,888739268,888764485,25217,216,300
888771931,888768530,888793288,24758,217,300
888800732,888797333,888819222,21889,218,300
888826667,888823267,888847710,24443,219,300
888855156,888851755,888874932,23177,220,300
888882375,888878976,888903755,24779,221,300
888911200,888907800,888931294,23494,222,300
888938651,888935468,888960031,24563,223,300
888967475,888964076,888990143,26067,224,300
888997451,888994268,889019464,25196,225,300
889026910,889023509,889049578,26069,226,300
889057023,889053623,889080007,26384,227,300
889087358,889084174,889108738,24564,228,300
889116183,889112783,889135622,22839,229,300
889143068,889139667,889161556,21889,230,300
889169000,889165600,889186559,20959,231,300
889193831,889190649,889216183,25534,232,300
889223628,889220228,889244692,24464,233,300
889252025,889248840,889270515,21675,234,300
889277833,889274650,889297927,23277,235,300
889305371,889301972,889326414,24442,236,300
889333859,889330459,889353654,23195,237,300
889361098,889357699,889380243,22544,238,300
889387688,889384288,889407465,23177,239,300
889414910,889411510,889436607,25097,240,300
889443929,889440746,889464655,23909,241,300
889471943,889468760,889491720,22960,242,300
889499050,889495866,889518194,22328,243,300
889525484,889522300,889546845,24545,244,300
889554170,889550987,889574264,23277,245,300
889581710,889578309,889599566,21257,246,300
889607012,889603611,889629045,25434,247,300
889636489,889633090,889656287,23197,248,300
889663732,889660332,889682221,21889,249,300
889689666,889686266,889709104,22838,250,300
889716548,889713149,889737274,24125,251,300
889744552,889741369,889764962,23593,252,300
889772408,889769007,889793153,24146,253,300
889800597,889797197,889819107,21910,254,300
889826552,889823152,889847912,24760,255,300
889855357,889851957,889878025,26068,256,300
889885470,889882071,889905900,23829,257,300
889913345,889909945,889932172,22227,258,300
889939617,889936217,889959078,22861,259,300
889966390,889963207,889988404,25197,260,300
889995682,889992498,890016091,23593,261,300
890023421,890020238,890044781,24543,262,300
890052227,890048826,890070400,21574,263,300
890077715,890074530,890095592,21062,264,300
890102821,890099637,890124934,25297,265,300
890132263,890129080,890154275,25195,266,300
890161721,890158320,890181813,23493,267,300
890189259,890185858,890210956,25098,268,300
890218274,890215091,890239655,24564,269,300
890247100,890243700,890267510,23810,270,300
890274858,890271675,890295606,23931,271,300
890302932,890299749,890324630,24881,272,300
890332075,890328675,890351536,22861,273,300
890358981,890355581,890378126,22545,274,300
890385573,890382171,890407587,25416,275,300
890415031,890411632,890437697,26065,276,300
890445141,890441742,890464578,22836,277,300
890472022,890468623,890492431,23808,278,300
890499745,890496562,890518888,22326,279,300
890526335,890522933,890547083,24150,280,300
890554394,890551211,890572588,21377,281,300
890580034,890576633,890601078,24445,282,300
890608522,890605123,890629248,24125,283,300
890636694,890633293,890657083,23790,284,300
890664378,890661195,890685420,24225,285,300
890692865,890689465,890713296,23831,286,300
890720593,890717410,890741003,23593,287,300
890748290,890745105,890770619,25514,288,300
890777901,890774717,890800231,25514,289,300
890807677,890804277,890827432,23155,290,300
890834879,890831477,890855290,23813,291,300
890862649,890859465,890883374,23909,292,300
890890700,890887517,890912397,24880,293,300
890919684,890916500,890940094,23594,294,300
890947540,890944139,890968583,24444,295,300
890976029,890972628,890997388,24760,296,300
891004738,891001553,891025169,23616,297,300
891032472,891029287,891052883,23596,298,300
891060329,891056928,891079155,22227,299,300
891086450,891083266,891109117,25851,300,300
891116395,891113212,891135855,22643,301,300
891143301,891139900,891164362,24462,302,300
891171687,891168502,891192435,23933,303,300
891199881,891196480,891222529,26049,304,300
891229975,891226574,891249732,23158,305,300
891257178,891253777,891276322,22545,306,300
891283638,891280454,891304048,23594,307,300
891311494,891308093,891331586,23493,308,300
891339031,891335630,891361676,26046,309,300
891368966,891365782,891390346,24564,310,300
891397791,891394391,891420439,26048,311,300
891427753,891424569,891448795,24226,312,300
891456239,891452839,891476649,23810,313,300
891483959,891480774,891505003,24229,314,300
891512285,891509099,891530142,21043,315,300
891537444,891534259,891565790,31531,316,300
891573073,891569888,891594115,24227,317,300
891601449,891598265,891620909,22644,318,300
891628355,891624954,891647159,22205,319,300
891654453,891651269,891675201,23932,320,300
891682481,891679298,891700991,21693,321,300
891708437,891705036,891729817,24781,322,300
891737262,891733862,891759592,25730,323,300
891766877,891763693,891786358,22665,324,300
891793803,891790402,891815499,25097,325,300
891822776,891819591,891844136,24545,326,300
891851455,891848271,891870916,22645,327,300
891878362,891874961,891898139,23178,328,300
891905586,891902184,891926016,23832,329,300
891933462,891930061,891952625,22564,330,300
891960070,891956670,891980501,23831,331,300
891987948,891984546,892007428,22882,332,300
892014750,892011566,892037733,26167,333,300
892045178,892041778,892063351,21573,334,300
892070675,892067491,892090452,22961,335,300
892097788,892094604,892116931,22327,336,300
892124377,892120976,892145758,24782,337,300
892153205,892149803,892172981,23178,338,300
892180428,892177026,892198283,21257,339,300
892205728,892202327,892226793,24466,340,300
892234120,892230936,892253897,22961,341,300
892261344,892257942,892283694,25752,342,300
892291140,892287739,892312184,24445,343,300
892319496,892316311,892337670,21359,344,300
892344999,892341815,892364796,22981,345,300
892372241,892368841,892394571,25730,346,300
892402019,892398616,892425636,27020,347,300
892433082,892429681,892453197,23516,348,300
892460643,892457242,892480103,22861,349,300
892487549,892484148,892507979,23831,350,300
892515293,892512108,892537623,25515,351,300
892545068,892541668,892565162,23494,352,300
892572608,892569207,892595276,26069,353,300
892602561,892599377,892625545,26168,354,300
892632853,892629669,892653579,23910,355,300
892661024,892657624,892683691,26067,356,300
892690994,892687809,892711404,23595,357,300
892718850,892715449,892738626,23177,358,300
892746073,892742671,892766483,23812,359,300
892773929,892770528,892792757,22229,360,300
892800034,892796849,892822681,25832,361,300
892830128,892826727,892853111,26384,362,300
892860424,892857239,892881803,24564,363,300
892889089,892885905,892909498,23593,364,300
892916944,892913543,892936109,22566,365,300
892943555,892940154,892962697,22543,366,300
892970033,892966847,892992068,25221,367,300
892999512,892996112,893020575,24463,368,300
893027903,893024718,893047997,23279,369,300
893055328,893052141,893074492,22351,370,300
893081853,893078668,893102599,23931,371,300
893109901,893106716,893130311,23595,372,300
893137757,893134356,893157851,23495,373,300
893165297,893161896,893185072,23176,374,300
893192519,893189117,893212951,23834,375,300
893220397,893216996,893240808,23812,376,300
893248253,893244853,893269635,24782,377,300
893277081,893273680,893296835,23155,378,300
893304132,893300948,893323591,22643,379,300
893330881,893327696,893349053,21357,380,300
893356500,893353098,893378196,25098,381,300
893385643,893382241,893407974,25733,382,300
893415423,893412020,893436803,24783,383,300
893444249,893440848,893464996,24148,384,300
893472442,893469040,893491268,22228,385,300
893498713,893495312,893521675,26363,386,300
893528986,893525801,893548150,22349,387,300
893555596,893552195,893576006,23811,388,300
893583453,893580051,893603864,23813,389,300
893611310,893607909,893632689,24780,390,300
893640136,893636734,893662804,26070,391,300
893670250,893666849,893692579,25730,392,300
893700025,893696624,893720770,24146,393,300
893728216,893724815,893747993,23178,394,300
893755439,893752038,893775512,23474,395,300
893782792,893779608,893803540,23932,396,300
893810985,893807585,893830423,22838,397,300
893837870,893834468,893859251,24783,398,300
893866559,893863373,893885047,21674,399,300
893892494,893889092,893915477,26385,400,300
893922800,893919615,893942557,22942,401,300
893950003,893946602,893970412,23810,402,300
893977858,893974457,893997655,23198,403,300
894005101,894001700,894025828,24128,404,300
894033114,894029930,894053861,23931,405,300
894061189,894058005,894082885,24880,406,300
894090188,894087002,894110619,23617,407,300
894117932,894114746,894140261,25515,408,300
894147548,894144363,894167621,23258,409,300
894175066,894171665,894194232,22567,410,300
894201549,894198364,894221642,23278,411,300
894228988,894225804,894247793,21989,412,300
894255076,894251891,894274536,22645,413,300
894281981,894278581,894302074,23493,414,300
894309377,894306194,894329153,22959,415,300
894336477,894333293,894357541,24248,416,300
894364849,894361665,894385913,24248,417,300
894393200,894390016,894414244,24228,418,300
894421690,894418289,894444335,26046,419,300
894451782,894448380,894471220,22840,420,300
894478666,894475265,894497811,22546,421,300
894505257,894501856,894525645,23789,422,300
894532930,894529746,894553359,23613,423,300
894560804,894557404,894582818,25414,424,300
894590155,894586969,894611537,24568,425,300
894618983,894615582,894640048,24466,426,300
894647493,894644092,894666321,22229,427,300
894673767,894670366,894693544,23178,428,300
894700990,894697589,894723002,25413,429,300
894730448,894727047,894750539,23492,430,300
894757985,894754584,894778416,23832,431,300
894785697,894782512,894806738,24226,432,300
894814184,894810783,894835227,24444,433,300
894842673,894839272,894865003,25731,434,300
894872449,894869048,894893831,24783,435,300
894901277,894897876,894922975,25099,436,300
894930421,894927020,894952751,25731,437,300
894960198,894956797,894979954,23157,438,300
894987305,894984121,895007061,22940,439,300
895014508,895011106,895036206,25100,440,300
895043562,895040377,895065259,24882,441,300
895072706,895069304,895093431,24127,442,300
895100876,895097476,895119385,21909,443,300
895126718,895123533,895146811,23278,444,300
895154258,895150856,895175975,25119,445,300
895183422,895180020,895204801,24781,446,300
895212248,895208846,895232319,23473,447,300
895239765,895236364,895260492,24128,448,300
895267938,895264537,895285794,21257,449,300
895293148,895289964,895316110,26146,450,300
895323408,895320223,895343502,23279,451,300
895350845,895347662,895374145,26483,452,300
895381592,895378191,895401053,22862,453,300
895408500,895405098,895431485,26387,454,300
895438932,895435530,895458076,22546,455,300
895465522,895462121,895485615,23494,456,300
895493061,895489660,895513807,24147,457,300
895521253,895517852,895542297,24445,458,300
895549742,895546342,895570764,24422,459,300
895578211,895574809,895600857,26048,460,300
895608303,895604902,895629030,24128,461,300
895636476,895633075,895657541,24466,462,300
895664986,895661586,895683814,22228,463,300
895691169,895687984,895712529,24545,464,300
895719811,895716627,895741171,24544,465,300
895748479,895745295,895766674,21379,466,300
895774121,895770719,895792632,21913,467,300
895799924,895796740,895820334,23594,468,300
895827694,895824510,895849706,25196,469,300
895857152,895853751,895875325,21574,470,300
895882632,895879448,895903043,23595,471,300
895910488,895907088,895931215,24127,472,300
895938662,895935260,895961646,26386,473,300
895968995,895965810,895987187,21377,474,300
895994507,895991322,896016203,24881,475,300
896023649,896020248,896045030,24782,476,300
896052477,896049075,896072592,23517,477,300
896079906,896076720,896100969,24249,478,300
896108415,896105014,896128509,23495,479,300
896135954,896132553,896156384,23831,480,300
896163713,896160529,896183804,23275,481,300
896191250,896187849,896209740,21891,482,300
896217045,896213860,896236483,22623,483,300
896243930,896240528,896263707,23179,484,300
896270986,896267802,896293000,25198,485,300
896300353,896297169,896323335,26166,486,300
896330662,896327478,896351091,23613,487,300
896358537,896355136,896377996,22860,488,300
896385444,896382041,896404902,22861,489,300
896412348,896408946,896432780,23834,490,300
896440136,896436951,896462149,25198,491,300
896469595,896466194,896490680,24486,492,300
896498007,896494823,896519367,24544,493,300
896526812,896523411,896548824,25413,494,300
896556269,896552868,896577966,25098,495,300
896585412,896582011,896608374,26363,496,300
896615820,896612419,896637495,25076,497,300
896644828,896641644,896664922,23278,498,300
896672227,896669042,896694219,25177,499,300
896701664,896698264,896719837,21573,500,300
896727285,896723882,896747060,23178,501,300
896754392,896751208,896776088,24880,502,300
896783533,896780133,896803927,23794,503,300
896811373,896807972,896830180,22208,504,300
896837493,896834309,896859189,24880,505,300
896866635,896863234,896887361,24127,506,300
896894807,896891406,896916167,24761,507,300
896923613,896920212,896943390,23178,508,300
896950711,896947527,896971143,23616,509,300
896978456,896975271,897000471,25200,510,300
897007791,897004606,897029173,24567,511,300
897036619,897033218,897056397,23179,512,300
897063843,897060442,897085518,25076,513,300
897092965,897089563,897116581,27018,514,300
897124027,897120626,897143805,23179,515,300
897151251,897147850,897172926,25076,516,300
897180237,897177052,897203199,26147,517,300
897210646,897207245,897227890,20645,518,300
897235336,897231935,897255767,23832,519,300
897263041,897259857,897284402,24545,520,300
897291710,897288526,897309587,21061,521,300
897317035,897313632,897337445,23813,522,300
897344891,897341490,897365618,24128,523,300
897373064,897369663,897393137,23474,524,300
897400454,897397271,897421498,24227,525,300
897428943,897425543,897449669,24126,526,300
897456955,897453771,897475761,21990,527,300
897483207,897479806,897504252,24446,528,300
897511566,897508382,897531027,22645,529,300
897538472,897535072,897557912,22840,530,300
897565359,897561957,897587373,25416,531,300
897594819,897591418,897615861,24443,532,300
897623213,897620029,897642335,22306,533,300
897649782,897646380,897671163,24783,534,300
897678439,897675254,897700137,24883,535,300
897707441,897704257,897726923,22666,536,300
897734368,897730967,897753830,22863,537,300
897761276,897757875,897781370,23495,538,300
897788724,897785540,897810401,24861,539,300
897817847,897814446,897838258,23812,540,300
897845703,897842303,897867103,24800,541,300
897874551,897871148,897897513,26365,542,300
897904846,897901661,897924307,22646,543,300
897931753,897928352,897952480,24128,544,300
897959927,897956525,897979388,22863,545,300
897986672,897983488,898008687,25199,546,300
898016019,898012834,898038687,25853,547,300
898046039,898042855,898068369,25514,548,300
898075816,898072414,898094960,22546,549,300
898102268,898099085,898122699,23614,550,300
898130148,898126744,898151485,24741,551,300
898158764,898155579,898177888,22309,552,300
898185333,898181933,898208634,26701,553,300
898216080,898212679,898236511,23832,554,300
898243958,898240556,898263714,23158,555,300
898271038,898267854,898291765,23911,556,300
898299114,898295930,898320813,24883,557,300
898328261,898324858,898350590,25732,558,300
898358036,898354635,898380050,25415,559,300
898387496,898384095,898407590,23495,560,300
898415036,898411635,898436081,24446,561,300
898443527,898440125,898463305,23180,562,300
898470751,898467350,898492449,25099,563,300
898499894,898496494,898520641,24147,564,300
898527971,898524787,898548718,23931,565,300
898556164,898552763,898577862,25099,566,300
898585140,898581956,898606858,24902,567,300
898614304,898610903,898634058,23155,568,300
898641344,898638159,898660805,22646,569,300
898668088,898664903,898690398,25495,570,300
898697697,898694513,898716862,22349,571,300
898724308,898720907,898745034,24127,572,300
898752479,898749079,898771623,22544,573,300
898779068,898775668,898799499,23831,574,300
898806945,898803544,898827060,23516,575,300
898834360,898831176,898855109,23933,576,300
898862387,898859203,898882798,23595,577,300
898890245,898886843,898913208,26365,578,300
898920495,898917310,898940272,22962,579,300
898947717,898944317,898967515,23198,580,300
898974868,898971684,898994643,22959,581,300
899002088,898998688,899020579,21891,582,300
899028026,899024624,899048141,23517,583,300
899055461,899052275,899074920,22645,584,300
899082367,899078965,899104401,25436,585,300
899111846,899108446,899132910,24464,586,300
899140356,899136955,899160470,23515,587,300
899167916,899164515,899188304,23789,588,300
899195615,899192431,899215413,22982,589,300
899222710,899219526,899244407,24881,590,300
899251710,899248525,899272121,23596,591,300
899279396,899276212,899301094,24882,592,300
899308540,899305139,899328635,23496,593,300
899335936,899332751,899356028,23277,594,300
899363373,899360189,899383150,22961,595,300
899390595,899387194,899413897,26703,596,300
899421179,899417995,899440303,22308,597,300
899447750,899444348,899468477,24129,598,300
899475924,899472522,899497285,24763,599,300
899504635,899501451,899526629,25178,600,300
899534075,899530674,899552269,21595,601,300
899559576,899556392,899580304,23912,602,300
899587750,899584349,899608816,24467,603,300
899616262,899612860,899635090,22230,604,300
899642412,899639227,899662211,22984,605,300
899669657,899666256,899691354,25098,606,300
899698800,899695399,899719568,24169,607,300
899727014,899723613,899746770,23157,608,300
899754216,899750815,899773971,23156,609,300
899781294,899778109,899801082,22973,610,300
899808368,899805183,899827491,22308,611,300
899834937,899831536,899854080,22544,612,300
899861434,899858250,899884417,26167,613,300
899891864,899888463,899912611,24148,614,300
899919936,899916752,899941632,24880,615,300
899948934,899945750,899971264,25514,616,300
899978710,899975309,899998804,23495,617,300
900006092,900002908,900027767,24859,618,300
900035213,900031812,900056257,24445,619,300
900063704,900060302,900081560,21258,620,300
900089007,900085605,900111021,25416,621,300
900118467,900115066,900139508,24442,622,300
900146793,900143609,900165936,22327,623,300
900173231,900170048,900193008,22960,624,300
900200454,900197053,900220884,23831,625,300
900228330,900224929,900249373,24444,626,300
900256819,900253418,900276280,22862,627,300
900283561,900280376,900303317,22941,628,300
900310605,900307421,900332619,25198,629,300
900340064,900336664,900360178,23514,630,300
900367624,900364223,900390270,26047,631,300
900397717,900394316,900416207,21891,632,300
900423653,900420252,900445012,24760,633,300
900452458,900449057,900470968,21911,634,300
900478413,900475013,900497558,22545,635,300
900504835,900501650,900524275,22625,636,300
900531597,900528413,900550422,22009,637,300
900557869,900554467,900578933,24466,638,300
900586379,900582978,900606473,23495,639,300
900613920,900610518,900633695,23177,640,300
900641142,900637740,900663155,25415,641,300
900670432,900667248,900690209,22961,642,300
900697656,900694254,900719353,25099,643,300
900726799,900723398,900747189,23791,644,300
900754636,900751234,900774729,23495,645,300
900782175,900778774,900803873,25099,646,300
900811195,900808011,900831287,23276,647,300
900838735,900835332,900860432,25100,648,300
900867877,900864477,900888645,24168,649,300
900895945,900892762,900917325,24563,650,300
900924677,900921493,900947324,25831,651,300
900954771,900951370,900973934,22564,652,300
900981249,900978065,901001363,23298,653,300
901009844,901005408,901031225,25817,654,300
901038514,901035329,901059896,24567,655,300
901067342,901063941,901088090,24149,656,300
901095537,901092135,901117887,25752,657,300
901125335,901121933,901148299,26366,658,300
901155744,901152344,901177124,24780,659,300
901184438,901181252,901204848,23596,660,300
901212194,901209010,901230999,21989,661,300
901238445,901235044,901259172,24128,662,300
901266616,901263216,901286708,23492,663,300
901294154,901290753,901312980,22227,664,300
901320261,901317077,901340038,22961,665,300
901347312,901344127,901367404,23277,666,300
901374848,901371448,901394942,23494,667,300
901402388,901398987,901423133,24146,668,300
901430480,901427295,901452177,24882,669,300
901459499,901456314,901480857,24543,670,300
901488156,901484971,901509515,24544,671,300
901516962,901513560,901535789,22229,672,300
901543235,901539834,901563981,24147,673,300
901571261,901568077,901590404,22327,674,300
901597716,901594532,901620025,25493,675,300
901627471,901624070,901648197,24127,676,300
901655504,901652320,901677834,25514,677,300
901685281,901681879,901706028,24149,678,300
901713474,901710073,901733568,23495,679,300
901741015,901737613,901761088,23475,680,300
901768422,901765238,901788536,23298,681,300
901795981,901792580,901816686,24106,682,300
901823976,901820791,901845334,24543,683,300
901852780,901849379,901874771,25392,684,300
901882075,901878889,901900565,21676,685,300
901908010,901904610,901927807,23197,686,300
901935253,901931852,901957581,25729,687,300
901965027,901961626,901985100,23474,688,300
901992546,901989145,902012955,23810,689,300
902020401,902017000,902040515,23515,690,300
902047803,902044618,902065996,21378,691,300
902073442,902070041,902095138,25097,692,300
902102586,902099183,902124916,25733,693,300
902132362,902128961,902152751,23790,694,300
902160076,902156892,902180801,23909,695,300
902188246,902184845,902208339,23494,696,300
902215625,902212442,902235718,23276,697,300
902243164,902239763,902261042,21279,698,300
902268488,902265087,902287969,22882,699,300
902295292,902292107,902316335,24228,700,300
902323781,902320380,902343241,22861,701,300
902350551,902347366,902369378,22012,702,300
902376709,902373525,902396190,22665,703,300
902403636,902400235,902425015,24780,704,300
902432461,902429060,902452892,23832,705,300
902460338,902456937,902483912,26975,706,300
902491357,902487957,902511134,23177,707,300
902518579,902515179,902538988,23809,708,300
902546294,902543109,902566069,22960,709,300
902573516,902570114,902594242,24128,710,300
902601688,902598287,902623702,25415,711,300
902631148,902627747,902649340,21593,712,300
902656786,902653385,902677511,24126,713,300
902684826,902681641,902704602,22961,714,300
902712048,902708647,902734715,26068,715,300
902742019,902738835,902762743,23908,716,300
902770190,902766788,902790597,23809,717,300
902798042,902794641,902819106,24465,718,300
902826552,902823151,902847299,24148,719,300
902854745,902851344,902877075,25731,720,300
902884520,902881120,902906850,25730,721,300
902914296,902910895,902936625,25730,722,300
902943903,902940721,902965284,24563,723,300
902972730,902969329,902992485,23156,724,300
902999795,902996612,903020856,24244,725,300
903028300,903024900,903049363,24463,726,300
903056808,903053407,903077238,23831,727,300
903084683,903081283,903106044,24761,728,300
903113490,903110089,903133920,23831,729,300
903141366,903137965,903161141,23176,730,300
903168586,903165186,903188995,23809,731,300
903196441,903193040,903220058,27018,732,300
903227349,903224165,903248729,24564,733,300
903256176,903252774,903277240,24466,734,300
903284570,903281386,903306897,25511,735,300
903314344,903310942,903333148,22206,736,300
903340447,903337263,903361512,24249,737,300
903368958,903365557,903391625,26068,738,300
903398904,903395719,903418048,22329,739,300
903425495,903422093,903445610,23517,740,300
903452925,903449741,903475255,25514,741,300
903482700,903479299,903502139,22840,742,300
903509586,903506184,903530966,24782,743,300
903538269,903535083,903560282,25199,744,300
903567593,903564408,903588636,24228,745,300
903596082,903592681,903616176,23495,746,300
903623622,903620220,903645636,25416,747,300
903652941,903649757,903672716,22959,748,300
903680071,903676887,903701452,24565,749,300
903708765,903705580,903727593,22013,750,300
903735040,903731638,903756716,25078,751,300
903764162,903760761,903782672,21911,752,300
903789958,903786773,903810051,23278,753,300
903817497,903814096,903836619,22523,754,300
903844067,903840664,903866416,25752,755,300
903873702,903870518,903894746,24228,756,300
903902191,903898791,903923573,24782,757,300
903931020,903927618,903950164,22546,758,300
903957451,903954267,903978494,24227,759,300
903985843,903982657,904004966,22309,760,300
904012412,904009011,904030586,21575,761,300
904037869,904034685,904058575,23890,762,300
904065922,904062737,904085382,22645,763,300
904092828,904089427,904111337,21910,764,300
904118635,904115450,904138726,23276,765,300
904146173,904142771,904165949,23178,766,300
904173397,904169994,904193787,23793,767,300
904201233,904197832,904221029,23197,768,300
904228375,904225190,904250366,25176,769,300
904257812,904254411,904278557,24146,770,300
904285878,904282694,904307257,24563,771,300
904314704,904311302,904332897,21595,772,300
904340201,904337016,904360293,23277,773,300
904367641,904364456,904385517,21061,774,300
904392963,904389562,904413056,23494,775,300
904420502,904417101,904438693,21592,776,300
904446010,904442828,904465131,22303,777,300
904472412,904469227,904491555,22328,778,300
904499001,904495600,904518778,23178,779,300
904526061,904522876,904546787,23911,780,300
904554102,904550918,904574195,23277,781,300
904581642,904578240,904601100,22860,782,300
904608546,904605145,904631530,26385,783,300
904638977,904635576,904662279,26703,784,300
904669726,904666324,904690473,24149,785,300
904697919,904694518,904720586,26068,786,300
904727868,904724684,904747624,22940,787,300
904755069,904751669,904776112,24443,788,300
904783559,904780157,904801753,21596,789,300
904809064,904805878,904829808,23930,790,300
904837253,904833853,904856396,22543,791,300
904863713,904860529,904886064,25535,792,300
904893510,904890109,904914869,24760,793,300
904922213,904919030,904941673,22643,794,300
904949024,904945839,904970088,24249,795,300
904977534,904974133,904997627,23494,796,300
905005074,905001672,905025822,24150,797,300
905033109,905029925,905055756,25831,798,300
905063202,905059801,905084582,24781,799,300
905092028,905088627,905110855,22228,800,300
905118142,905114957,905138552,23595,801,300
905145999,905142597,905165457,22860,802,300
905172904,905169502,905193652,24150,803,300
905201098,905197697,905222457,24760,804,300
905229733,905226549,905248537,21988,805,300
905255982,905252581,905273839,21258,806,300
905281283,905277883,905301376,23493,807,300
905308822,905305421,905328915,23494,808,300
905336213,905333029,905356307,23278,809,300
905363641,905360456,905385675,25219,810,300
905393122,905389720,905411612,21892,811,300
905419058,905415657,905438202,22545,812,300
905445650,905442247,905467007,24760,813,300
905474334,905471151,905493161,22010,814,300
905500607,905497206,905521334,24128,815,300
905528780,905525379,905547902,22523,816,300
905555349,905551947,905575126,23179,817,300
905582571,905579171,905604923,25752,818,300
905612370,905608968,905632126,23158,819,300
905639572,905636170,905659011,22841,820,300
905666457,905663056,905686234,23178,821,300
905693681,905690279,905714429,24150,822,300
905721744,905718559,905743758,25199,823,300
905751045,905747860,905770821,22961,824,300
905778122,905774938,905797243,22305,825,300
905804690,905801288,905823517,22229,826,300
905830833,905827648,905852848,25200,827,300
905860122,905856938,905879582,22644,828,300
905886871,905883686,905906964,23278,829,300
905914275,905911091,905935338,24247,830,300
905942660,905939476,905962437,22961,831,300
905969785,905966600,905991483,24883,832,300
905998930,905995528,906019023,23495,833,300
906026469,906023068,906046247,23179,834,300
906053693,906050292,906072837,22545,835,300
906080282,906076882,906102930,26048,836,300
906110210,906107026,906130619,23593,837,300
906138066,906134664,906160395,25731,838,300
906167841,906164440,906189222,24782,839,300
906196668,906193267,906216127,22860,840,300
906223414,906220230,906242220,21990,841,300
906249573,906246388,906268738,22350,842,300
906276016,906272831,906296426,23595,843,300
906303749,906300565,906322577,22012,844,300
906329930,906326745,906350360,23615,845,300
906357657,906354472,906378701,24229,846,300
906386146,906382746,906405627,22881,847,300
906413073,906409672,906435403,25731,848,300
906442705,906439520,906461512,21992,849,300
906468958,906465557,906488080,22523,850,300
906495526,906492125,906515641,23516,851,300
906522951,906519766,906541757,21991,852,300
906549203,906545802,906570878,25076,853,300
906578324,906574923,906597763,22840,854,300
906605047,906601862,906624191,22329,855,300
906631477,906628292,906651254,22962,856,300
906658701,906655298,906678479,23181,857,300
906685757,906682572,906705512,22940,858,300
906712829,906709644,906733259,23615,859,300
906740705,906737304,906763352,26048,860,300
906770681,906767497,906790436,22939,861,300
906797882,906794481,906816075,21594,862,300
906823365,906820178,906843774,23596,863,300
906851220,906847819,906873889,26070,864,300
906881337,906877935,906901092,23157,865,300
906908538,906905137,906927047,21910,866,300
906934352,906931168,906953180,22012,867,300
906960627,906957225,906980088,22863,868,300
906987396,906984213,907007173,22960,869,300
907014480,907011296,907034573,23277,870,300
907042018,907038617,907065319,26702,871,300
907072597,907069412,907092373,22961,872,300
907099819,907096418,907121179,24761,873,300
907128625,907125224,907148717,23493,874,300
907156163,907152762,907176235,23473,875,300
907183681,907180280,907202823,22543,876,300
907210269,907206868,907232915,26047,877,300
907240361,907236960,907262692,25732,878,300
907269988,907266804,907288499,21695,879,300
907295945,907292543,907317642,25099,880,300
907325089,907321687,907345499,23812,881,300
907352787,907349603,907374463,24860,882,300
907381908,907378507,907404871,26364,883,300
907412317,907408916,907433698,24782,884,300
907441144,907437743,907459022,21279,885,300
907466468,907463067,907488481,25414,886,300
907495927,907492526,907516653,24127,887,300
907524101,907520698,907545165,24467,888,300
907552457,907549271,907572253,22982,889,300
907579534,907576350,907601546,25196,890,300
907608992,907605591,907630710,25119,891,300
907638155,907634755,907659831,25076,892,300
907667178,907663993,907687884,23891,893,300
907695330,907691929,907717997,26068,894,300
907725442,907722042,907747432,25390,895,300
907754760,907751575,907775804,24229,896,300
907783250,907779849,907804292,24443,897,300
907811578,907808394,907834225,25831,898,300
907841671,907838270,907864318,26048,899,300
907871765,907868364,907893778,25414,900,300
907901224,907897823,907923872,26049,901,300
907931193,907928008,907951919,23911,902,300
907959365,907955964,907980428,24464,903,300
907987873,907984473,908008916,24443,904,300
908016363,908012961,908037764,24803,905,300
908045211,908041809,908063701,21892,906,300
908071147,908067746,908091874,24128,907,300
908099320,908095919,908118125,22206,908,300
908125572,908122170,908145981,23811,909,300
908153427,908150026,908171621,21595,910,300
908179067,908175666,908201080,25414,911,300
908208525,908205125,908228007,22882,912,300
908235358,908232174,908256105,23931,913,300
908263552,908260150,908283011,22861,914,300
908290458,908287056,908311182,24126,915,300
908318628,908315227,908338722,23495,916,300
908346030,908342845,908368677,25832,917,300
908376123,908372722,908396214,23492,918,300
908403515,908400331,908422658,22327,919,300
908430103,908426703,908452453,25750,920,300
908459899,908456498,908478410,21912,921,300
908485856,908482455,908503713,21258,922,300
908510992,908507808,908531717,23909,923,300
908539034,908535849,908557840,21991,924,300
908565286,908561885,908584746,22861,925,300
908592194,908588791,908612287,23496,926,300
908619734,908616332,908641748,25416,927,300
908649063,908645878,908670085,24207,928,300
908677437,908674253,908697193,22940,929,300
908704510,908701325,908724942,23617,930,300
908732390,908728987,908751513,22526,931,300
908758958,908755558,908778713,23155,932,300
908786043,908782859,908807719,24860,933,300
908814997,908811813,908837645,25832,934,300
908845091,908841690,908864530,22840,935,300
908871975,908868574,908892384,23810,936,300
908899829,908896429,908921189,24760,937,300
908928534,908925350,908949260,23910,938,300
908956706,908953305,908974878,21573,939,300
908982176,908978992,909003851,24859,940,300
909011297,909007896,909032676,24780,941,300
909040123,909036721,909060215,23494,942,300
909067660,909064260,909088070,23810,943,300
909095395,909092211,909118695,26484,944,300
909126004,909122818,909147047,24229,945,300
909154328,909151143,909174421,23278,946,300
909181868,909178466,909202594,24128,947,300
909210040,909206639,909231083,24444,948,300
909238409,909235224,909258524,23300,949,300
909265970,909262569,909284776,22207,950,300
909292061,909288876,909311205,22329,951,300
909318652,909315250,909338112,22862,952,300
909345558,909342156,909363118,20962,953,300
909370565,909367163,909390658,23495,954,300
909398104,909394703,909421720,27017,955,300
909429166,909425765,909451179,25414,956,300
909458624,909455224,909479667,24443,957,300
909487113,909483712,909509128,25416,958,300
909516573,909513173,909537975,24802,959,300
909545421,909542020,909567412,25392,960,300
909574694,909571510,909593520,22010,961,300
909600814,909597629,909620591,22962,962,300
909627945,909624760,909647066,22306,963,300
909654512,909651111,909678447,27336,964,300
909685893,909682492,909706303,23811,965,300
909713596,909710412,909734975,24563,966,300
909742309,909739125,909761137,22012,967,300
909768584,909765182,909787390,22208,968,300
909794836,909791435,909816511,25076,969,300
909823833,909820648,909845529,24881,970,300
909852975,909849574,909874038,24464,971,300
909881484,909878083,909904131,26048,972,300
909911576,909908176,909930720,22544,973,300
909938165,909934764,909958259,23495,974,300
909965706,909962304,909987721,25417,975,300
909995167,909991766,910013995,22229,976,300
910021442,910018040,910040587,22547,977,300
910048033,910044632,910066544,21912,978,300
910073898,910070713,910095595,24882,979,300
910103043,910099640,910121553,21913,980,300
910129000,910125598,910150064,24466,981,300
910157510,910154109,910175999,21890,982,300
910183308,910180124,910203401,23277,983,300
910210847,910207446,910230286,22840,984,300
910237575,910234392,910257984,23592,985,300
910265431,910262029,910285547,23518,986,300
910292992,910289592,910313718,24126,987,300
910321165,910317763,910342208,24445,988,300
910349487,910346304,910368629,22325,989,300
910376075,910372674,910396190,23516,990,300
910403636,910400235,910424680,24445,991,300
910432125,910428724,910452218,23494,992,300
910459664,910456263,910479778,23515,993,300
910487224,910483823,910509554,25731,994,300
910517000,910513599,910537411,23812,995,300
910544857,910541456,910565900,24444,996,300
910573346,910569945,910594388,24443,997,300
910601678,910598494,910621748,23254,998,300
910629193,910625793,910648356,22563,999,300
910655802,910652401,910679082,26681,1000,300
910686447,910683263,910706857,23594,1001,300
910714391,910710991,910733219,22228,1002,300
910740663,910737479,910762044,24565,1003,300
910769579,910766178,910789376,23198,1004,300
910796911,910793510,910816984,23474,1005,300
910824519,910821118,910844929,23811,1006,300
910852463,910849063,910874159,25096,1007,300
910881693,910878293,910899571,21278,1008,300
910907106,910903705,910929118,25413,1009,300
910936654,910933252,910956747,23495,1010,300
910964281,910960880,910984036,23156,1011,300
910991451,910988266,911011206,22940,1012,300
911018577,911015391,911038036,22645,1013,300
911045570,911042169,911066929,24760,1014,300
911074464,911071063,911096161,25098,1015,300
911103696,911100295,911122840,22545,1016,300
911130375,911126974,911150153,23179,1017,300
911157687,911154286,911179384,25098,1018,300
911186919,911183518,911209905,26387,1019,300
911217299,911214115,911238996,24881,1020,300
911246369,911243185,911267117,23932,1021,300
911274491,911271307,911295850,24543,1022,300
911303219,911300034,911323628,23594,1023,300
911331042,911327858,911351135,23277,1024,300
911358550,911355364,911381513,26149,1025,300
911389050,911385647,911410725,25078,1026,300
911418260,911414858,911438669,23811,1027,300
911446203,911442802,911468849,26047,1028,300
911476216,911473031,911496289,23258,1029,300
911503658,911500474,911525988,25514,1030,300
911533404,911530220,911554784,24564,1031,300
911562319,911558918,911588090,29172,1032,300
911595458,911592274,911615236,22962,1033,300
911622644,911619460,911641788,22328,1034,300
911649323,911645922,911669731,23809,1035,300
911677266,911673865,911697656,23791,1036,300
911705190,911701789,911725283,23494,1037,300
911732726,911729542,911755373,25831,1038,300
911762908,911759507,911783951,24444,1039,300
911791486,911788085,911812549,24464,1040,300
911819956,911816772,911839414,22642,1041,300
911846948,911843547,911868329,24782,1042,300
911875864,911872463,911895304,22841,1043,300
911902698,911899514,911922791,23277,1044,300
911930326,911926925,911950736,23811,1045,300
911958271,911954870,911978025,23155,1046,300
911985560,911982159,912005676,23517,1047,300
912013210,912009809,912035201,25392,1048,300
912042736,912039335,912064117,24782,1049,300
912071652,912068250,912091112,22862,1050,300
912098547,912095363,912118302,22939,1051,300
912125838,912122436,912147536,25100,1052,300
912155071,912151670,912175479,23809,1053,300
912183014,912179613,912202157,22544,1054,300
912209691,912206290,912231387,25097,1055,300
912238923,912235521,912259649,24128,1056,300
912267184,912263783,912290168,26385,1057,300
912297704,912294302,912317165,22863,1058,300
912324550,912321364,912344959,23595,1059,300
912352495,912349093,912372568,23475,1060,300
912380104,912376701,912402456,25755,1061,300
912409992,912406590,912428481,21891,1062,300
912436015,912432614,912457057,24443,1063,300
912464593,912461191,912486921,25730,1064,300
912494456,912491055,912515498,24443,1065,300
912523033,912519631,912545046,25415,1066,300
912552580,912549179,912572673,23494,1067,300
912580210,912576807,912602202,25395,1068,300
912609736,912606335,912632381,26046,1069,300
912639817,912636632,912659277,22645,1070,300
912666699,912663515,912688058,24543,1071,300
912695503,912692319,912715597,23278,1072,300
912723002,912719817,912743750,23933,1073,300
912751148,912747963,912771579,23616,1074,300
912779114,912775713,912799502,23789,1075,300
912807036,912803635,912825525,21890,1076,300
912832964,912829780,912851769,21989,1077,300
912859304,912855903,912880664,24761,1078,300
912888199,912884798,912907638,22840,1079,300
912915078,912911894,912935172,23278,1080,300
912942708,912939306,912964089,24783,1081,300
912971457,912968273,912993450,25177,1082,300
913000823,912997640,913020937,23297,1083,300
913028471,913025070,913050168,25098,1084,300
913057701,913054301,913078743,24442,1085,300
913086149,913082965,913106559,23594,1086,300
913114094,913110693,913136086,25393,1087,300
913143494,913140309,913164558,24249,1088,300
913172093,913168692,913194106,25414,1089,300
913201642,913198240,913222685,24445,1090,300
913230220,913226819,913252866,26047,1091,300
913260401,913257000,913280178,23178,1092,300
913287713,913284311,913311013,26702,1093,300
913318547,913315147,913337057,21910,1094,300
913344593,913341191,913366437,25246,1095,300
913373972,913370571,913395016,24445,1096,300
913402552,913399150,913423955,24805,1097,300
913431489,913428089,913449999,21910,1098,300
913457381,913454197,913477474,23277,1099,300
913484906,913481722,913504682,22960,1100,300
913512218,913508816,913534528,25712,1101,300
913542064,913538662,913563445,24783,1102,300
913570980,913567579,913592362,24783,1103,300
913599898,913596496,913620308,23812,1104,300
913627843,913624442,913649519,25077,1105,300
913657054,913653652,913676177,22525,1106,300
913683712,913680310,913705410,25100,1107,300
913712852,913709668,913733262,23594,1108,300
913740797,913737396,913761501,24105,1109,300
913769035,913765634,913789760,24126,1110,300
913797297,913793894,913817704,23810,1111,300
913825239,913821838,913848204,26366,1112,300
913855739,913852338,913879041,26703,1113,300
913886576,913883175,913906987,23812,1114,300
913914396,913911212,913932886,21674,1115,300
913940279,913937095,913963580,26485,1116,300
913971115,913967714,913992474,24760,1117,300
914000008,913996607,914022021,25414,1118,300
914029557,914026155,914050621,24466,1119,300
914058156,914054755,914081775,27020,1120,300
914089310,914085909,914109087,23178,1121,300
914116462,914113279,914136239,22960,1122,300
914143774,914140373,914166443,26070,1123,300
914173978,914170577,914192172,21595,1124,300
914199586,914196401,914219700,23299,1125,300
914227235,914223834,914247962,24128,1126,300
914255366,914252182,914275775,23593,1127,300
914283309,914279908,914304055,24147,1128,300
914311589,914308188,914335206,27018,1129,300
914342741,914339340,914365071,25731,1130,300
914372438,914369255,914394451,25196,1131,300
914401840,914398655,914422272,23617,1132,300
914429808,914426406,914451167,24761,1133,300
914458702,914455301,914478794,23493,1134,300
914486191,914483007,914505968,22961,1135,300
914513503,914510102,914534546,24444,1136,300
914542080,914538679,914562512,23833,1137,300
914570047,914566646,914588852,22206,1138,300
914596388,914592986,914616164,23178,1139,300
914623699,914620298,914643792,23494,1140,300
914651193,914648009,914671941,23932,1141,300
914679476,914676075,914699273,23198,1142,300
914706808,914703407,914730426,27019,1143,300
914737961,914734560,914759319,24759,1144,300
914766854,914763453,914786313,22860,1145,300
914793848,914790447,914815227,24780,1146,300
914822762,914819361,914846063,26702,1147,300
914853597,914850197,914872741,22544,1148,300
914880278,914876875,914901639,24764,1149,300
914909074,914905891,914933008,27117,1150,300
914940415,914937231,914963695,26464,1151,300
914971230,914967829,914992610,24781,1152,300
915000145,914996744,915021505,24761,1153,300
915029042,915025639,915048186,22547,1154,300
915055721,915052320,915074209,21889,1155,300
915081649,915078464,915099823,21359,1156,300
915107265,915104080,915128330,24250,1157,300
915135865,915132464,915156908,24444,1158,300
915164443,915161042,915182001,20959,1159,300
915189537,915186135,915209611,23476,1160,300
915217145,915213745,915239792,26047,1161,300
915247200,915244015,915266661,22646,1162,300
915274195,915270794,915296841,26047,1163,300
915304377,915300975,915327341,26366,1164,300
915334710,915331526,915353832,22306,1165,300
915361214,915358029,915380040,22011,1166,300
915387576,915384174,915408936,24762,1167,300
915416472,915413070,915438147,25077,1168,300
915445542,915442358,915465339,22981,1169,300
915472874,915469473,915492630,23157,1170,300
915500048,915496864,915520752,23888,1171,300
915528167,915524982,915548893,23911,1172,300
915556426,915553026,915575232,22206,1173,300
915582767,915579366,915603493,24127,1174,300
915611028,915607627,915629199,21572,1175,300
915636734,915633333,915660036,26703,1176,300
915667572,915664171,915688278,24107,1177,300
915695813,915692412,915714619,22207,1178,300
915722153,915718753,915743532,24779,1179,300
915751067,915747666,915771160,23494,1180,300
915778694,915775294,915800074,24780,1181,300
915807489,915804304,915827243,22939,1182,300
915834778,915831377,915856139,24762,1183,300
915863673,915860273,915883765,23492,1184,300
915891214,915888030,915910019,21989,1185,300
915917553,915914152,915939905,25753,1186,300
915947280,915944095,915969293,25198,1187,300
915976690,915973505,915996783,23278,1188,300
916004320,916000917,916024098,23181,1189,300
916031499,916028315,916050959,22644,1190,300
916058493,916055093,916078250,23157,1191,300
916085787,916082384,916106219,23835,1192,300
916113754,916110353,916135767,25414,1193,300
916143301,916139901,916164998,25097,1194,300
916172533,916169132,916192942,23810,1195,300
916200476,916197076,916219304,22228,1196,300
916226840,916223438,916246299,22861,1197,300
916253834,916250433,916273927,23494,1198,300
916281463,916278061,916301240,23179,1199,300
916308632,916305447,916327460,22013,1200,300
916334995,916331594,916356355,24761,1201,300
916363793,916360610,916386439,25829,1202,300
916393974,916390573,916422172,31599,1203,300
916429573,916426387,916451902,25515,1204,300
916459438,916456036,916479531,23495,1205,300
916486915,916483729,916508591,24862,1206,300
916516125,916512724,916538792,26068,1207,300
916546327,916542926,916567708,24782,1208,300
916575242,916571841,916596285,24444,1209,300
916603696,916600511,916625056,24545,1210,300
916632591,916629190,916651715,22525,1211,300
916659252,916655849,916680949,25100,1212,300
916688343,916685158,916707170,22012,1213,300
916714534,916711350,916734627,23277,1214,300
916742070,916738886,916762480,23594,1215,300
916770016,916766614,916793951,27337,1216,300
916801486,916798085,916821916,23831,1217,300
916829450,916826050,916852117,26067,1218,300
916859560,916856375,916877437,21062,1219,300
916884975,916881571,916905722,24151,1220,300
916913256,916909856,916936556,26700,1221,300
916944092,916940690,916963213,22523,1222,300
916970749,916967347,916989576,22229,1223,300
916997110,916993710,917017858,24148,1224,300
917025276,917022092,917044103,22011,1225,300
917051638,917048237,917071414,23177,1226,300
917078845,917075661,917098641,22980,1227,300
917106176,917102775,917125615,22840,1228,300
917133150,917129749,917154510,24761,1229,300
917162045,917158644,917183721,25077,1230,300
917191255,917187855,917211346,23491,1231,300
917218779,917215594,917239188,23594,1232,300
917246724,917243322,917267451,24129,1233,300
917274986,917271585,917296682,25097,1234,300
917304218,917300816,917323996,23180,1235,300
917331532,917328130,917351625,23495,1236,300
917359160,917355759,917380204,24445,1237,300
917387572,917384387,917408953,24566,1238,300
917416336,917413151,917435457,22306,1239,300
917442828,917439645,917462584,22939,1240,300
917470119,917466718,917493082,26364,1241,300
917500529,917497346,917522541,25195,1242,300
917529910,917526726,917550319,23593,1243,300
917557854,917554452,917579530,25078,1244,300
917586946,917583762,917606721,22959,1245,300
917614254,917610854,917634664,23810,1246,300
917642030,917638846,917665309,26463,1247,300
917672844,917669443,917691650,22207,1248,300
917699185,917695784,917720227,24443,1249,300
917727602,917724416,917747378,22962,1250,300
917754749,917751564,917775813,24249,1251,300
917783348,917779947,917802808,22861,1252,300
917810342,917806942,917831702,24760,1253,300
917839073,917835887,917858513,22626,1254,300
917866048,917862647,917886141,23494,1255,300
917893532,917890348,917912697,22349,1256,300
917920232,917916831,917939988,23157,1257,300
917947522,917944121,917969534,25413,1258,300
917976909,917973724,918000189,26465,1259,300
918007605,918004420,918029934,25514,1260,300
918037469,918034068,918056907,22839,1261,300
918064329,918061145,918087293,26148,1262,300
918094827,918091427,918117157,25730,1263,300
918124692,918121291,918146388,25097,1264,300
918153922,918150521,918174648,24127,1265,300
918182042,918178858,918205026,26168,1266,300
918212561,918209160,918233624,24464,1267,300
918241160,918237758,918262225,24467,1268,300
918269760,918266359,918290191,23832,1269,300
918297586,918294402,918317996,23594,1270,300
918325390,918322204,918343246,21042,1271,300
918350642,918347458,918371072,23614,1272,300
918378491,918375307,918399534,24227,1273,300
918406899,918403714,918426673,22959,1274,300
918434093,918430909,918453848,22939,1275,300
918461383,918457982,918481792,23810,1276,300
918489328,918485926,918510097,24171,1277,300
918517460,918514276,918536920,22644,1278,300
918544454,918541053,918563914,22861,1279,300
918571449,918568047,918595384,27337,1280,300
918602919,918599518,918623646,24128,1281,300
918631180,918627779,918653214,25435,1282,300
918660749,918657347,918679892,22545,1283,300
918687265,918684080,918709277,25197,1284,300
918716672,918713488,918738686,25198,1285,300
918746222,918742820,918766314,23494,1286,300
918773720,918770535,918792863,22328,1287,300
918800399,918796997,918820491,23494,1288,300
918828025,918824624,918845566,20942,1289,300
918853100,918849699,918871589,21890,1290,300
918879124,918875723,918899218,23495,1291,300
918906751,918903351,918926843,23492,1292,300
918934240,918931056,918956233,25177,1293,300
918963669,918960484,918985365,24881,1294,300
918992901,918989499,919013944,24445,1295,300
919021359,919018175,919041474,23299,1296,300
919048907,919045723,919070603,24880,1297,300
919078136,919074736,919098546,23810,1298,300
919106081,919102680,919128094,25414,1299,300
919135502,919132317,919156882,24565,1300,300
919164417,919161016,919186747,25731,1301,300
919194282,919190881,919215345,24464,1302,300
919222880,919219479,919241729,22250,1303,300
919249106,919245920,919271434,25514,1304,300
919278968,919275567,919300349,24782,1305,300
919307761,919304577,919327833,23256,1306,300
919335368,919331967,919356727,24760,1307,300
919364098,919360913,919386111,25198,1308,300
919393476,919390292,919414834,24542,1309,300
919422240,919419057,919441405,22348,1310,300
919448938,919445538,919470318,24780,1311,300
919477855,919474452,919498920,24468,1312,300
919506456,919503054,919524966,21912,1313,300
919532328,919529145,919550817,21672,1314,300
919558352,919554951,919578782,23831,1315,300
919586317,919582916,919605756,22840,1316,300
919613290,919609889,919633383,23494,1317,300
919640779,919637594,919660239,22645,1318,300
919667773,919664372,919686598,22226,1319,300
919694134,919690732,919715513,24781,1320,300
919723049,919719647,919742825,23178,1321,300
919750243,919747058,919770970,23912,1322,300
919778504,919775104,919799885,24781,1323,300
919807420,919804019,919829751,25732,1324,300
919837121,919833937,919856560,22623,1325,300
919863968,919860783,919885347,24564,1326,300
919892760,919889576,919915743,26167,1327,300
919923280,919919878,919941768,21890,1328,300
919949302,919945901,919969395,23494,1329,300
919976773,919973589,919997204,23615,1330,300
920004739,920001338,920027068,25730,1331,300
920034603,920031202,920056322,25120,1332,300
920063858,920060456,920082707,22251,1333,300
920090145,920086961,920113763,26802,1334,300
920121141,920117957,920142501,24544,1335,300
920149875,920146690,920171550,24860,1336,300
920178996,920175812,920201641,25829,1337,300
920209013,920205828,920227206,21378,1338,300
920234574,920231390,920255636,24246,1339,300
920263076,920259892,920284118,24226,1340,300
920291653,920288252,920313055,24803,1341,300
920320501,920317317,920338378,21061,1342,300
920345796,920342611,920367156,24545,1343,300
920374592,920371406,920393736,22330,1344,300
920401270,920397869,920421362,23493,1345,300
920428784,920425600,920450796,25196,1346,300
920458331,920454930,920478106,23176,1347,300
920485641,920482240,920504785,22545,1348,300
920512177,920508992,920532288,23296,1349,300
920539736,920536552,920560463,23911,1350,300
920568000,920564597,920589065,24468,1351,300
920596600,920593199,920616060,22861,1352,300
920623424,920620240,920642251,22011,1353,300
920649786,920646385,920672095,25710,1354,300
920679630,920676229,920698437,22208,1355,300
920705832,920702647,920726897,24250,1356,300
920734276,920731092,920755022,23930,1357,300
920762440,920759255,920782217,22962,1358,300
920789751,920786350,920811111,24761,1359,300
920818496,920815312,920838589,23277,1360,300
920846124,920842722,920866892,24170,1361,300
920874426,920871025,920895173,24148,1362,300
920902708,920899307,920921536,22229,1363,300
920928912,920925727,920949660,23933,1364,300
920957196,920953794,920976635,22841,1365,300
920984059,920980873,921004449,23576,1366,300
921011983,921008583,921032708,24125,1367,300
921040119,921036934,921061815,24881,1368,300
921069213,921066029,921091226,25197,1369,300
921098762,921095360,921120755,25395,1370,300
921128290,921124889,921146800,21911,1371,300
921154206,921151022,921172695,21673,1372,300
921180092,921176908,921203392,26484,1373,300
921210927,921207526,921233574,26048,1374,300
921240944,921237760,921261671,23911,1375,300
921269108,921265924,921288231,22307,1376,300
921295652,921292468,921317349,24881,1377,300
921324885,921321483,921345317,23834,1378,300
921352851,921349451,921373577,24126,1379,300
921381113,921377711,921402493,24782,1380,300
921410028,921406627,921431409,24782,1381,300
921438944,921435543,921460324,24781,1382,300
921467860,921464458,921490504,26046,1383,300
921498040,921494639,921517816,23177,1384,300
921525350,921521950,921544790,22840,1385,300
921552325,921548924,921579888,30964,1386,300
921587423,921584022,921608782,24760,1387,300
921616318,921612915,921636094,23179,1388,300
921643628,921640227,921666295,26068,1389,300
921673732,921670548,921695112,24564,1390,300
921702647,921699245,921724659,25414,1391,300
921732193,921728792,921751969,23177,1392,300
921759503,921756102,921778329,22227,1393,300
921785712,921782527,921803906,21379,1394,300
921811440,921808039,921833137,25098,1395,300
921840670,921837270,921862051,24781,1396,300
921869482,921866298,921888943,22645,1397,300
921896377,921893194,921917757,24563,1398,300
921925291,921921890,921946355,24465,1399,300
921953888,921950488,921974615,24127,1400,300
921982149,921978748,922002242,23494,1401,300
922009775,922006375,922028917,22542,1402,300
922036332,922033148,922055476,22328,1403,300
922063010,922059609,922085341,25732,1404,300
922092735,922089551,922111541,21990,1405,300
922119076,922115675,922138853,23178,1406,300
922146221,922143036,922167918,24882,1407,300
922175291,922172107,922196988,24881,1408,300
922204523,922201122,922225586,24464,1409,300
922232953,922229769,922254986,25217,1410,300
922262521,922259119,922284535,25416,1411,300
922292069,922288669,922311845,23176,1412,300
922319236,922316051,922339646,23595,1413,300
922347023,922343838,922367748,23910,1414,300
922375150,922371966,922397139,25173,1415,300
922404673,922401273,922426982,25709,1416,300
922434517,922431116,922456846,25730,1417,300
922464230,922461046,922483035,21989,1418,300
922490570,922487169,922513555,26386,1419,300
922520924,922517741,922540362,22621,1420,300
922547897,922544496,922567018,22522,1421,300
922574384,922571200,922595131,23931,1422,300
922602666,922599264,922624997,25733,1423,300
922632408,922629223,922650917,21694,1424,300
922658310,922655125,922680302,25177,1425,300
922687837,922684435,922707634,23199,1426,300
922715168,922711767,922737815,26048,1427,300
922745193,922742009,922765583,23574,1428,300
922772978,922769794,922792459,22665,1429,300
922799993,922796592,922818187,21595,1430,300
922825597,922822413,922846640,24227,1431,300
922854173,922850773,922876186,25413,1432,300
922883721,922880319,922903497,23178,1433,300
922910863,922907678,922928423,20745,1434,300
922935957,922932556,922958308,25752,1435,300
922965685,922962501,922985463,22962,1436,300
922992997,922989596,923013112,23516,1437,300
923020648,923017246,923040108,22862,1438,300
923047641,923044241,923070603,26362,1439,300
923078138,923074737,923100172,25435,1440,300
923107706,923104305,923130352,26047,1441,300
923137765,923134581,923157225,22644,1442,300
923164636,923161451,923184433,22982,1443,300
923191827,923188643,923212913,24270,1444,300
923220447,923217046,923243410,26364,1445,300
923250832,923247647,923269005,21358,1446,300
923276380,923273196,923298394,25198,1447,300
923305804,923302619,923324610,21991,1448,300
923332144,923328744,923353524,24780,1449,300
923360892,923357708,923379065,21357,1450,300
923386600,923383198,923408295,25097,1451,300
923415678,923412494,923437690,25196,1452,300
923445093,923441908,923465207,23299,1453,300
923472649,923469464,923493691,24227,1454,300
923501225,923497824,923522604,24780,1455,300
923529975,923526791,923550068,23277,1456,300
923557603,923554202,923577400,23198,1457,300
923584823,923581638,923606204,24566,1458,300
923613573,923610388,923631767,21379,1459,300
923639302,923635901,923662604,26703,1460,300
923670140,923666738,923692491,25753,1461,300
923700026,923696625,923722040,25415,1462,300
923729576,923726174,923752223,26049,1463,300
923759758,923756357,923779217,22860,1464,300
923786751,923783350,923805557,22207,1465,300
923813092,923809690,923835738,26048,1466,300
923843183,923839998,923862642,22644,1467,300
923870178,923866776,923891220,24444,1468,300
923898616,923895432,923917759,22327,1469,300
923925134,923921949,923945227,23278,1470,300
923952611,923949427,923973674,24247,1471,300
923981210,923977808,924000671,22863,1472,300
924008206,924004805,924029566,24761,1473,300
924037100,924033699,924055927,22228,1474,300
924063463,924060061,924084527,24466,1475,300
924092061,924088660,924113440,24780,1476,300
924120837,924117653,924141266,23613,1477,300
924148637,924145452,924169680,24228,1478,300
924177214,924173813,924197624,23811,1479,300
924205159,924201757,924224934,23177,1480,300
924232468,924229067,924251612,22545,1481,300
924259147,924255745,924279536,23791,1482,300
924286983,924283798,924309946,26148,1483,300
924317481,924314080,924339495,25415,1484,300
924346877,924343693,924366968,23275,1485,300
924374502,924371101,924395228,24127,1486,300
924402763,924399361,924424461,25100,1487,300
924431863,924428678,924451344,22666,1488,300
924458716,924455532,924478176,22644,1489,300
924485709,924482309,924507405,25096,1490,300
924514938,924511538,924535347,23809,1491,300
924542882,924539481,924563966,24485,1492,300
924571414,924568230,924593429,25199,1493,300
924600837,924597653,924622851,25198,1494,300
924630385,924626984,924653368,26384,1495,300
924660903,924657502,924681313,23811,1496,300
924688848,924685446,924711833,26387,1497,300
924719370,924715967,924739780,23813,1498,300
924747187,924744002,924766984,22982,1499,300
924774386,924771202,924795112,23910,1500,300
924802548,924799363,924821670,22307,1501,300
924829108,924825923,924850151,24228,1502,300
924857685,924854284,924880647,26363,1503,300
924888044,924884859,924907504,22645,1504,300
924915038,924911637,924932282,20645,1505,300
924939816,924936415,924961512,25097,1506,300
924969046,924965645,924990110,24465,1507,300
924997505,924994319,925014748,20429,1508,300
925022282,925018881,925043030,24149,1509,300
925050565,925047164,925072242,25078,1510,300
925079775,925076375,925100544,24169,1511,300
925108080,925104677,925130094,25417,1512,300
925137628,925134227,925156772,22545,1513,300
925164147,925160962,925185843,24881,1514,300
925193255,925190071,925213664,23593,1515,300
925221199,925217797,925242581,24784,1516,300
925250117,925246714,925271498,24784,1517,300
925279033,925275632,925301048,25416,1518,300
925308584,925305182,925328676,23494,1519,300
925336210,925332809,925356303,23494,1520,300
925363838,925360437,925383931,23494,1521,300
925391352,925388168,925411467,23299,1522,300
925419003,925415601,925441018,25417,1523,300
925448403,925445220,925466575,21355,1524,300
925474010,925470826,925493807,22981,1525,300
925501341,925497940,925522384,24444,1526,300
925529918,925526517,925548724,22207,1527,300
925556147,925552960,925576239,23279,1528,300
925583774,925580372,925603572,23200,1529,300
925611106,925607705,925633416,25711,1530,300
925640952,925637550,925661046,23496,1531,300
925668415,925665230,925688509,23279,1532,300
925696045,925692643,925717719,25076,1533,300
925725254,925721852,925746634,24782,1534,300
925754170,925750767,925774580,23813,1535,300
925781978,925778794,925801756,22962,1536,300
925809179,925805994,925830539,24545,1537,300
925838073,925834672,925860721,26049,1538,300
925868166,925864981,925889209,24228,1539,300
925896744,925893342,925917807,24465,1540,300
925925343,925921940,925947357,25417,1541,300
925954800,925951615,925977445,25830,1542,300
925984820,925981635,926007467,25832,1543,300
926014914,926011730,926033741,22011,1544,300
926041117,926037933,926061842,23909,1545,300
926069240,926066056,926088700,22644,1546,300
926096235,926092833,926119537,26704,1547,300
926126919,926123735,926146379,22644,1548,300
926153912,926150512,926172084,21572,1549,300
926179620,926176218,926200979,24761,1550,300
926208513,926205113,926228902,23789,1551,300
926236436,926233036,926255896,22860,1552,300
926263431,926260030,926282573,22543,1553,300
926289984,926286800,926309106,22306,1554,300
926316495,926313311,926336905,23594,1555,300
926344440,926341039,926365482,24443,1556,300
926373016,926369616,926391527,21911,1557,300
926399062,926395661,926419493,23832,1558,300
926427027,926423627,926449039,25412,1559,300
926456411,926453227,926476482,23255,1560,300
926484016,926480616,926504741,24125,1561,300
926512142,926508957,926530968,22011,1562,300
926538503,926535102,926558258,23156,1563,300
926565793,926562392,926584599,22207,1564,300
926591997,926588813,926613695,24882,1565,300
926621229,926617829,926642927,25098,1566,300
926650462,926647061,926670851,23790,1567,300
926678387,926674985,926700717,25732,1568,300
926708164,926704980,926727940,22960,1569,300
926735353,926732168,926754813,22645,1570,300
926762347,926758946,926784044,25098,1571,300
926791579,926788177,926812306,24129,1572,300
926819840,926816439,926839933,23494,1573,300
926847469,926844067,926866275,22208,1574,300
926873809,926870408,926891053,20645,1575,300
926898587,926895186,926919630,24444,1576,300
926927166,926923764,926948863,25099,1577,300
926956400,926952997,926974275,21278,1578,300
926981811,926978409,927001587,23178,1579,300
927009005,927005820,927032306,26486,1580,300
927039692,927036508,927060732,24224,1581,300
927068267,927064866,927090914,26048,1582,300
927098356,927095172,927120348,25176,1583,300
927127746,927124562,927148472,23910,1584,300
927155849,927152665,927176914,24249,1585,300
927184450,927181048,927203592,22544,1586,300
927211126,927207726,927229932,22206,1587,300
927237298,927234114,927254859,20745,1588,300
927262246,927259060,927282339,23279,1589,300
927289732,927286548,927311744,25196,1590,300
927319280,927315878,927341612,25734,1591,300
927349147,927345746,927372110,26364,1592,300
927379474,927376290,927400559,24269,1593,300
927407977,927404792,927429970,25178,1594,300
927437504,927434103,927457261,23158,1595,300
927464628,927461444,927487296,25852,1596,300
927494710,927491526,927515753,24227,1597,300
927523129,927519945,927546430,26485,1598,300
927553966,927550564,927574692,24128,1599,300
927582229,927578825,927603608,24783,1600,300
927611144,927607742,927633475,25733,1601,300
927640866,927637680,927662563,24883,1602,300
927669944,927666759,927688117,21358,1603,300
927695653,927692252,927716063,23811,1604,300
927723599,927720197,927744663,24466,1605,300
927752199,927748797,927772292,23495,1606,300
927779827,927776426,927801186,24760,1607,300
927808623,927805439,927828062,22623,1608,300
927835599,927832197,927855376,23179,1609,300
927862911,927859510,927882372,22862,1610,300
927889908,927886506,927910001,23495,1611,300
927917537,927914136,927936976,22840,1612,300
927944512,927941111,927968129,27018,1613,300
927975515,927972331,927996874,24543,1614,300
928004244,928001059,928024019,22960,1615,300
928031555,928028153,928052280,24127,1616,300
928059697,928056512,928078503,21991,1617,300
928086038,928082637,928104865,22228,1618,300
928112402,928108999,928131841,22842,1619,300
928139209,928136024,928160904,24880,1620,300
928168439,928165038,928186949,21911,1621,300
928194320,928191135,928214115,22980,1622,300
928221488,928218303,928240947,22644,1623,300
928248483,928245081,928268914,23833,1624,300
928276450,928273048,928297808,24760,1625,300
928305246,928302062,928326923,24861,1626,300
928334458,928331057,928353284,22227,1627,300
928360819,928357418,928379647,22229,1628,300
928387183,928383781,928408224,24443,1629,300
928415599,928412415,928436640,24225,1630,300
928444023,928440838,928463484,22646,1631,300
928470861,928467676,928493191,25515,1632,300
928500561,928497376,928521941,24565,1633,300
928529477,928526075,928551826,25751,1634,300
928559363,928555961,928579138,23177,1635,300
928586673,928583272,928605816,22544,1636,300
928613206,928610022,928632981,22959,1637,300
928640517,928637115,928659640,22525,1638,300
928667017,928663834,928688060,24226,1639,300
928695479,928692295,928715235,22940,1640,300
928722769,928719369,928741259,21890,1641,300
928748794,928745393,928772093,26700,1642,300
928779467,928776283,928801144,24861,1643,300
928808679,928805278,928828773,23495,1644,300
928836214,928833028,928856920,23892,1645,300
928864314,928861130,928884070,22940,1646,300
928891436,928888251,928911867,23616,1647,300
928919402,928916001,928940467,24466,1648,300
928948002,928944601,928967144,22543,1649,300
928974516,928971332,928997500,26168,1650,300
929004947,929001764,929023772,22008,1651,300
929031144,929027959,929052187,24228,1652,300
929059722,929056321,929080152,23831,1653,300
929087687,929084286,929107465,23179,1654,300
929115001,929111599,929136699,25100,1655,300
929144234,929140833,929164642,23809,1656,300
929172177,929168776,929191953,23177,1657,300
929199487,929196087,929220847,24760,1658,300
929228382,929224981,929249762,24781,1659,300
929257209,929254025,929278886,24861,1660,300
929286279,929283093,929307955,24862,1661,300
929315490,929312089,929335267,23178,1662,300
929342662,929339478,929362440,22962,1663,300
929369975,929366574,929389435,22861,1664,300
929396880,929393696,929418576,24880,1665,300
929426113,929422710,929449414,26704,1666,300
929456950,929453549,929476072,22523,1667,300
929483607,929480206,929503700,23494,1668,300
929511145,929507960,929532524,24564,1669,300
929540060,929536659,929561418,24759,1670,300
929568954,929565552,929590354,24802,1671,300
929597732,929594547,929616854,22307,1672,300
929624228,929621043,929644637,23594,1673,300
929652171,929648771,929670048,21277,1674,300
929677583,929674182,929698309,24127,1675,300
929705844,929702443,929726571,24128,1676,300
929734106,929730705,929752595,21890,1677,300
929760131,929756729,929780541,23812,1678,300
929788078,929784676,929810092,25416,1679,300
929817495,929814311,929837587,23276,1680,300
929845121,929841721,929868085,26364,1681,300
929875474,929872289,929895883,23594,1682,300
929903420,929900017,929923513,23496,1683,300
929930906,929927722,929950661,22939,1684,300
929958062,929954878,929977521,22643,1685,300
929985056,929981655,930006100,24445,1686,300
930013486,930010302,930033896,23594,1687,300
930041309,930038124,930061739,23615,1688,300
930069274,930065873,930089365,23492,1689,300
930096736,930093551,930115541,21990,1690,300
930122928,930119744,930143022,23278,1691,300
930150558,930147156,930169406,22250,1692,300
930176941,930173540,930198954,25414,1693,300
930206489,930203088,930228503,25415,1694,300
930236037,930232637,930255813,23176,1695,300
930263218,930260034,930281074,21040,1696,300
930288509,930285325,930309553,24228,1697,300
930317000,930313815,930338697,24882,1698,300
930346078,930342894,930364588,21694,1699,300
930372023,930368838,930394035,25197,1700,300
930401573,930398170,930422954,24784,1701,300
930430491,930427089,930449296,22207,1702,300
930456661,930453477,930476438,22961,1703,300
930483974,930480572,930502147,21575,1704,300
930509682,930506281,930528487,22206,1705,300
930536023,930532622,930556748,24126,1706,300
930564283,930560882,930583742,22860,1707,300
930591277,930587876,930613289,25413,1708,300
930620824,930617423,930641550,24127,1709,300
930649085,930645684,930668862,23178,1710,300
930676233,930673047,930695354,22307,1711,300
930702789,930699604,930722566,22962,1712,300
930729980,930726796,930748490,21694,1713,300
930756025,930752624,930776117,23493,1714,300
930783652,930780251,930806635,26384,1715,300
930814172,930810770,930834919,24149,1716,300
930842295,930839110,930862072,22962,1717,300
930869609,930866206,930890336,24130,1718,300
930897871,930894470,930916698,22228,1719,300
930924233,930920832,930947197,26365,1720,300
930954733,930951332,930975142,23810,1721,300
930982535,930979350,931004884,25534,1722,300
931012254,931009070,931034900,25830,1723,300
931042437,931039035,931064788,25753,1724,300
931072181,931068997,931091007,22010,1725,300
931098542,931095141,931118613,23472,1726,300
931125990,931122804,931146736,23932,1727,300
931154272,931150871,931175969,25098,1728,300
931183367,931180183,931204726,24543,1729,300
931212172,931208987,931230367,21380,1730,300
931237732,931234549,931257824,23275,1731,300
931265360,931261958,931285770,23812,1732,300
931293304,931289904,931314388,24484,1733,300
931321924,931318522,931343304,24782,1734,300
931350840,931347438,931370954,23516,1735,300
931378490,931375088,931398288,23200,1736,300
931405672,931402488,931428320,25832,1737,300
931435688,931432503,931457069,24566,1738,300
931464605,931461203,931485036,23833,1739,300
931492572,931489170,931511736,22566,1740,300
931519273,931515871,931540001,24130,1741,300
931547371,931544187,931571771,27584,1742,300
931579091,931575906,931599422,23516,1743,300
931606819,931603634,931629781,26147,1744,300
931637150,931633964,931657877,23913,1745,300
931665411,931662011,931686454,24443,1746,300
931693824,931690639,931714549,23910,1747,300
931721946,931718761,931743306,24545,1748,300
931750740,931747556,931771467,23911,1749,300
931779002,931775601,931798779,23178,1750,300
931806185,931803001,931825961,22960,1751,300
931833496,931830096,931855827,25731,1752,300
931863237,931860053,931883013,22960,1753,300
931890548,931887147,931914166,27019,1754,300
931921567,931918383,931941977,23594,1755,300
931949382,931946196,931968525,22329,1756,300
931975900,931972716,931995676,22960,1757,300
932003085,931999901,932023198,23297,1758,300
932030593,932027409,932053576,26167,1759,300
932061112,932057711,932082493,24782,1760,300
932089925,932086741,932110967,24226,1761,300
932118360,932115174,932137819,22645,1762,300
932145354,932141953,932165129,23176,1763,300
932172519,932169335,932194848,25513,1764,300
932202383,932198982,932223130,24148,1765,300
932230667,932227264,932250422,23158,1766,300
932257957,932254556,932278071,23515,1767,300
932285606,932282205,932305382,23177,1768,300
932312917,932309516,932335585,26069,1769,300
932343121,932339720,932362263,22543,1770,300
932369797,932366397,932390229,23832,1771,300
932397763,932394363,932416884,22521,1772,300
932424420,932421018,932445801,24783,1773,300
932453336,932449935,932473766,23831,1774,300
932481211,932478027,932502275,24248,1775,300
932509811,932506409,932529903,23494,1776,300
932537298,932534113,932560283,26170,1777,300
932567820,932564418,932588229,23811,1778,300
932595647,932592463,932617977,25514,1779,300
932625369,932622185,932643880,21695,1780,300
932651302,932648118,932672344,24226,1781,300
932679880,932676478,932700289,23811,1782,300
932707826,932704423,932727308,22885,1783,300
932734674,932731490,932755401,23911,1784,300
932762771,932759588,932782864,23276,1785,300
932790401,932786999,932809207,22208,1786,300
932816655,932813471,932835798,22327,1787,300
932843334,932839933,932864398,24465,1788,300
932871934,932868532,932891688,23156,1789,300
932899223,932895822,932919970,24148,1790,300
932927383,932924199,932947159,22960,1791,300
932954593,932951409,932972449,21040,1792,300
932979984,932976583,933001048,24465,1793,300
933008425,933005241,933029469,24228,1794,300
933037004,933033603,933056779,23176,1795,300
933064316,933060914,933083142,22228,1796,300
933090676,933087276,933110135,22859,1797,300
933117545,933114360,933136686,22326,1798,300
933144221,933140820,933165918,25098,1799,300
933173286,933170101,933193695,23594,1800,300
933201230,933197830,933223244,25414,1801,300
933230780,933227379,933252161,24782,1802,300
933259696,933256295,933279471,23176,1803,300
933287007,933283605,933306467,22862,1804,300
933313900,933310715,933332390,21675,1805,300
933339757,933336573,933358605,22032,1806,300
933366140,933362739,933388470,25731,1807,300
933396007,933392605,933418337,25732,1808,300
933425873,933422472,933447254,24782,1809,300
933454790,933451389,933474565,23176,1810,300
933481930,933478745,933503311,24566,1811,300
933510846,933507445,933529653,22208,1812,300
933537058,933533874,933558440,24566,1813,300
933565835,933562651,933586245,23594,1814,300
933593614,933590430,933613052,22622,1815,300
933620420,933617234,933639585,22351,1816,300
933647120,933643719,933665927,22208,1817,300
933673462,933670061,933693239,23178,1818,300
933700775,933697374,933721817,24443,1819,300
933729265,933726080,933747458,21378,1820,300
933754994,933751592,933774770,23178,1821,300
933782173,933778988,933802584,23596,1822,300
933810120,933806719,933830530,23811,1823,300
933838066,933834664,933859110,24446,1824,300
933866646,933863245,933887395,24150,1825,300
933894931,933891530,933916629,25099,1826,300
933924162,933920763,933946514,25751,1827,300
933954050,933950649,933973826,23177,1828,300
933981360,933977960,934003691,25731,1829,300
934011086,934007902,934031179,23277,1830,300
934038715,934035313,934060730,25417,1831,300
934068266,934064865,934089646,24781,1832,300
934097181,934093780,934119510,25730,1833,300
934126881,934123696,934146341,22645,1834,300
934153717,934150531,934174444,23913,1835,300
934181979,934178578,934203992,25414,1836,300
934211529,934208127,934233226,25099,1837,300
934240761,934237361,934262120,24759,1838,300
934269544,934266358,934291558,25200,1839,300
934299094,934295693,934318870,23177,1840,300
934326405,934323004,934348101,25097,1841,300
934355638,934352236,934375732,23496,1842,300
934383121,934379937,934402558,22621,1843,300
934410093,934406692,934430186,23494,1844,300
934437721,934434320,934458130,23810,1845,300
934465564,934462379,934487261,24882,1846,300
934494667,934491482,934514761,23279,1847,300
934522160,934518976,934540964,21988,1848,300
934548500,934545098,934567938,22840,1849,300
934575474,934572072,934597804,25732,1850,300
934605217,934602032,934627230,25198,1851,300
934634766,934631364,934655471,24107,1852,300
934662840,934659656,934684198,24542,1853,300
934691735,934688332,934712144,23812,1854,300
934719679,934716278,934739455,23177,1855,300
934746826,934743642,934766939,23297,1856,300
934774474,934771073,934796192,25119,1857,300
934803640,934800456,934823733,23277,1858,300
934831268,934827867,934853934,26067,1859,300
934861344,934858159,934879515,21356,1860,300
934886965,934883780,934909949,26169,1861,300
934917484,934914084,934936606,22522,1862,300
934944142,934940740,934965837,25097,1863,300
934973372,934969971,934992833,22862,1864,300
935000368,934996967,935022063,25096,1865,300
935029598,935026197,935049691,23494,1866,300
935057130,935053945,935076905,22960,1867,300
935084323,935081139,935103466,22327,1868,300
935111001,935107601,935130777,23176,1869,300
935138170,935134985,935157945,22960,1870,300
935165312,935162128,935184772,22644,1871,300
935192307,935188906,935213033,24127,1872,300
935220567,935217167,935242874,25707,1873,300
935250409,935247009,935272106,25097,1874,300
935279513,935276329,935299269,22940,1875,300
935306804,935303403,935328502,25099,1876,300
935335895,935332711,935355650,22939,1877,300
935363185,935359784,935383278,23494,1878,300
935390813,935387412,935411243,23831,1879,300
935418614,935415429,935438390,22961,1880,300
935445837,935442652,935467217,24565,1881,300
935474752,935471351,935495794,24443,1882,300
935503330,935499929,935523740,23811,1883,300
935531276,935527875,935551033,23158,1884,300
935558568,935555167,935580265,25098,1885,300
935587667,935584482,935608414,23932,1886,300
935615949,935612548,935634123,21575,1887,300
935641658,935638257,935662046,23789,1888,300
935669583,935666181,935689042,22861,1889,300
935696578,935693176,935717009,23833,1890,300
935724543,935721143,935744318,23175,1891,300
935751853,935748452,935772895,24443,1892,300
935780431,935777029,935800207,23178,1893,300
935807743,935804342,935827203,22861,1894,300
935834741,935831338,935855149,23811,1895,300
935862684,935859283,935882480,23197,1896,300
935890016,935886614,935911059,24445,1897,300
935918596,935915194,935941263,26069,1898,300
935948799,935945398,935968576,23178,1899,300
935976111,935972710,935996204,23494,1900,300
936003614,936000430,936026261,25831,1901,300
936033796,936030395,936053869,23474,1902,300
936061275,936058090,936082316,24226,1903,300
936089681,936086497,936111038,24541,1904,300
936118573,936115172,936139615,24443,1905,300
936147150,936143749,936169165,25416,1906,300
936176701,936173299,936195844,22545,1907,300
936203284,936200100,936225932,25832,1908,300
936233467,936230067,936255480,25413,1909,300
936263015,936259614,936282475,22861,1910,300
936290012,936286610,936311392,24782,1911,300
936318926,936315526,936338724,23198,1912,300
936346260,936342858,936367639,24781,1913,300
936375175,936371774,936394952,23178,1914,300
936402319,936399135,936424355,25220,1915,300
936431890,936428489,936450379,21890,1916,300
936457820,936454636,936479178,24542,1917,300
936486715,936483313,936506808,23495,1918,300
936514343,936510942,936533485,22543,1919,300
936540890,936537705,936559697,21992,1920,300
936567231,936563831,936587958,24127,1921,300
936595492,936592092,936614320,22228,1922,300
936621856,936618455,936642919,24464,1923,300
936650454,936647053,936668943,21890,1924,300
936676338,936673153,936696748,23595,1925,300
936704285,936700883,936725348,24465,1926,300
936732760,936729577,936752832,23255,1927,300
936760366,936756966,936779826,22860,1928,300
936787360,936783960,936810638,26678,1929,300
936818174,936814773,936837950,23177,1930,300
936845485,936842084,936863046,20962,1931,300
936870442,936867258,936892750,25492,1932,300
936900285,936896884,936920693,23809,1933,300
936928065,936924881,936950712,25831,1934,300
936958248,936954847,936979312,24465,1935,300
936986848,936983446,937006623,23177,1936,300
937014158,937010757,937036825,26068,1937,300
937044360,937040960,937066689,25729,1938,300
937074224,937070824,937095605,24781,1939,300
937102997,937099813,937123407,23594,1940,300
937130838,937127654,937149981,22327,1941,300
937157515,937154115,937177291,23176,1942,300
937184690,937181505,937207041,25536,1943,300
937214577,937211175,937235008,23833,1944,300
937242543,937239142,937265188,26046,1945,300
937272724,937269323,937293135,23812,1946,300
937300670,937297269,937319814,22545,1947,300
937327349,937323948,937345206,21258,1948,300
937352587,937349402,937372680,23278,1949,300
937380215,937376814,937400983,24169,1950,300
937408519,937405117,937430848,25731,1951,300
937438386,937434983,937459744,24761,1952,300
937467279,937463878,937487371,23493,1953,300
937494905,937491505,937515334,23829,1954,300
937522868,937519468,937542962,23494,1955,300
937550348,937547164,937569174,22010,1956,300
937576709,937573308,937595219,21911,1957,300
937602624,937599440,937622718,23278,1958,300
937630255,937626853,937651634,24781,1959,300
937659170,937655768,937678313,22545,1960,300
937685848,937682447,937706278,23831,1961,300
937713701,937710516,937733457,22941,1962,300
937740874,937737689,937760333,22644,1963,300
937767869,937764467,937787329,22862,1964,300
937794708,937791524,937817039,25515,1965,300
937824410,937821225,937843871,22646,1966,300
937851406,937848005,937872155,24150,1967,300
937879689,937876289,937900119,23830,1968,300
937907514,937904330,937928261,23931,1969,300
937935797,937932395,937953356,20961,1970,300
937960892,937957490,937981322,23832,1971,300
937988695,937985510,938010075,24565,1972,300
938017453,938014268,938038179,23911,1973,300
938045715,938042313,938066441,24128,1974,300
938073837,938070652,938096166,25514,1975,300
938103701,938100300,938122528,22228,1976,300
938129924,938126740,938151304,24564,1977,300
938158715,938155531,938181699,26168,1978,300
938189235,938185834,938209665,23831,1979,300
938217200,938213799,938238263,24464,1980,300
938245799,938242398,938267811,25413,1981,300
938275347,938271945,938296725,24780,1982,300
938304107,938300921,938325485,24564,1983,300
938333021,938329620,938355350,25730,1984,300
938362716,938359531,938381228,21697,1985,300
938388663,938385479,938410360,24881,1986,300
938417896,938414495,938437672,23177,1987,300
938445114,938441929,938463603,21674,1988,300
938471140,938467738,938493471,25733,1989,300
938500863,938497679,938519984,22305,1990,300
938527404,938524219,938547201,22982,1991,300
938554737,938551335,938575144,23809,1992,300
938582679,938579278,938603721,24443,1993,300
938611091,938607907,938632788,24881,1994,300
938640182,938636998,938659302,22304,1995,300
938666675,938663491,938687086,23595,1996,300
938694623,938691221,938715372,24151,1997,300
938722907,938719506,938743001,23495,1998,300
938750444,938747259,938771191,23932,1999,300
938778562,938775377,938799309,23932,2000,300
938806846,938803444,938827234,23790,2001,300
938834771,938831369,938857440,26071,2002,300
938864819,938861635,938888119,26484,2003,300
938895498,938892313,938914304,21991,2004,300
938921840,938918439,938943537,25098,2005,300
938950906,938947722,938971631,23909,2006,300
938979168,938975766,938999240,23474,2007,300
939006775,939003375,939025602,22227,2008,300
939033138,939029737,939052261,22524,2009,300
939059797,939056395,939081494,25099,2010,300
939089031,939085629,939108806,23177,2011,300
939116251,939113067,939136956,23889,2012,300
939144396,939141211,939166071,24860,2013,300
939173606,939170206,939195641,25435,2014,300
939203178,939199776,939223270,23494,2015,300
939230807,939227405,939252166,24761,2016,300
939259702,939256301,939282349,26048,2017,300
939289886,939286485,939310610,24125,2018,300
939318046,939314860,939339406,24546,2019,300
939346943,939343541,939368957,25416,2020,300
939376493,939373092,939397557,24465,2021,300
939404949,939401766,939428881,27115,2022,300
939436417,939433016,939456806,23790,2023,300
939464342,939460941,939484771,23830,2024,300
939492306,939488906,939512082,23176,2025,300
939519497,939516313,939539274,22961,2026,300
939546809,939543409,939570426,27017,2027,300
939577832,939574648,939597926,23278,2028,300
939605462,939602061,939625238,23177,2029,300
939632676,939629492,939652769,23277,2030,300
939660305,939656904,939683269,26365,2031,300
939690805,939687404,939709926,22522,2032,300
939717462,939714061,939736901,22840,2033,300
939744272,939741088,939764366,23278,2034,300
939771748,939768565,939791841,23276,2035,300
939799283,939796098,939818088,21990,2036,300
939825539,939822353,939844344,21991,2037,300
939851756,939848571,939872186,23615,2038,300
939879721,939876321,939903022,26701,2039,300
939910559,939907158,939930335,23177,2040,300
939937871,939934470,939957627,23157,2041,300
939965020,939961836,939987348,25512,2042,300
939994885,939991483,940015612,24129,2043,300
940022991,940019806,940043423,23617,2044,300
940050959,940047558,940071706,24148,2045,300
940079242,940075841,940100940,25099,2046,300
940108476,940105075,940127600,22525,2047,300
940135138,940131735,940155231,23496,2048,300
940162606,940159421,940183965,24544,2049,300
940191501,940188100,940211932,23832,2050,300
940219370,940216185,940239780,23595,2051,300
940247171,940243987,940267602,23615,2052,300
940275139,940271737,940296202,24465,2053,300
940303738,940300337,940324780,24443,2054,300
940332317,940328915,940355618,26703,2055,300
940363155,940359754,940382594,22840,2056,300
940390132,940386729,940411514,24785,2057,300
940419049,940415649,940437539,21890,2058,300
940444910,940441725,940462470,20745,2059,300
940470007,940466605,940489129,22524,2060,300
940496665,940493264,940516105,22841,2061,300
940523507,940520323,940544233,23910,2062,300
940551769,940548368,940573129,24761,2063,300
940580666,940577264,940601414,24150,2064,300
940608794,940605610,940628276,22666,2065,300
940635813,940632411,940656877,24466,2066,300
940664262,940661077,940684039,22962,2067,300
940691575,940688174,940711374,23200,2068,300
940718755,940715571,940739820,24249,2069,300
940747357,940743955,940767132,23177,2070,300
940774536,940771352,940792731,21379,2071,300
940800267,940796866,940821331,24465,2072,300
940828868,940825466,940852801,27335,2073,300
940860338,940856937,940881696,24759,2074,300
940889232,940885831,940910611,24780,2075,300
940918148,940914746,940938537,23791,2076,300
940946075,940942672,940968406,25734,2077,300
940975828,940972644,940995921,23277,2078,300
941003458,941000056,941025472,25416,2079,300
941032860,941029675,941055191,25516,2080,300
941062727,941059326,941080919,21593,2081,300
941088306,941085122,941107449,22327,2082,300
941114985,941111584,941134128,22544,2083,300
941141522,941138338,941161634,23296,2084,300
941169004,941165820,941190384,24564,2085,300
941197817,941194633,941218859,24226,2086,300
941226396,941222994,941246489,23495,2087,300
941254025,941250624,941274751,24127,2088,300
941282287,941278886,941303667,24781,2089,300
941311203,941307802,941332563,24761,2090,300
941339953,941336769,941358780,22011,2091,300
941366315,941362915,941389616,26701,2092,300
941397064,941393880,941417158,23278,2093,300
941424531,941421347,941445277,23930,2094,300
941452815,941449412,941472908,23496,2095,300
941480444,941477043,941503090,26047,2096,300
941510626,941507225,941530718,23493,2097,300
941538254,941534853,941559950,25097,2098,300
941567485,941564085,941588845,24760,2099,300
941596235,941593051,941616329,23278,2100,300
941623865,941620464,941644905,24441,2101,300
941652441,941649040,941672535,23495,2102,300
941680071,941676670,941701768,25098,2103,300
941709304,941705903,941730685,24782,2104,300
941738221,941734820,941757680,22860,2105,300
941765061,941761876,941787389,25513,2106,300
941794808,941791622,941814923,23301,2107,300
941822459,941819058,941842256,23198,2108,300
941849793,941846391,941871469,25078,2109,300
941879005,941875604,941898465,22861,2110,300
941905855,941902671,941924049,21378,2111,300
941931586,941928184,941951701,23517,2112,300
941959080,941955896,941980144,24248,2113,300
941987680,941984279,942008427,24148,2114,300
942015963,942012562,942035740,23178,2115,300
942043111,942039926,942065125,25199,2116,300
942072660,942069260,942093387,24127,2117,300
942100923,942097522,942121670,24148,2118,300
942129080,942125894,942147884,21990,2119,300
942155420,942152019,942175830,23811,2120,300
942183366,942179964,942203459,23495,2121,300
942210995,942207594,942231741,24147,2122,300
942239278,942235876,942263212,27336,2123,300
942270662,942267477,942292064,24587,2124,300
942299600,942296199,942320641,24442,2125,300
942328176,942324776,942350527,25751,2126,300
942358062,942354662,942378156,23494,2127,300
942385524,942382340,942404667,22327,2128,300
942412204,942408802,942432952,24150,2129,300
942440489,942437087,942460898,23811,2130,300
942468434,942465033,942491081,26048,2131,300
942498617,942495216,942518099,22883,2132,300
942525467,942522282,942544588,22306,2133,300
942551967,942548781,942572693,23912,2134,300
942580082,942576898,942599522,22624,2135,300
942606929,942603745,942628627,24882,2136,300
942636060,942632876,942656806,23930,2137,300
942664229,942661044,942685271,24227,2138,300
942692682,942689497,942712163,22666,2139,300
942719543,942716359,942741238,24879,2140,300
942748774,942745373,942769204,23831,2141,300
942776740,942773339,942796200,22861,2142,300
942803736,942800335,942823807,23472,2143,300
942831342,942827942,942851118,23176,2144,300
942858517,942855332,942878293,22961,2145,300
942885688,942882504,942905466,22962,2146,300
942912863,942909678,942933273,23595,2147,300
942940678,942937493,942961405,23912,2148,300
942968941,942965540,942988064,22524,2149,300
942995431,942992247,943014891,22644,2150,300
943022427,943019026,943044755,25729,2151,300
943052130,943048945,943075114,26169,2152,300
943082651,943079250,943104665,25415,2153,300
943112201,943108800,943132590,23790,2154,300
943140126,943136725,943161189,24464,2155,300
943168577,943165392,943189344,23952,2156,300
943196881,943193479,943216974,23495,2157,300
943224342,943221158,943243169,22011,2158,300
943250706,943247304,943273037,25733,2159,300
943280575,943277173,943300985,23812,2160,300
943308378,943305194,943329759,24565,2161,300
943337296,943333894,943357387,23493,2162,300
943364923,943361522,943384067,22545,2163,300
943391603,943388202,943413934,25732,2164,300
943421355,943418171,943440477,22306,2165,300
943448013,943444612,943470025,25413,2166,300
943477561,943474160,943495438,21278,2167,300
943502887,943499703,943522030,22327,2168,300
943529566,943526165,943551577,25412,2169,300
943559113,943555712,943581444,25732,2170,300
943588811,943585626,943609538,23912,2171,300
943617075,943613673,943637821,24148,2172,300
943645357,943641956,943666400,24444,2173,300
943673844,943670660,943695540,24880,2174,300
943702962,943699775,943723689,23914,2175,300
943731226,943727824,943752585,24761,2176,300
943759979,943756794,943778784,21990,2177,300
943786321,943782919,943809938,27019,2178,300
943817475,943814073,943839489,25416,2179,300
943847025,943843624,943866148,22524,2180,300
943873549,943870364,943896512,26148,2181,300
943903935,943900750,943925316,24566,2182,300
943932713,943929527,943951520,21993,2183,300
943959057,943955655,943978517,22862,2184,300
943986054,943982652,944006780,24128,2185,300
944014316,944010915,944034091,23176,2186,300
944041472,944038288,944061564,23276,2187,300
944069099,944065698,944090795,25097,2188,300
944098329,944094929,944119076,24147,2189,300
944126611,944123210,944147990,24780,2190,300
944155527,944152125,944177857,25732,2191,300
944185250,944182066,944206946,24880,2192,300
944214336,944211152,944234747,23595,2193,300
944242282,944238882,944262375,23493,2194,300
944269748,944266563,944289523,22960,2195,300
944296933,944293749,944318948,25199,2196,300
944326484,944323083,944345924,22841,2197,300
944353460,944350058,944373574,23516,2198,300
944380982,944377798,944402363,24565,2199,300
944409899,944406497,944430310,23813,2200,300
944437690,944434506,944457444,22938,2201,300
944464980,944461579,944484124,22545,2202,300
944491509,944488324,944511603,23279,2203,300
944518986,944515801,944539710,23909,2204,300
944547100,944543916,944568798,24882,2205,300
944576334,944572933,944595477,22544,2206,300
944602845,944599660,944624204,24544,2207,300
944631741,944628339,944652784,24445,2208,300
944660198,944657014,944681240,24226,2209,300
944688775,944685374,944709499,24125,2210,300
944717035,944713634,944739049,25415,2211,300
944746585,944743184,944768577,25393,2212,300
944776018,944772834,944795498,22664,2213,300
944803033,944799632,944821860,22228,2214,300
944829396,944825995,944848538,22543,2215,300
944855973,944852789,944876086,23297,2216,300
944883623,944880221,944905637,25416,2217,300
944913054,944909871,944934096,24225,2218,300
944941506,944938322,944963542,25220,2219,300
944971077,944967676,944990876,23200,2220,300
944998247,944995062,945018024,22962,2221,300
945025391,945022205,945045167,22962,2222,300
945052703,945049302,945072459,23157,2223,300
945079995,945076594,945100089,23495,2224,300
945107463,945104279,945127555,23276,2225,300
945135092,945131690,945152336,20646,2226,300
945159872,945156471,945181568,25097,2227,300
945189105,945185703,945209851,24148,2228,300
945217251,945214066,945235740,21674,2229,300
945243136,945239952,945263547,23595,2230,300
945271083,945267682,945290205,22523,2231,300
945297741,945294340,945318150,23810,2232,300
945325686,945322285,945349303,27018,2233,300
945356839,945353438,945380454,27016,2234,300
945387991,945384590,945409370,24780,2235,300
945416740,945413555,945435883,22328,2236,300
945443419,945440018,945463196,23178,2237,300
945470730,945467330,945488924,21594,2238,300
945496460,945493059,945518790,25731,2239,300
945526327,945522925,945546400,23475,2240,300
945553813,945550629,945575827,25198,2241,300
945583363,945579962,945602486,22524,2242,300
945609869,945606686,945630909,24223,2243,300
945638445,945635044,945657905,22861,2244,300
945665323,945662139,945686724,24585,2245,300
945694260,945690859,945714352,23493,2246,300
945721888,945718487,945740376,21889,2247,300
945747825,945744640,945767601,22961,2248,300
945775137,945771736,945796517,24781,2249,300
945804052,945800651,945825748,25097,2250,300
945833284,945829882,945855297,25415,2251,300
945862684,945859500,945883094,23594,2252,300
945890631,945887229,945909754,22525,2253,300
945917155,945913971,945939169,25198,2254,300
945946706,945943304,945969036,25732,2255,300
945976410,945973226,945995532,22306,2256,300
946003068,945999667,946024449,24782,2257,300
946031986,946028584,946053365,24781,2258,300
946060900,946057500,946080972,23472,2259,300
946088508,946085107,946109233,24126,2260,300
946116769,946113368,946138465,25097,2261,300
946145838,946142654,946167851,25197,2262,300
946175386,946171986,946197084,25098,2263,300
946204620,946201219,946225663,24444,2264,300
946233199,946229798,946254896,25098,2265,300
946262266,946259081,946283307,24226,2266,300
946290681,946287497,946310458,22961,2267,300
946317907,946314723,946339604,24881,2268,300
946346976,946343792,946367386,23594,2269,300
946374777,946371593,946392951,21358,2270,300
946400315,946397130,946419775,22645,2271,300
946427311,946423910,946446117,22207,2272,300
946453654,946450252,946473451,23199,2273,300
946480987,946477586,946502030,24444,2274,300
946509423,946506239,946528566,22327,2275,300
946535964,946532779,946557661,24882,2276,300
946565084,946561900,946586127,24227,2277,300
946593663,946590262,946613755,23493,2278,300
946621165,946617980,946643475,25495,2279,300
946651011,946647610,946670492,22882,2280,300
946678029,946674627,946697151,22524,2281,300
946704688,946701286,946724759,23473,2282,300
946732296,946728894,946752369,23475,2283,300
946759905,946756504,946780969,24465,2284,300
946788391,946785207,946808169,22962,2285,300
946815705,946812304,946838035,25731,2286,300
946845572,946842170,946865982,23812,2287,300
946873352,946870167,946892812,22645,2288,300
946900349,946896947,946919808,22861,2289,300
946927344,946923943,946949358,25415,2290,300
946956806,946953622,946975610,21988,2291,300
946983146,946979745,947004505,24760,2292,300
947012041,947008640,947031499,22859,2293,300
947039034,947035634,947059128,23494,2294,300
947066566,947063382,947087947,24565,2295,300
947095483,947092082,947116209,24127,2296,300
947123745,947120344,947146709,26365,2297,300
947154083,947150898,947174807,23909,2298,300
947182198,947179013,947202925,23912,2299,300
947210461,947207060,947231505,24445,2300,300
947239041,947235640,947259452,23812,2301,300
947266987,947263586,947284864,21278,2302,300
947292401,947288999,947312494,23495,2303,300
947319888,947316704,947340931,24227,2304,300
947348325,947345141,947367447,22306,2305,300
947374983,947371582,947395710,24128,2306,300
947403246,947399845,947423678,23833,2307,300
947431213,947427813,947452593,24780,2308,300
947460128,947456728,947480855,24127,2309,300
947488221,947485037,947507026,21989,2310,300
947514433,947511249,947535814,24565,2311,300
947543349,947539948,947564076,24128,2312,300
947571494,947568310,947590954,22644,2313,300
947598342,947595156,947619090,23934,2314,300
947626454,947623269,947646546,23277,2315,300
947654082,947650681,947674809,24128,2316,300
947682344,947678943,947703386,24443,2317,300
947710923,947707521,947730066,22545,2318,300
947737452,947734267,947759149,24882,2319,300
947766685,947763284,947787412,24128,2320,300
947794779,947791594,947815506,23912,2321,300
947822908,947819725,947843000,23275,2322,300
947850535,947847135,947872231,25096,2323,300
947879769,947876366,947898912,22546,2324,300
947906352,947903167,947927711,24544,2325,300
947935247,947931846,947957557,25711,2326,300
947965092,947961692,947984552,22860,2327,300
947992089,947988687,948011550,22863,2328,300
948019087,948015685,948040763,25078,2329,300
948048298,948044898,948066807,21909,2330,300
948074186,948071002,948094912,23910,2331,300
948102314,948099130,948123357,24227,2332,300
948130724,948127539,948151153,23614,2333,300
948158590,948155403,948178998,23595,2334,300
948186374,948183189,948206468,23279,2335,300
948214004,948210603,948234117,23514,2336,300
948241653,948238252,948261114,22862,2337,300
948268649,948265249,948289691,24442,2338,300
948297104,948293919,948315593,21674,2339,300
948322980,948319796,948342756,22960,2340,300
948350166,948346981,948370575,23594,2341,300
948378111,948374710,948398203,23493,2342,300
948405740,948402338,948424882,22544,2343,300
948432418,948429017,948453165,24148,2344,300
948460547,948457362,948480029,22667,2345,300
948487425,948484240,948507517,23277,2346,300
948515054,948511652,948534177,22525,2347,300
948541713,948538312,948562101,23789,2348,300
948569637,948566236,948588462,22226,2349,300
948595998,948592597,948618010,25413,2350,300
948625547,948622145,948645641,23496,2351,300
948653010,948649827,948672449,22622,2352,300
948679984,948676583,948701681,25098,2353,300
948709217,948705816,948728993,23177,2354,300
948736441,948733256,948755902,22646,2355,300
948763438,948760037,948783530,23493,2356,300
948790953,948787767,948812628,24861,2357,300
948819997,948816813,948838803,21990,2358,300
948846339,948842937,948865778,22841,2359,300
948873186,948870001,948893912,23911,2360,300
948901449,948898047,948920930,22883,2361,300
948928345,948925161,948948437,23276,2362,300
948955809,948952625,948975249,22624,2363,300
948982785,948979384,949005771,26387,2364,300
949013307,949009906,949033401,23495,2365,300
949040937,949037536,949060102,22566,2366,300
949067638,949064237,949089651,25414,2367,300
949097187,949093786,949118230,24444,2368,300
949125767,949122365,949145207,22842,2369,300
949152571,949149387,949174268,24881,2370,300
949181677,949178492,949203036,24544,2371,300
949210574,949207171,949232587,25416,2372,300
949240124,949236722,949257979,21257,2373,300
949265516,949262114,949286897,24783,2374,300
949294336,949291151,949316350,25199,2375,300
949323762,949320578,949344827,24249,2376,300
949352364,949348962,949372796,23834,2377,300
949380168,949376984,949403785,26801,2378,300
949411321,949407920,949431097,23177,2379,300
949438634,949435232,949460627,25395,2380,300
949468163,949464762,949488888,24126,2381,300
949496425,949493023,949518756,25733,2382,300
949526151,949522967,949545610,22643,2383,300
949553145,949549745,949573871,24126,2384,300
949581407,949578006,949601500,23494,2385,300
949609037,949605635,949631050,25415,2386,300
949638585,949635185,949658362,23177,2387,300
949665807,949662623,949685603,22980,2388,300
949693139,949689738,949713232,23494,2389,300
949720617,949717431,949741344,23913,2390,300
949748742,949745558,949769827,24269,2391,300
949777364,949773962,949799378,25416,2392,300
949806826,949803642,949825673,22031,2393,300
949833209,949829808,949854273,24465,2394,300
949861809,949858408,949881290,22882,2395,300
949888680,949885495,949909427,23932,2396,300
949916799,949913615,949939783,26168,2397,300
949947178,949943994,949967292,23298,2398,300
949974688,949971504,949994444,22940,2399,300
950001981,949998579,950021779,23200,2400,300
950029315,950025914,950048457,22543,2401,300
950055869,950052685,950075963,23278,2402,300
950083500,950080098,950103909,23811,2403,300
950111350,950108167,950131104,22937,2404,300
950138640,950135239,950156496,21257,2405,300
950163931,950160746,950186262,25516,2406,300
950193798,950190397,950213575,23178,2407,300
950221110,950217710,950243123,25413,2408,300
950250491,950247307,950272506,25199,2409,300
950280042,950276641,950301107,24466,2410,300
950308641,950305241,950328733,23492,2411,300
950336268,950332867,950358912,26045,2412,300
950366322,950363137,950386415,23278,2413,300
950393950,950390549,950413432,22883,2414,300
950420970,950417567,950442033,24466,2415,300
950449404,950446220,950469201,22981,2416,300
950476589,950473405,950498919,25514,2417,300
950506456,950503054,950525917,22863,2418,300
950533451,950530051,950553227,23176,2419,300
950560662,950557478,950582042,24564,2420,300
950589434,950586251,950608892,22641,2421,300
950616428,950613027,950638759,25732,2422,300
950646295,950642894,950666389,23495,2423,300
950673925,950670524,950696592,26068,2424,300
950704129,950700727,950723292,22565,2425,300
950730829,950727427,950752209,24782,2426,300
950759656,950756472,950779432,22960,2427,300
950786969,950783567,950808012,24445,2428,300
950815549,950812147,950837247,25100,2429,300
950844782,950841382,950864538,23156,2430,300
950871910,950868724,950889786,21062,2431,300
950897321,950893921,950918067,24146,2432,300
950925604,950922202,950944726,22524,2433,300
950952123,950948939,950972238,23299,2434,300
950979774,950976373,951001156,24783,2435,300
951008525,951005339,951030223,24884,2436,300
951037644,951034459,951055837,21378,2437,300
951063272,951060088,951083999,23911,2438,300
951091537,951088134,951113234,25100,2439,300
951120770,951117369,951140547,23178,2440,300
951148083,951144682,951168829,24147,2441,300
951176225,951173041,951198577,25536,2442,300
951205960,951202776,951227046,24270,2443,300
951234462,951231278,951258395,27117,2444,300
951265931,951262530,951286974,24444,2445,300
951294509,951291109,951314920,23811,2446,300
951322305,951319120,951342715,23595,2447,300
951350252,951346850,951368107,21257,2448,300
951375644,951372242,951395082,22840,2449,300
951402463,951399279,951422557,23278,2450,300
951430093,951426692,951450818,24126,2451,300
951458355,951454953,951478132,23179,2452,300
951485668,951482267,951506414,24147,2453,300
951513835,951510651,951532979,22328,2454,300
951540516,951537114,951575718,38604,2455,300
951583255,951579853,951606238,26385,2456,300
951613774,951610374,951635133,24759,2457,300
951642579,951639394,951662672,23278,2458,300
951670120,951666935,951690530,23595,2459,300
951697921,951694737,951718015,23278,2460,300
951725421,951722236,951745830,23594,2461,300
951753367,951749965,951772828,22863,2462,300
951780364,951776963,951799192,22229,2463,300
951806569,951803384,951826346,22962,2464,300
951833720,951830535,951854468,23933,2465,300
951861902,951858717,951884253,25536,2466,300
951891789,951888388,951912833,24445,2467,300
951920369,951916968,951939174,22206,2468,300
951946709,951943308,951969039,25731,2469,300
951976436,951973252,951998765,25513,2470,300
952006301,952002900,952026395,23495,2471,300
952033832,952030647,952055214,24567,2472,300
952062751,952059349,952082845,23496,2473,300
952090382,952086980,952109524,22544,2474,300
952116962,952113778,952139293,25515,2475,300
952146829,952143428,952166290,22862,2476,300
952173825,952170425,952193624,23199,2477,300
952201161,952197759,952221908,24149,2478,300
952229326,952226142,952247838,21696,2479,300
952255374,952251973,952276100,24127,2480,300
952283637,952280235,952303433,23198,2481,300
952310883,952307697,952333552,25855,2482,300
952341087,952337687,952361498,23811,2483,300
952369033,952365632,952387542,21910,2484,300
952395078,952391677,952415802,24125,2485,300
952423338,952419937,952445012,25075,2486,300
952452547,952449147,952474559,25412,2487,300
952481982,952478797,952502728,23931,2488,300
952510264,952506863,952528437,21574,2489,300
952535847,952532662,952555939,23277,2490,300
952563474,952560073,952582618,22545,2491,300
952590155,952586753,952609614,22861,2492,300
952617151,952613749,952637877,24128,2493,300
952645413,952642012,952666476,24464,2494,300
952674012,952670611,952693788,23177,2495,300
952701167,952697981,952722885,24904,2496,300
952730260,952727076,952752590,25514,2497,300
952760126,952756725,952780535,23810,2498,300
952787931,952784746,952807709,22963,2499,300
952815245,952811844,952835972,24128,2500,300
952843339,952840156,952864720,24564,2501,300
952872257,952868855,952892666,23811,2502,300
952900202,952896801,952920274,23473,2503,300
952927722,952924538,952951339,26801,2504,300
952958877,952955474,952979940,24466,2505,300
952987476,952984075,953007273,23198,2506,300
953014810,953011408,953034904,23496,2507,300
953042283,953039099,953060773,21674,2508,300
953068169,953064986,953087945,22959,2509,300
953095481,953092080,953114941,22861,2510,300
953122478,953119076,953144176,25100,2511,300
953151624,953148440,953170136,21696,2512,300
953177672,953174271,953197785,23514,2513,300
953205321,953201920,953227018,25098,2514,300
953234554,953231153,953254668,23515,2515,300
953262076,953258891,953282508,23617,2516,300
953289917,953286733,953310009,23276,2517,300
953317545,953314144,953337954,23810,2518,300
953345490,953342089,953364613,22524,2519,300
953372150,953368748,953390956,22208,2520,300
953398365,953395180,953419428,24248,2521,300
953426965,953423563,953445793,22230,2522,300
953453189,953450004,953473915,23911,2523,300
953481451,953478050,953499009,20959,2524,300
953506546,953503144,953525688,22544,2525,300
953533224,953529823,953553634,23811,2526,300
953561169,953557769,953581283,23514,2527,300
953588716,953585532,953609780,24248,2528,300
953617317,953613915,953636438,22523,2529,300
953643879,953640695,953662390,21695,2530,300
953669796,953666612,953687650,21038,2531,300
953695186,953691785,953715912,24127,2532,300
953723331,953720147,953743128,22981,2533,300
953750664,953747263,953771074,23811,2534,300
953778611,953775209,953798071,22862,2535,300
953805606,953802206,953827302,25096,2536,300
953834838,953831437,953854616,23179,2537,300
953862154,953858751,953883852,25101,2538,300
953891225,953888041,953912900,24859,2539,300
953920436,953917035,953940212,23177,2540,300
953947749,953944347,953969762,25415,2541,300
953977298,953973897,953997074,23177,2542,300
954004610,954001208,954024388,23180,2543,300
954031825,954028640,954052869,24229,2544,300
954060405,954057004,954079212,22208,2545,300
954086748,954083347,954105870,22523,2546,300
954113406,954110005,954133500,23495,2547,300
954140877,954137693,954160970,23277,2548,300
954168506,954165105,954191151,26046,2549,300
954198556,954195371,954218986,23615,2550,300
954226522,954223121,954248536,25415,2551,300
954255925,954252741,954275996,23255,2552,300
954283533,954280131,954303922,23791,2553,300
954311327,954308143,954333974,25831,2554,300
954341510,954338109,954361603,23494,2555,300
954368995,954365810,954388116,22306,2556,300
954395652,954392251,954418004,25753,2557,300
954425540,954422139,954444030,21891,2558,300
954451566,954448165,954471998,23833,2559,300
954479534,954476133,954501230,25097,2560,300
954508599,954505416,954527426,22010,2561,300
954534962,954531561,954555350,23789,2562,300
954562886,954559485,954585217,25732,2563,300
954592754,954589353,954612529,23176,2564,300
954620066,954616664,954638894,22230,2565,300
954646430,954643029,954665595,22566,2566,300
954673130,954669730,954695777,26047,2567,300
954703315,954699913,954724039,24126,2568,300
954731485,954728301,954750924,22623,2569,300
954758461,954755059,954780135,25076,2570,300
954787557,954784373,954807650,23277,2571,300
954815024,954811839,954836065,24226,2572,300
954843459,954840275,954864503,24228,2573,300
954872040,954868638,954890867,22229,2574,300
954898404,954895002,954921072,26070,2575,300
954928503,954925319,954947963,22644,2576,300
954955498,954952098,954977828,25730,2577,300
954985365,954981964,955008982,27018,2578,300
955016369,955013184,955034225,21041,2579,300
955041611,955038425,955060437,22012,2580,300
955067974,955064572,955089333,24761,2581,300
955096702,955093518,955116458,22940,2582,300
955123995,955120594,955144383,23789,2583,300
955151748,955148563,955170575,22012,2584,300
955178111,955174710,955197255,22545,2585,300
955204791,955201391,955227774,26383,2586,300
955235312,955231910,955253801,21891,2587,300
955261338,955257936,955281748,23812,2588,300
955289179,955285995,955309948,23953,2589,300
955317338,955314152,955338718,24566,2590,300
955346254,955342853,955368267,25414,2591,300
955375803,955372402,955395917,23515,2592,300
955403302,955400119,955426603,26484,2593,300
955434140,955430739,955453600,22861,2594,300
955461139,955457736,955482182,24446,2595,300
955489569,955486384,955510610,24226,2596,300
955517976,955514791,955539673,24882,2597,300
955547209,955543809,955566987,23178,2598,300
955574525,955571123,955594955,23832,2599,300
955602492,955599090,955624821,25731,2600,300
955632359,955628957,955651503,22546,2601,300
955659040,955655638,955679450,23812,2602,300
955686988,955683586,955707734,24148,2603,300
955715105,955711921,955734881,22960,2604,300
955742419,955739017,955761563,22546,2605,300
955769099,955765698,955790139,24441,2606,300
955797675,955794275,955818740,24465,2607,300
955826161,955822977,955847858,24881,2608,300
955855395,955851994,955874559,22565,2609,300
955882001,955878817,955901460,22643,2610,300
955908903,955905718,955930284,24566,2611,300
955937704,955934521,955958449,23928,2612,300
955965986,955962585,955985764,23179,2613,300
955993302,955989900,956013394,23494,2614,300
956020764,956017579,956040879,23300,2615,300
956048267,956045083,956069330,24247,2616,300
956076865,956073465,956098562,25097,2617,300
956105949,956102764,956126378,23614,2618,300
956133915,956130514,956152740,22226,2619,300
956160277,956156876,956180076,23200,2620,300
956187614,956184212,956208340,24128,2621,300
956215772,956212587,956236181,23594,2622,300
956243718,956240317,956264761,24444,2623,300
956272299,956268897,956293026,24129,2624,300
956300469,956297285,956321216,23931,2625,300
956328753,956325352,956348866,23514,2626,300
956356267,956353082,956377309,24227,2627,300
956384760,956381574,956405464,23890,2628,300
956413001,956409600,956431807,22207,2629,300
956439211,956436026,956458039,22013,2630,300
956465576,956462175,956485353,23178,2631,300
956492891,956489489,956511698,22209,2632,300
956519133,956515949,956537621,21672,2633,300
956544991,956541806,956564452,22646,2634,300
956571989,956568588,956593033,24445,2635,300
956600476,956597292,956620886,23594,2636,300
956628263,956625079,956650592,25513,2637,300
956658131,956654728,956679175,24447,2638,300
956686571,956683386,956707951,24565,2639,300
956715353,956712169,956736734,24565,2640,300
956744271,956740870,956764660,23790,2641,300
956772197,956768796,956791972,23176,2642,300
956799407,956796222,956819816,23594,2643,300
956827353,956823952,956846834,22882,2644,300
956854222,956851038,956873999,22961,2645,300
956881395,956878211,956902141,23930,2646,300
956909538,956906354,956929631,23277,2647,300
956937007,956933822,956958683,24861,2648,300
956966220,956962818,956985678,22860,2649,300
956993048,956989864,957012171,22307,2650,300
957019706,957016306,957041065,24759,2651,300
957048462,957045277,957068892,23615,2652,300
957076211,957073027,957099845,26818,2653,300
957107235,957104051,957126674,22623,2654,300
957134212,957130810,957153649,22839,2655,300
957161186,957157785,957183832,26047,2656,300
957191370,957187968,957211802,23834,2657,300
957219339,957215937,957239096,23159,2658,300
957246488,957243303,957268185,24882,2659,300
957275593,957272406,957296319,23913,2660,300
957303856,957300455,957322366,21911,2661,300
957329901,957326501,957349339,22838,2662,300
957356876,957353475,957380494,27019,2663,300
957388031,957384630,957409074,24444,2664,300
957416448,957413264,957436859,23595,2665,300
957444266,957441080,957464359,23279,2666,300
957471896,957468494,957491061,22567,2667,300
957498435,957495252,957518867,23615,2668,300
957526262,957523078,957547960,24882,2669,300
957555495,957552095,957575904,23809,2670,300
957583334,957580150,957604419,24269,2671,300
957611957,957608555,957633336,24781,2672,300
957640874,957637472,957660651,23179,2673,300
957668188,957664787,957689569,24782,2674,300
957696959,957693775,957717391,23616,2675,300
957724927,957721526,957746287,24761,2676,300
957753825,957750423,957774551,24128,2677,300
957782087,957778686,957801842,23156,2678,300
957809378,957805978,957828836,22858,2679,300
957836207,957833021,957855963,22942,2680,300
957863501,957860099,957884564,24465,2681,300
957892102,957888700,957913146,24446,2682,300
957920683,957917282,957942064,24782,2683,300
957949440,957946255,957968878,22623,2684,300
957976415,957973013,957997141,24128,2685,300
958004679,958001277,958026375,25098,2686,300
958033913,958030511,958055272,24761,2687,300
958062692,958059508,958084074,24566,2688,300
958091611,958088210,958111702,23492,2689,300
958119151,958115966,958140193,24227,2690,300
958147730,958144329,958168815,24486,2691,300
958176227,958173043,958196637,23594,2692,300
958204029,958200844,958222834,21990,2693,300
958230371,958226970,958250781,23811,2694,300
958258319,958254917,958278413,23496,2695,300
958285949,958282548,958304122,21574,2696,300
958311659,958308258,958331119,22861,2697,300
958338656,958335255,958360354,25099,2698,300
958367748,958364563,958388158,23595,2699,300
958395696,958392294,958415790,23496,2700,300
958423179,958419994,958446480,26486,2701,300
958454017,958450616,958474112,23496,2702,300
958481650,958478248,958503347,25099,2703,300
958510884,958507482,958531315,23833,2704,300
958538851,958535450,958561160,25710,2705,300
958568698,958565296,958587524,22228,2706,300
958594927,958591741,958615020,23279,2707,300
958622387,958619203,958642794,23591,2708,300
958650208,958647025,958667768,20743,2709,300
958675307,958671904,958694745,22841,2710,300
958702281,958698880,958722373,23493,2711,300
958729784,958726599,958752431,25832,2712,300
958759969,958756567,958778795,22228,2713,300
958786197,958783012,958806923,23911,2714,300
958814460,958811058,958832970,21912,2715,300
958840508,958837106,958863493,26387,2716,300
958871031,958867629,958892075,24446,2717,300
958899477,958896292,958917986,21694,2718,300
958925523,958922122,958946586,24464,2719,300
958954123,958950722,958975820,25098,2720,300
958983230,958980046,959001404,21358,2721,300
959008940,959005540,959028717,23177,2722,300
959036256,959032853,959056982,24129,2723,300
959064519,959061118,959085921,24803,2724,300
959093459,959090057,959115789,25732,2725,300
959123226,959120042,959144270,24228,2726,300
959151806,959148405,959173504,25099,2727,300
959181042,959177640,959198582,20942,2728,300
959206000,959202816,959225124,22308,2729,300
959232516,959229332,959252610,23278,2730,300
959260148,959256746,959280242,23496,2731,300
959287779,959284378,959310110,25732,2732,300
959317647,959314246,959338056,23810,2733,300
959345593,959342192,959366636,24444,2734,300
959374014,959370829,959392841,22012,2735,300
959400292,959397107,959422645,25538,2736,300
959430183,959426781,959451563,24782,2737,300
959459002,959455819,959479095,23276,2738,300
959486630,959483230,959506744,23514,2739,300
959514281,959510879,959533425,22546,2740,300
959540963,959537561,959562978,25417,2741,300
959570354,959567170,959590764,23594,2742,300
959598301,959594899,959620316,25417,2743,300
959627767,959624582,959648493,23911,2744,300
959656031,959652629,959679017,26388,2745,300
959686404,959683219,959704260,21041,2746,300
959711797,959708395,959731890,23495,2747,300
959739428,959736026,959762074,26048,2748,300
959769611,959766210,959789703,23493,2749,300
959797240,959793839,959818934,25095,2750,300
959826470,959823069,959844960,21891,2751,300
959852497,959849096,959875799,26703,2752,300
959883249,959880064,959903321,23257,2753,300
959910707,959907523,959933058,25535,2754,300
959940595,959937194,959962609,25415,2755,300
959970145,959966745,959988000,21255,2756,300
959995537,959992136,960016264,24128,2757,300
960023801,960020400,960045815,25415,2758,300
960053208,960050025,960073301,23276,2759,300
960080838,960077436,960101583,24147,2760,300
960109022,960105838,960129116,23278,2761,300
960136653,960133251,960158351,25100,2762,300
960165888,960162486,960185008,22522,2763,300
960192543,960189143,960212320,23177,2764,300
960219725,960216539,960243657,27118,2765,300
960251077,960247894,960272141,24247,2766,300
960279678,960276276,960300721,24445,2767,300
960308258,960304856,960328666,23810,2768,300
960336035,960332850,960354227,21377,2769,300
960361764,960358362,960383123,24761,2770,300
960390659,960387259,960411069,23810,2771,300
960418606,960415204,960439649,24445,2772,300
960447186,960443784,960468250,24466,2773,300
960475627,960472442,960496354,23912,2774,300
960503798,960500613,960524206,23593,2775,300
960531741,960528341,960552784,24443,2776,300
960560320,960556919,960582966,26047,2777,300
960590503,960587102,960612538,25436,2778,300
960620075,960616673,960640168,23495,2779,300
960647703,960644303,960668429,24126,2780,300
960675800,960672615,960697180,24565,2781,300
960704568,960701383,960724998,23615,2782,300
960732436,960729250,960751896,22646,2783,300
960759338,960756153,960777848,21695,2784,300
960785384,960781984,960804529,22545,2785,300
960811921,960808738,960833005,24267,2786,300
960840541,960837140,960858101,20961,2787,300
960865537,960862353,960886263,23910,2788,300
960893800,960890399,960912648,22249,2789,300
960920068,960916883,960939507,22624,2790,300
960947043,960943642,960968085,24443,2791,300
960975523,960972338,960995931,23593,2792,300
961003353,961000169,961029292,29123,2793,300
961036681,961033496,961057724,24228,2794,300
961065260,961061859,961084719,22860,2795,300
961092256,961088855,961112983,24128,2796,300
961120520,961117118,961140634,23516,2797,300
961148171,961144770,961168579,23809,2798,300
961175996,961172813,961194802,21989,2799,300
961202176,961198992,961223218,24226,2800,300
961230594,961227410,961249399,21989,2801,300
961256787,961253603,961276899,23296,2802,300
961284345,961281161,961304753,23592,2803,300
961312153,961308967,961334186,25219,2804,300
961341574,961338390,961364876,26486,2805,300
961372414,961369012,961392822,23810,2806,300
961400358,961396957,961421401,24444,2807,300
961428795,961425610,961449543,23933,2808,300
961457080,961453678,961479092,25414,2809,300
961486628,961483227,961508641,25414,2810,300
961516177,961512776,961536924,24148,2811,300
961544460,961541059,961563921,22862,2812,300
961571457,961568056,961592521,24465,2813,300
961599933,961596748,961618443,21695,2814,300
961625980,961622578,961645417,22839,2815,300
961652853,961649668,961673896,24228,2816,300
961681433,961678031,961703448,25417,2817,300
961710868,961707683,961732271,24588,2818,300
961739642,961736457,961761022,24565,2819,300
961768559,961765157,961789622,24465,2820,300
961797007,961793823,961818683,24860,2821,300
961826122,961822938,961845561,22623,2822,300
961853097,961849696,961871585,21889,2823,300
961879120,961875720,961900205,24485,2824,300
961907742,961904341,961929439,25098,2825,300
961936975,961933575,961959642,26067,2826,300
961967181,961963778,961988858,25080,2827,300
961996395,961992994,962017437,24443,2828,300
962024975,962021573,962044435,22862,2829,300
962051850,962048666,962072282,23616,2830,300
962079653,962076468,962099767,23299,2831,300
962107302,962103902,962125158,21256,2832,300
962132694,962129293,962152767,23474,2833,300
962160305,962156903,962182951,26048,2834,300
962190329,962187145,962211688,24543,2835,300
962219056,962215872,962239149,23277,2836,300
962246567,962243384,962267315,23931,2837,300
962274851,962271450,962297519,26069,2838,300
962304887,962301702,962325298,23596,2839,300
962332836,962329434,962353244,23810,2840,300
962360687,962357502,962379197,21695,2841,300
962386581,962383396,962406992,23596,2842,300
962414527,962411127,962434304,23177,2843,300
962441693,962438509,962461765,23256,2844,300
962469137,962465953,962490831,24878,2845,300
962498367,962494966,962520085,25119,2846,300
962527622,962524221,962546744,22523,2847,300
962554279,962550879,962576292,25413,2848,300
962583827,962580427,962604575,24148,2849,300
962611950,962608765,962631072,22307,2850,300
962638608,962635207,962658723,23516,2851,300
962666260,962662858,962686986,24128,2852,300
962694523,962691121,962715249,24128,2853,300
962722684,962719500,962742122,22622,2854,300
962749658,962746258,962771988,25730,2855,300
962779526,962776124,962799936,23812,2856,300
962807472,962804071,962829802,25731,2857,300
962837339,962833938,962859351,25413,2858,300
962866787,962863602,962889434,25832,2859,300
962896805,962893621,962917869,24248,2860,300
962925313,962922129,962944751,22622,2861,300
962952173,962948989,962972265,23276,2862,300
962979801,962976400,963003419,27019,2863,300
963010824,963007638,963031233,23595,2864,300
963038599,963035415,963057110,21695,2865,300
963064646,963061245,963085055,23810,2866,300
963092592,963089191,963114607,25416,2867,300
963121975,963118791,963141435,22644,2868,300
963148818,963145633,963169227,23594,2869,300
963176763,963173362,963197509,24147,2870,300
963205047,963201645,963225793,24148,2871,300
963233329,963229928,963254075,24147,2872,300
963261446,963258263,963281540,23277,2873,300
963289077,963285675,963308517,22842,2874,300
963315884,963312701,963336293,23592,2875,300
963343830,963340429,963364556,24127,2876,300
963371994,963368809,963392720,23911,2877,300
963400257,963396856,963420371,23515,2878,300
963427908,963424506,963447368,22862,2879,300
963454903,963451503,963476282,24779,2880,300
963483664,963480479,963503441,22962,2881,300
963510978,963507577,963532043,24466,2882,300
963539579,963536178,963561592,25414,2883,300
963569129,963565727,963590824,25097,2884,300
963598360,963594959,963620374,25415,2885,300
963627911,963624509,963648637,24128,2886,300
963656172,963652772,963676898,24126,2887,300
963684435,963681033,963705478,24445,2888,300
963712887,963709703,963733318,23615,2889,300
963740691,963737507,963761417,23910,2890,300
963768784,963765600,963790503,24903,2891,300
963798039,963794638,963816866,22228,2892,300
963824404,963821001,963843526,22525,2893,300
963850913,963847728,963869719,21991,2894,300
963877255,963873854,963898953,25099,2895,300
963906358,963903174,963927738,24564,2896,300
963935274,963931873,963954713,22840,2897,300
963962250,963958848,963983946,25098,2898,300
963991483,963988082,964010944,22862,2899,300
964018480,964015079,964042414,27335,2900,300
964049951,964046550,964067490,20940,2901,300
964075026,964071625,964095119,23494,2902,300
964102655,964099255,964124015,24760,2903,300
964131551,964128151,964153248,25097,2904,300
964160784,964157383,964181193,23810,2905,300
964188728,964185328,964208819,23491,2906,300
964216185,964213000,964238198,25198,2907,300
964245734,964242333,964266480,24147,2908,300
964273918,964270736,964294327,23591,2909,300
964301863,964298462,964321957,23495,2910,300
964329392,964326207,964351089,24882,2911,300
964358625,964355225,964377135,21910,2912,300
964384535,964381351,964405282,23931,2913,300
964412819,964409417,964433250,23833,2914,300
964440654,964437470,964460746,23276,2915,300
964468282,964464881,964489346,24465,2916,300
964496882,964493481,964515686,22205,2917,300
964523066,964519881,964543475,23594,2918,300
964550869,964547685,964572882,25197,2919,300
964580419,964577017,964601462,24445,2920,300
964608848,964605664,964629257,23593,2921,300
964636795,964633393,964656910,23517,2922,300
964664446,964661045,964685825,24780,2923,300
964693362,964689961,964715377,25416,2924,300
964722914,964719512,964743957,24445,2925,300
964751331,964748148,964773999,25851,2926,300
964781536,964778135,964801628,23493,2927,300
964809164,964805763,964829552,23789,2928,300
964837089,964833687,964858133,24446,2929,300
964865670,964862268,964886417,24149,2930,300
964893781,964890597,964916745,26148,2931,300
964924282,964920881,964945323,24442,2932,300
964952859,964949458,964972952,23494,2933,300
964980490,964977087,965000287,23200,2934,300
965007668,965004484,965028099,23615,2935,300
965035535,965032350,965054974,22624,2936,300
965062510,965059109,965084840,25731,2937,300
965092378,965088976,965111839,22863,2938,300
965119376,965115975,965137886,21911,2939,300
965145421,965142021,965165513,23492,2940,300
965173048,965169648,965193457,23809,2941,300
965200902,965197717,965222894,25177,2942,300
965230430,965227029,965250523,23494,2943,300
965257920,965254737,965277716,22979,2944,300
965285251,965281851,965303740,21889,2945,300
965311149,965307964,965329638,21674,2946,300
965337085,965333901,965358466,24565,2947,300
965366002,965362601,965386410,23809,2948,300
965393946,965390545,965414039,23494,2949,300
965421424,965418239,965439281,21042,2950,300
965446683,965443498,965465827,22329,2951,300
965473203,965470018,965493634,23616,2952,300
965501170,965497769,965519974,22205,2953,300
965527409,965524225,965548769,24544,2954,300
965556176,965552990,965575319,22329,2955,300
965582856,965579454,965602655,23201,2956,300
965610192,965606791,965631890,25099,2957,300
965639427,965636025,965659519,23494,2958,300
965667055,965663654,965687466,23812,2959,300
965694841,965691658,965716539,24881,2960,300
965724075,965720674,965745435,24761,2961,300
965752973,965749571,965774332,24761,2962,300
965781869,965778467,965801645,23178,2963,300
965809055,965805870,965829148,23278,2964,300
965836685,965833284,965856462,23178,2965,300
965863841,965860656,965883617,22961,2966,300
965891154,965887753,965910318,22565,2967,300
965917725,965914541,965938136,23595,2968,300
965945674,965942272,965966421,24149,2969,300
965973959,965970557,965996944,26387,2970,300
966004481,966001080,966023623,22543,2971,300
966030992,966027806,966052371,24565,2972,300
966059909,966056507,966083524,27017,2973,300
966090910,966087726,966113557,25831,2974,300
966121093,966117693,966143086,25393,2975,300
966150624,966147222,966171371,24149,2976,300
966178908,966175506,966198050,22544,2977,300
966205454,966202268,966227469,25201,2978,300
966234844,966231659,966256225,24566,2979,300
966263762,966260361,966283539,23178,2980,300
966290910,966287726,966312586,24860,2981,300
966320124,966316722,966342116,25394,2982,300
966349486,966346301,966367679,21378,2983,300
966375215,966371815,966397862,26047,2984,300
966405256,966402072,966426615,24543,2985,300
966434151,966430750,966452978,22228,2986,300
966460392,966457208,966478881,21673,2987,300
966486281,966483097,966505404,22307,2988,300
966512940,966509540,966532399,22859,2989,300
966539935,966536534,966558129,21595,2990,300
966565666,966562265,966585464,23199,2991,300
966593000,966589599,966612776,23177,2992,300
966620313,966616912,966641038,24126,2993,300
966648434,966645250,966667262,22012,2994,300
966674653,966671469,966694747,23278,2995,300
966702283,966698882,966723347,24465,2996,300
966730884,966727482,966751907,24425,2997,300
966759443,966756042,966780169,24127,2998,300
966787705,966784304,966809719,25415,2999,300
966817127,966813942,966836903,22961,3000,300
966844341,966841156,966862850,21694,3001,300
966870387,966866985,966892379,25394,3002,300
966899914,966896514,966918740,22226,3003,300
966926275,966922875,966947338,24463,3004,300
966954775,966951591,966975502,23911,3005,300
966982951,966979767,967004015,24248,3006,300
967011463,967008279,967031557,23278,3007,300
967039095,967035693,967061742,26049,3008,300
967069279,967065878,967089057,23179,3009,300
967096488,967093304,967117846,24542,3010,300
967125383,967121981,967144843,22862,3011,300
967152252,967149067,967174264,25197,3012,300
967181800,967178400,967203518,25118,3013,300
967211055,967207653,967230831,23178,3014,300
967238215,967235031,967259279,24248,3015,300
967266815,967263414,967286908,23494,3016,300
967294445,967291043,967315509,24466,3017,300
967323045,967319644,967346028,26384,3018,300
967353566,967350164,967373344,23180,3019,300
967380755,967377570,967398609,21039,3020,300
967406146,967402744,967429129,26385,3021,300
967436667,967433265,967454860,21595,3022,300
967462266,967459083,967481092,22009,3023,300
967488628,967485227,967507455,22228,3024,300
967514990,967511590,967537638,26048,3025,300
967545009,967541824,967566390,24566,3026,300
967573787,967570603,967596116,25513,3027,300
967603653,967600252,967626636,26384,3028,300
967634173,967630772,967654900,24128,3029,300
967662437,967659036,967681580,22544,3030,300
967689025,967685841,967707831,21990,3031,300
967715367,967711966,967735776,23810,3032,300
967743312,967739911,967763405,23494,3033,300
967770846,967767663,967790918,23255,3034,300
967798454,967795053,967816964,21911,3035,300
967824351,967821167,967845076,23909,3036,300
967852612,967849211,967872704,23493,3037,300
967880240,967876839,967900968,24129,3038,300
967908504,967905103,967930200,25097,3039,300
967937737,967934336,967957830,23494,3040,300
967965366,967961965,967984173,22208,3041,300
967991708,967988308,968013088,24780,3042,300
968020623,968017223,968041370,24147,3043,300
968048907,968045505,968071891,26386,3044,300
968079427,968076027,968099499,23472,3045,300
968106894,968103710,968128886,25176,3046,300
968136423,968133022,968155250,22228,3047,300
968162787,968159385,968184146,24761,3048,300
968191682,968188281,968211459,23178,3049,300
968218994,968215594,968241323,25729,3050,300
968248861,968245459,968268617,23158,3051,300
968276153,968272753,968294346,21593,3052,300
968301752,968298568,968320895,22327,3053,300
968328431,968325030,968350127,25097,3054,300
968357500,968354316,968378881,24565,3055,300
968386265,968383081,968406673,23592,3056,300
968414054,968410870,968434148,23278,3057,300
968441534,968438349,968461627,23278,3058,300
968469162,968465762,968488622,22860,3059,300
968496159,968492758,968516231,23473,3060,300
968523626,968520442,968544055,23613,3061,300
968551476,968548291,968571865,23574,3062,300
968579302,968576118,968598108,21990,3063,300
968605644,968602244,968626709,24465,3064,300
968634247,968630845,968654656,23811,3065,300
968662037,968658851,968682763,23912,3066,300
968690298,968686898,968710708,23810,3067,300
968718104,968714919,968738197,23278,3068,300
968745733,968742332,968769349,27017,3069,300
968776886,968773485,968798603,25118,3070,300
968806140,968802739,968824968,22229,3071,300
968832504,968829103,968855150,26047,3072,300
968862553,968859370,968882647,23277,3073,300
968890020,968886836,968909480,22644,3074,300
968917016,968913615,968937742,24127,3075,300
968945278,968941877,968963452,21575,3076,300
968970989,968967587,968989499,21912,3077,300
968996866,968993682,969015670,21988,3078,300
969023207,969019805,969044271,24466,3079,300
969051674,969048489,969071766,23277,3080,300
969079136,969075951,969097942,21991,3081,300
969105480,969102077,969127492,25415,3082,300
969135029,969131627,969154489,22862,3083,300
969161885,969158700,969181978,23278,3084,300
969189376,969186191,969211726,25535,3085,300
969219108,969215924,969240172,24248,3086,300
969247576,969244392,969267670,23278,3087,300
969275206,969271805,969295931,24126,3088,300
969303468,969300067,969323582,23515,3089,300
969331002,969327816,969352067,24251,3090,300
969359487,969356303,969377974,21671,3091,300
969385510,969382110,969403998,21888,3092,300
969411535,969408134,969430680,22546,3093,300
969438216,969434815,969458626,23811,3094,300
969466164,969462762,969485940,23178,3095,300
969493477,969490076,969514224,24148,3096,300
969521760,969518359,969543455,25096,3097,300
969550829,969547645,969572527,24882,3098,300
969580065,969576663,969601128,24465,3099,300
969608572,969605388,969629299,23911,3100,300
969636834,969633434,969657877,24443,3101,300
969665413,969662012,969686772,24760,3102,300
969694147,969690963,969716161,25198,3103,300
969723698,969720297,969744742,24445,3104,300
969752279,969748878,969774292,25414,3105,300
969781829,969778428,969801626,23198,3106,300
969809016,969805832,969830693,24861,3107,300
969838229,969834829,969858660,23831,3108,300
969866197,969862796,969885952,23156,3109,300
969893488,969890087,969913918,23831,3110,300
969921360,969918175,969942107,23932,3111,300
969949492,969946308,969970555,24247,3112,300
969977963,969974779,969998056,23277,3113,300
970005506,970002321,970026212,23891,3114,300
970033598,970030413,970055612,25199,3115,300
970063149,970059747,970083241,23494,3116,300
970090779,970087377,970109902,22525,3117,300
970117437,970114037,970137214,23177,3118,300
970144750,970141349,970164189,22840,3119,300
970171725,970168324,970194393,26069,3120,300
970201931,970198529,970222044,23515,3121,300
970229580,970226180,970251910,25730,3122,300
970259285,970256100,970280981,24881,3123,300
970288517,970285116,970308948,23832,3124,300
970316324,970313139,970338357,25218,3125,300
970345773,970342588,970365528,22940,3126,300
970373064,970369663,970391238,21575,3127,300
970398612,970395427,970419634,24207,3128,300
970427171,970423769,970449500,25731,3129,300
970457037,970453636,970476497,22861,3130,300
970484034,970480633,970503474,22841,3131,300
970511010,970507610,970531419,23809,3132,300
970538955,970535554,970559999,24445,3133,300
970567397,970564212,970590381,26169,3134,300
970597919,970594517,970617060,22543,3135,300
970624462,970621278,970644534,23256,3136,300
970651985,970648801,970673345,24544,3137,300
970680882,970677481,970701290,23809,3138,300
970708828,970705426,970728288,22862,3139,300
970735658,970732473,970755751,23278,3140,300
970763288,970759887,970784669,24782,3141,300
970792085,970788900,970812810,23910,3142,300
970820346,970816945,970841093,24148,3143,300
970848541,970845356,970868317,22961,3144,300
970875853,970872453,970895313,22860,3145,300
970902753,970899567,970922528,22961,3146,300
970929947,970926762,970950039,23277,3147,300
970957454,970954270,970979447,25177,3148,300
970986984,970983583,971007097,23514,3149,300
971014474,971011288,971036487,25199,3150,300
971043931,971040746,971062419,21673,3151,300
971069956,971066554,971089417,22863,3152,300
971096834,971093650,971119816,26166,3153,300
971127214,971124031,971145702,21671,3154,300
971153237,971149837,971172674,22837,3155,300
971180211,971176810,971203492,26682,3156,300
971211029,971207628,971230172,22544,3157,300
971237708,971234307,971259087,24780,3158,300
971266524,971263340,971285687,22347,3159,300
971293119,971289935,971315449,25514,3160,300
971322987,971319584,971342763,23179,3161,300
971350135,971346951,971369573,22622,3162,300
971376942,971373757,971398323,24566,3163,300
971405861,971402459,971429162,26703,3164,300
971436699,971433298,971457426,24128,3165,300
971464814,971461629,971486511,24882,3166,300
971494050,971490647,971513511,22864,3167,300
971521048,971517647,971540508,22861,3168,300
971548046,971544643,971569089,24446,3169,300
971576504,971573320,971596259,22939,3170,300
971603671,971600487,971626973,26486,3171,300
971634511,971631109,971654603,23494,3172,300
971662018,971658833,971684348,25515,3173,300
971691886,971688484,971710711,22227,3174,300
971718154,971714969,971737931,22962,3175,300
971745467,971742066,971766215,24149,3176,300
971773752,971770351,971792873,22522,3177,300
971800240,971797056,971822255,25199,3178,300
971829792,971826390,971847964,21574,3179,300
971855501,971852100,971875911,23811,3180,300
971883313,971880129,971904356,24227,3181,300
971911892,971908491,971933906,25415,3182,300
971941442,971938041,971960923,22882,3183,300
971968461,971965059,971989820,24761,3184,300
971997193,971994010,972018891,24881,3185,300
972026296,972023113,972048309,25196,3186,300
972055845,972052445,972076571,24126,3187,300
972084109,972080707,972101648,20941,3188,300
972109024,972105839,972129137,23298,3189,300
972136532,972133347,972156943,23596,3190,300
972164313,972161128,972185040,23912,3191,300
972192481,972189296,972211286,21990,3192,300
972218823,972215421,972237947,22526,3193,300
972245484,972242083,972268448,26365,3194,300
972275986,972272584,972295107,22523,3195,300
972302545,972299360,972325846,26486,3196,300
972333237,972330053,972353961,23908,3197,300
972361327,972358143,972380787,22644,3198,300
972388324,972384923,972410021,25098,3199,300
972417416,972414231,972438143,23912,3200,300
972445680,972442279,972466744,24465,3201,300
972474280,972470879,972494037,23158,3202,300
972501574,972498173,972521012,22839,3203,300
972528548,972525147,972546426,21279,3204,300
972553962,972550561,972575004,24443,3205,300
972582385,972579200,972602814,23614,3206,300
972610349,972606949,972633015,26066,3207,300
972640552,972637151,972657795,20644,3208,300
972665177,972661992,972686221,24229,3209,300
972693759,972690357,972715457,25100,3210,300
972722993,972719593,972741799,22206,3211,300
972749219,972746035,972772521,26486,3212,300
972780060,972776657,972801101,24444,3213,300
972808544,972805359,972829904,24545,3214,300
972837277,972834093,972857983,23890,3215,300
972865519,972862118,972887512,25394,3216,300
972895047,972891647,972917397,25750,3217,300
972924936,972921533,972951548,30015,3218,300
972959086,972955684,972979180,23496,3219,300
972986715,972983315,973006809,23494,3220,300
973014344,973010944,973036041,25097,3221,300
973043578,973040176,973063354,23178,3222,300
973070890,973067489,973089085,21596,3223,300
973096532,973093347,973117258,23911,3224,300
973124796,973121394,973144911,23517,3225,300
973152330,973149145,973173056,23911,3226,300
973180592,973177191,973200685,23494,3227,300
973208222,973204820,973231837,27017,3228,300
973239374,973235973,973259784,23811,3229,300
973267321,973263919,973285832,21913,3230,300
973293368,973289967,973315361,25394,3231,300
973322796,973319611,973344177,24566,3232,300
973351613,973348429,973371706,23277,3233,300
973379077,973375892,973397882,21990,3234,300
973405269,973402083,973425381,23298,3235,300
973432746,973429561,973453493,23932,3236,300
973460910,973457727,973481678,23951,3237,300
973489049,973485865,973507539,21674,3238,300
973515076,973511675,973533902,22227,3239,300
973541440,973538038,973562186,24148,3240,300
973569593,973566409,973590951,24542,3241,300
973598488,973595086,973619551,24465,3242,300
973627087,973623686,973646230,22544,3243,300
973653767,973650365,973674514,24149,3244,300
973681883,973678699,973703898,25199,3245,300
973711436,973708034,973731212,23178,3246,300
973738748,973735347,973759178,23831,3247,300
973766714,973763313,973787440,24127,3248,300
973794977,973791575,973814755,23180,3249,300
973822291,973818891,973845593,26702,3250,300
973853131,973849729,973873561,23832,3251,300
973881097,973877696,973900873,23177,3252,300
973908409,973905008,973930106,25098,3253,300
973937488,973934304,973959186,24882,3254,300
973966560,973963375,973984437,21062,3255,300
973991810,973988626,974014458,25832,3256,300
974021829,974018643,974041606,22963,3257,300
974049142,974045741,974068263,22522,3258,300
974075638,974072454,974096681,24227,3259,300
974104049,974100863,974125114,24251,3260,300
974132505,974129320,974155173,25853,3261,300
974162710,974159309,974181516,22207,3262,300
974189052,974185651,974209777,24126,3263,300
974217312,974213912,974237066,23154,3264,300
974244602,974241202,974266932,25730,3265,300
974274334,974271148,974296030,24882,3266,300
974303567,974300166,974323661,23495,3267,300
974331199,974327796,974350656,22860,3268,300
974358049,974354865,974378797,23932,3269,300
974386333,974382932,974407377,24445,3270,300
974414913,974411512,974434690,23178,3271,300
974442226,974438825,974463608,24783,3272,300
974471144,974467743,974491869,24126,3273,300
974499405,974496004,974520468,24464,3274,300
974528004,974524603,974550038,25435,3275,300
974557575,974554174,974579588,25414,3276,300
974586958,974583774,974608656,24882,3277,300
974616193,974612791,974634366,21575,3278,300
974641904,974638502,974663601,25099,3279,300
974671138,974667736,974693151,25415,3280,300
974700689,974697287,974720467,23180,3281,300
974728003,974724602,974748096,23494,3282,300
974755633,974752231,974777668,25437,3283,300
974785206,974781803,974805614,23811,3284,300
974813151,974809749,974834194,24445,3285,300
974841589,974838405,974861702,23297,3286,300
974869238,974865837,974890597,24760,3287,300
974898133,974894732,974917910,23178,3288,300
974925341,974922157,974947988,25831,3289,300
974955525,974952124,974976883,24759,3290,300
974984254,974981071,975004685,23614,3291,300
975012079,975008895,975033143,24248,3292,300
975040681,975037279,975059846,22567,3293,300
975067383,975063981,975089081,25100,3294,300
975096505,975093320,975116282,22962,3295,300
975123820,975120418,975144207,23789,3296,300
975151744,975148343,975171816,23473,3297,300
975179264,975176081,975200961,24880,3298,300
975208331,975205146,975227158,22012,3299,300
975234694,975231293,975255126,23833,3300,300
975262499,975259314,975282592,23278,3301,300
975290128,975286727,975311171,24444,3302,300
975318542,975315356,975338317,22961,3303,300
975345855,975342453,975366896,24443,3304,300
975374433,975371031,975395815,24784,3305,300
975403350,975399950,975426967,27017,3306,300
975434504,975431103,975455231,24128,3307,300
975462607,975459423,975482066,22643,3308,300
975489487,975486303,975512154,25851,3309,300
975519691,975516290,975539783,23493,3310,300
975547196,975544012,975567942,23930,3311,300
975575479,975572078,975594940,22862,3312,300
975602476,975599075,975624490,25415,3313,300
975632027,975628625,975653384,24759,3314,300
975660921,975657520,975680698,23178,3315,300
975688235,975684833,975711220,26387,3316,300
975718757,975715356,975740433,25077,3317,300
975747970,975744569,975770300,25731,3318,300
975777672,975774487,975799685,25198,3319,300
975807082,975803898,975827513,23615,3320,300
975834892,975831708,975854331,22623,3321,300
975861868,975858467,975884199,25732,3322,300
975891736,975888335,975910858,22523,3323,300
975918394,975914993,975939437,24444,3324,300
975946974,975943573,975967384,23811,3325,300
975974825,975971641,975994285,22644,3326,300
976001822,975998421,976023835,25414,3327,300
976031372,976027970,976051780,23810,3328,300
976059316,976055915,976079748,23833,3329,300
976087123,976083939,976108820,24881,3330,300
976116356,976112955,976137399,24444,3331,300
976144936,976141535,976164734,23199,3332,300
976172270,976168869,976194622,25753,3333,300
976202160,976198758,976223856,25098,3334,300
976231392,976227991,976252456,24465,3335,300
976259842,976256658,976281201,24543,3336,300
976288609,976285425,976307415,21990,3337,300
976314785,976311601,976334542,22941,3338,300
976341938,976338754,976364268,25514,3339,300
976371805,976368403,976395423,27020,3340,300
976402960,976399559,976422737,23178,3341,300
976430144,976426959,976450217,23258,3342,300
976457752,976454352,976476875,22523,3343,300
976484316,976481133,976504409,23276,3344,300
976511809,976508624,976531269,22645,3345,300
976538685,976535501,976556859,21358,3346,300
976564396,976560994,976585437,24443,3347,300
976592974,976589572,976614968,25396,3348,300
976622360,976619177,976644056,24879,3349,300
976651592,976648191,976674556,26365,3350,300
976682093,976678692,976703454,24762,3351,300
976710822,976707638,976731232,23594,3352,300
976738769,976735367,976761100,25733,3353,300
976768639,976765236,976787465,22229,3354,300
976795002,976791601,976815728,24127,3355,300
976823265,976819863,976844307,24444,3356,300
976851844,976848443,976873542,25099,3357,300
976881078,976877677,976901509,23832,3358,300
976908900,976905716,976930281,24565,3359,300
976937715,976934530,976959392,24862,3360,300
976966786,976963601,976988462,24861,3361,300
976995853,976992669,977017213,24544,3362,300
977024750,977021348,977048052,26704,3363,300
977055589,977052188,977075366,23178,3364,300
977082903,977079501,977104580,25079,3365,300
977112119,977108716,977134788,26072,3366,300
977142168,977138984,977162578,23594,3367,300
977170113,977166713,977190839,24126,3368,300
977198375,977194974,977219418,24444,3369,300
977226954,977223553,977247385,23832,3370,300
977254921,977251520,977274043,22523,3371,300
977281581,977278179,977301674,23495,3372,300
977309072,977305888,977332373,26485,3373,300
977339740,977336556,977359180,22624,3374,300
977366551,977363367,977387278,23911,3375,300
977394816,977391414,977414591,23177,3376,300
977422127,977418726,977440934,22208,3377,300
977448305,977445121,977469347,24226,3378,300
977476884,977473483,977498582,25099,3379,300
977505972,977502788,977525411,22623,3380,300
977532948,977529547,977554645,25098,3381,300
977562182,977558780,977584512,25732,3382,300
977592049,977588648,977614716,26068,3383,300
977622253,977618852,977642684,23832,3384,300
977650086,977646902,977669526,22624,3385,300
977677062,977673661,977699391,25730,3386,300
977706929,977703527,977728309,24782,3387,300
977735845,977732445,977756255,23810,3388,300
977763649,977760464,977786634,26170,3389,300
977794172,977790770,977814265,23495,3390,300
977821802,977818401,977842845,24444,3391,300
977850218,977847034,977868707,21673,3392,300
977876245,977872843,977894101,21258,3393,300
977901506,977898322,977920331,22009,3394,300
977927867,977924466,977949543,25077,3395,300
977957079,977953678,977977804,24126,3396,300
977985341,977981939,978006406,24467,3397,300
978013943,978010541,978036273,25732,3398,300
978043663,978040478,978067281,26803,3399,300
978074651,978071467,978096033,24566,3400,300
978103427,978100241,978124787,24546,3401,300
978132323,978128922,978154992,26070,3402,300
978162404,978159220,978184735,25515,3403,300
978192137,978188953,978212884,23931,3404,300
978220420,978217019,978239860,22841,3405,300
978247396,978243995,978269388,25393,3406,300
978276927,978273524,978295754,22230,3407,300
978303290,978299889,978323066,23177,3408,300
978330602,978327202,978350695,23493,3409,300
978358232,978354830,978381533,26703,3410,300
978389071,978385669,978410767,25098,3411,300
978418304,978414902,978438377,23475,3412,300
978445914,978442513,978465077,22564,3413,300
978472524,978469339,978494538,25199,3414,300
978501988,978498803,978521132,22329,3415,300
978528528,978525343,978548938,23595,3416,300
978556388,978553204,978575533,22329,3417,300
978583069,978579668,978602529,22861,3418,300
978610066,978606664,978630814,24150,3419,300
978638190,978635006,978658284,23278,3420,300
978665821,978662420,978685913,23493,3421,300
978693347,978690162,978712470,22308,3422,300
978720006,978716606,978743287,26681,3423,300
978750823,978747423,978769650,22227,3424,300
978777187,978773786,978796964,23178,3425,300
978804500,978801099,978823642,22543,3426,300
978831178,978827778,978850954,23176,3427,300
978858358,978855173,978878114,22941,3428,300
978885651,978882250,978907032,24782,3429,300
978914476,978911292,978935833,24541,3430,300
978943370,978939969,978965384,25415,3431,300
978972920,978969520,978992696,23176,3432,300
979000145,978996960,979020892,23932,3433,300
979028328,979025143,979046501,21358,3434,300
979054038,979050637,979073837,23200,3435,300
979081220,979078035,979101967,23932,3436,300
979109505,979106103,979129598,23495,3437,300
979136970,979133785,979157718,23933,3438,300
979165255,979161854,979186950,25096,3439,300
979194487,979191086,979215234,24148,3440,300
979222771,979219370,979243202,23832,3441,300
979250740,979247337,979269567,22230,3442,300
979276987,979273803,979297713,23910,3443,300
979305250,979301849,979325977,24128,3444,300
979333515,979330113,979354896,24783,3445,300
979362430,979359031,979383176,24145,3446,300
979390553,979387369,979409381,22012,3447,300
979416773,979413589,979439442,25853,3448,300
979446814,979443629,979465324,21695,3449,300
979472704,979469520,979493114,23594,3450,300
979500487,979497303,979520265,22962,3451,300
979527636,979524452,979546464,22012,3452,300
979554002,979550600,979574411,23811,3453,300
979581811,979578626,979602558,23932,3454,300
979610096,979606694,979631455,24761,3455,300
979638992,979635591,979658451,22860,3456,300
979665987,979662587,979683863,21276,3457,300
979691399,979687998,979712443,24445,3458,300
979719978,979716578,979741992,25414,3459,300
979749392,979746209,979770457,24248,3460,300
979777993,979774592,979799987,25395,3461,300
979807523,979804123,979830487,26364,3462,300
979838025,979834623,979859406,24783,3463,300
979866943,979863542,979887670,24128,3464,300
979895066,979891881,979914525,22644,3465,300
979922062,979918661,979943422,24761,3466,300
979950957,979947557,979971051,23494,3467,300
979978588,979975186,979998997,23811,3468,300
980006533,980003132,980026626,23494,3469,300
980034161,980030761,980052988,22227,3470,300
980060364,980057178,980080774,23596,3471,300
980088143,980084958,980108575,23617,3472,300
980116113,980112711,980135258,22547,3473,300
980142691,980139506,980163101,23595,3474,300
980170638,980167237,980189781,22544,3475,300
980197178,980193992,980215056,21064,3476,300
980222461,980219277,980241584,22307,3477,300
980249122,980245720,980268265,22545,3478,300
980275803,980272401,980295917,23516,3479,300
980303455,980300053,980325152,25099,3480,300
980332689,980329288,980353731,24443,3481,300
980361165,980357981,980379972,21991,3482,300
980387510,980384108,980408237,24129,3483,300
980415773,980412372,980436817,24445,3484,300
980444352,980440952,980465414,24462,3485,300
980472780,980469597,980495426,25829,3486,300
980502963,980499562,980522740,23178,3487,300
980530276,980526875,980552289,25414,3488,300
980559825,980556424,980578315,21891,3489,300
980585852,980582450,980607210,24760,3490,300
980614607,980611423,980634363,22940,3491,300
980641900,980638498,980662332,23834,3492,300
980669728,980666544,980688850,22306,3493,300
980696387,980692986,980716163,23177,3494,300
980723701,980720299,980745735,25436,3495,300
980753182,980749998,980773929,23931,3496,300
980781319,980778133,980802363,24230,3497,300
980809741,980806556,980829834,23278,3498,300
980837370,980833970,980859678,25708,3499,300
980867215,980863814,980888258,24444,3500,300
980895796,980892394,980916544,24150,3501,300
980923962,980920776,980945976,25200,3502,300
980953512,980950111,980975843,25732,3503,300
980983258,980980073,981003373,23300,3504,300
981010910,981007509,981031320,23811,3505,300
981038700,981035514,981059764,24250,3506,300
981067300,981063899,981090285,26386,3507,300
981097736,981094551,981118461,23910,3508,300
981125998,981122597,981144823,22226,3509,300
981152222,981149038,981170415,21377,3510,300
981177855,981174671,981199552,24881,3511,300
981206926,981203742,981228308,24566,3512,300
981235706,981232521,981255799,23278,3513,300
981263336,981259935,981281530,21595,3514,300
981289066,981285665,981309160,23495,3515,300
981316604,981313419,981337330,23911,3516,300
981344868,981341466,981365615,24149,3517,300
981373151,981369750,981395820,26070,3518,300
981403241,981400056,981423989,23933,3519,300
981431527,981428125,981452590,24465,3520,300
981460126,981456726,981481844,25118,3521,300
981489380,981485980,981512680,26700,3522,300
981520217,981516816,981540310,23494,3523,300
981547847,981544446,981568573,24127,3524,300
981575993,981572808,981595771,22963,3525,300
981603309,981599907,981622769,22862,3526,300
981630305,981626905,981650062,23157,3527,300
981657599,981654198,981678684,24486,3528,300
981686067,981682881,981705845,22964,3529,300
981713383,981709981,981732506,22525,3530,300
981739903,981736719,981759342,22623,3531,300
981766879,981763478,981788872,25394,3532,300
981796407,981793007,981818103,25096,3533,300
981825641,981822239,981846684,24445,3534,300
981854220,981850820,981877520,26700,3535,300
981885057,981881656,981905783,24127,3536,300
981913318,981909918,981934698,24780,3537,300
981942236,981938834,981962329,23495,3538,300
981969866,981966465,981989938,23473,3539,300
981997474,981994074,982018516,24442,3540,300
982026054,982022652,982044228,21576,3541,300
982051764,982048363,982070885,22522,3542,300
982078325,982075141,982099052,23911,3543,300
982106501,982103317,982125644,22327,3544,300
982133052,982129866,982154094,24228,3545,300
982161633,982158230,982183648,25418,3546,300
982191062,982187877,982212105,24228,3547,300
982219642,982216241,982241003,24762,3548,300
982248441,982245256,982268218,22962,3549,300
982275755,982272354,982296798,24444,3550,300
982304333,982300933,982324111,23178,3551,300
982331509,982328325,982351602,23277,3552,300
982359141,982355738,982380837,25099,3553,300
982388374,982384973,982409754,24781,3554,300
982417290,982413890,982437384,23494,3555,300
982444777,982441594,982464575,22981,3556,300
982472111,982468711,982493470,24759,3557,300
982501007,982497605,982521438,23833,3558,300
982528976,982525574,982549090,23516,3559,300
982556627,982553226,982578324,25098,3560,300
982585863,982582460,982605005,22545,3561,300
982612543,982609141,982632952,23811,3562,300
982640490,982637088,982662187,25099,3563,300
982669589,982666405,982689662,23257,3564,300
982697198,982693798,982718558,24760,3565,300
982725990,982722806,982747351,24545,3566,300
982754887,982751487,982777238,25751,3567,300
982784660,982781474,982806991,25517,3568,300
982814441,982811257,982834218,22961,3569,300
982841754,982838354,982861531,23177,3570,300
982869067,982865667,982889476,23809,3571,300
982896844,982893659,982916938,23279,3572,300
982924323,982921139,982944417,23278,3573,300
982951795,982948611,982970623,22012,3574,300
982978063,982974879,982998831,23952,3575,300
983006221,983003036,983028234,25198,3576,300
983035772,983032370,983055864,23494,3577,300
983063401,983060000,983084443,24443,3578,300
983091827,983088642,983110653,22011,3579,300
983118190,983114788,983136678,21890,3580,300
983144214,983140813,983163990,23177,3581,300
983171407,983168222,983190234,22012,3582,300
983197771,983194369,983219467,25098,3583,300
983226861,983223677,983246954,23277,3584,300
983254490,983251089,983276523,25434,3585,300
983284060,983280658,983304470,23812,3586,300
983311870,983308686,983332911,24225,3587,300
983340447,983337046,983359907,22861,3588,300
983367291,983364107,983386729,22622,3589,300
983394265,983390864,983416279,25415,3590,300
983423815,983420414,983444880,24466,3591,300
983452416,983449015,983473501,24486,3592,300
983480946,983477761,983499435,21674,3593,300
983506854,983503670,983526948,23278,3594,300
983534349,983531164,983556025,24861,3595,300
983563562,983560161,983583971,23810,3596,300
983591393,983588209,983613406,25197,3597,300
983620779,983617594,983639269,21675,3598,300
983646670,983643485,983666128,22643,3599,300
983673572,983670388,983694615,24227,3600,300
983702008,983698823,983725626,26803,3601,300
983733163,983729762,983752938,23176,3602,300
983760474,983757073,983781539,24466,3603,300
983788948,983785762,983810961,25199,3604,300
983818498,983815096,983840510,25414,3605,300
983847949,983844765,983869329,24564,3606,300
983876726,983873541,983898424,24883,3607,300
983905960,983902559,983926371,23812,3608,300
983933786,983930601,983952927,22326,3609,300
983960463,983957062,983981526,24464,3610,300
983989062,983985661,984011393,25732,3611,300
984018931,984015529,984040943,25414,3612,300
984048333,984045148,984070685,25537,3613,300
984078117,984074932,984099477,24545,3614,300
984107013,984103612,984127738,24126,3615,300
984135176,984131991,984157168,25177,3616,300
984164568,984161385,984184344,22959,3617,300
984191879,984188479,984212944,24465,3618,300
984220481,984217079,984241861,24782,3619,300
984249242,984246057,984269672,23615,3620,300
984277041,984273857,984299075,25218,3621,300
984306609,984303210,984325437,22227,3622,300
984332975,984329573,984354018,24445,3623,300
984361554,984358153,984384202,26049,3624,300
984391739,984388338,984412171,23833,3625,300
984419706,984416306,984440433,24127,3626,300
984447829,984444644,984466339,21695,3627,300
984473876,984470474,984493019,22545,3628,300
984500554,984497154,984519696,22542,3629,300
984527232,984523831,984549246,25415,3630,300
984556783,984553382,984578163,24781,3631,300
984585608,984582422,984606017,23595,3632,300
984613554,984610152,984633014,22862,3633,300
984640384,984637200,984659504,22304,3634,300
984666889,984663705,984687931,24226,3635,300
984695467,984692066,984716213,24147,3636,300
984723749,984720348,984745425,25077,3637,300
984752961,984749560,984773392,23832,3638,300
984780929,984777527,984801656,24129,3639,300
984809192,984805791,984830888,25097,3640,300
984838424,984835023,984859149,24126,3641,300
984866685,984863284,984886777,23493,3642,300
984894315,984890913,984915378,24465,3643,300
984922794,984919610,984941916,22306,3644,300
984949324,984946140,984969733,23593,3645,300
984977173,984973989,984997245,23256,3646,300
985004783,985001381,985025826,24445,3647,300
985033195,985030011,985053627,23616,3648,300
985061165,985057763,985081597,23834,3649,300
985088989,985085805,985109082,23277,3650,300
985116619,985113218,985138949,25731,3651,300
985146317,985143131,985169618,26487,3652,300
985177155,985173754,985197565,23811,3653,300
985205102,985201700,985226800,25100,3654,300
985234336,985230935,985256370,25435,3655,300
985263769,985260585,985284180,23595,3656,300
985291586,985288402,985311341,22939,3657,300
985318722,985315538,985338499,22961,3658,300
985345905,985342721,985364710,21989,3659,300
985372097,985368912,985395377,26465,3660,300
985402809,985399624,985426109,26485,3661,300
985433646,985430245,985455344,25099,3662,300
985462880,985459479,985484049,24570,3663,300
985491586,985488185,985513601,25416,3664,300
985521137,985517736,985542200,24464,3665,300
985549616,985546432,985570047,23615,3666,300
985577458,985574274,985598205,23931,3667,300
985605653,985602469,985626696,24227,3668,300
985634233,985630831,985653693,22862,3669,300
985661230,985657828,985682927,25099,3670,300
985690332,985687148,985713611,26463,3671,300
985721148,985717746,985741240,23494,3672,300
985748776,985745375,985770156,24781,3673,300
985777692,985774291,985799389,25098,3674,300
985806800,985803616,985828792,25176,3675,300
985836238,985833054,985855697,22643,3676,300
985863234,985859832,985883666,23834,3677,300
985891202,985887801,985914185,26384,3678,300
985921586,985918401,985942312,23911,3679,300
985949706,985946523,985970114,23591,3680,300
985977650,985974249,985997427,23178,3681,300
986004964,986001562,986027610,26048,3682,300
986035148,986031746,986054607,22861,3683,300
986062142,986058742,986080631,21889,3684,300
986088008,986084825,986109682,24857,3685,300
986117218,986113817,986136023,22206,3686,300
986143419,986140236,986162858,22622,3687,300
986170394,986166993,986191457,24464,3688,300
986198994,986195593,986220691,25098,3689,300
986228087,986224901,986251387,26486,3690,300
986258821,986255636,986278280,22644,3691,300
986285818,986282415,986305298,22883,3692,300
986312834,986309433,986332294,22861,3693,300
986339830,986336429,986359922,23493,3694,300
986367458,986364057,986387236,23179,3695,300
986394772,986391371,986413283,21912,3696,300
986420702,986417515,986442082,24567,3697,300
986449619,986446217,986470682,24465,3698,300
986478059,986474875,986498152,23277,3699,300
986505689,986502288,986526752,24464,3700,300
986534288,986530887,986553770,22883,3701,300
986561189,986558005,986582549,24544,3702,300
986589944,986586759,986611641,24882,3703,300
986619178,986615776,986642162,26386,3704,300
986649699,986646298,986672028,25730,3705,300
986679446,986676261,986700172,23911,3706,300
986707609,986704426,986728674,24248,3707,300
986736209,986732809,986759193,26384,3708,300
986766731,986763329,986787796,24467,3709,300
986795234,986792049,986814060,22011,3710,300
986821596,986818195,986842975,24780,3711,300
986850512,986847110,986869993,22883,3712,300
986877529,986874129,986897305,23176,3713,300
986904688,986901504,986924780,23276,3714,300
986932316,986928915,986951144,22229,3715,300
986958681,986955279,986977846,22567,3716,300
986985233,986982049,987004990,22941,3717,300
987012529,987009126,987035809,26683,3718,300
987043347,987039945,987064747,24802,3719,300
987072185,987069000,987094854,25854,3720,300
987102392,987098990,987120565,21575,3721,300
987128101,987124700,987149481,24781,3722,300
987157019,987153616,987178716,25100,3723,300
987186255,987182851,987206982,24131,3724,300
987214518,987211117,987234610,23493,3725,300
987241989,987238804,987263685,24881,3726,300
987271221,987267820,987292918,25098,3727,300
987300315,987297130,987319774,22644,3728,300
987327310,987323909,987346115,22206,3729,300
987353651,987350250,987374716,24466,3730,300
987382253,987378851,987402346,23495,3731,300
987409882,987406481,987429363,22882,3732,300
987436900,987433498,987454778,21280,3733,300
987462227,987459043,987480738,21695,3734,300
987488181,987484996,987508275,23279,3735,300
987515811,987512410,987536538,24128,3736,300
987544074,987540673,987564822,24149,3737,300
987572359,987568958,987593401,24443,3738,300
987600937,987597536,987622317,24781,3739,300
987629736,987626551,987650483,23932,3740,300
987657927,987654741,987678358,23617,3741,300
987685895,987682494,987705672,23178,3742,300
987713208,987709807,987733322,23515,3743,300
987740759,987737576,987763427,25851,3744,300
987770874,987767690,987793542,25852,3745,300
987801079,987797678,987820221,22543,3746,300
987827758,987824357,987847851,23494,3747,300
987855299,987852115,987876996,24881,3748,300
987884532,987881131,987903993,22862,3749,300
987911530,987908129,987932911,24782,3750,300
987940448,987937047,987960859,23812,3751,300
987968253,987965069,987990583,25514,3752,300
987998119,987994718,988020113,25395,3753,300
988027649,988024248,988047741,23493,3754,300
988055152,988051968,988075563,23595,3755,300
988083098,988079698,988102559,22861,3756,300
988110095,988106694,988130820,24126,3757,300
988138357,988134955,988159399,24444,3758,300
988166936,988163535,988187050,23515,3759,300
988194586,988191185,988212123,20938,3760,300
988219659,988216258,988238147,21889,3761,300
988245683,988242282,988264529,22247,3762,300
988271936,988268751,988293294,24543,3763,300
988300830,988297429,988321240,23811,3764,300
988328777,988325376,988348553,23177,3765,300
988356090,988352688,988377786,25098,3766,300
988385322,988381921,988406069,24148,3767,300
988413605,988410204,988432727,22523,3768,300
988440158,988436974,988459301,22327,3769,300
988466840,988463437,988488875,25438,3770,300
988496296,988493112,988515734,22622,3771,300
988523269,988519869,988542728,22859,3772,300
988550123,988546939,988570870,23931,3773,300
988578316,988575132,988600984,25852,3774,300
988608521,988605120,988631507,26387,3775,300
988639044,988635643,988658208,22565,3776,300
988665745,988662344,988686471,24127,3777,300
988693855,988690670,988715867,25197,3778,300
988723402,988720002,988741258,21256,3779,300
988748708,988745524,988769139,23615,3780,300
988776677,988773275,988797109,23834,3781,300
988804507,988801322,988824917,23595,3782,300
988832453,988829052,988853179,24127,3783,300
988860559,988857374,988883206,25832,3784,300
988890743,988887342,988911489,24147,3785,300
988919025,988915624,988938803,23179,3786,300
988946341,988942938,988967067,24129,3787,300
988974436,988971251,988995163,23912,3788,300
989002699,988999298,989023446,24148,3789,300
989030982,989027581,989051392,23811,3790,300
989058783,989055599,989078875,23276,3791,300
989086263,989083078,989106989,23911,3792,300
989114525,989111125,989134934,23809,3793,300
989142372,989139188,989162782,23594,3794,300
989170318,989166917,989188174,21257,3795,300
989195615,989192430,989216996,24566,3796,300
989224532,989221131,989245277,24146,3797,300
989252814,989249412,989274511,25099,3798,300
989281907,989278722,989303920,25198,3799,300
989311309,989308125,989332036,23911,3800,300
989339573,989336172,989362219,26047,3801,300
989369641,989366456,989389101,22645,3802,300
989396637,989393236,989414830,21594,3803,300
989422366,989418965,989443726,24761,3804,300
989451094,989447909,989470531,22622,3805,300
989478068,989474666,989499447,24781,3806,300
989506984,989503583,989535814,32231,3807,300
989543206,989540021,989563300,23279,3808,300
989570837,989567436,989592533,25097,3809,300
989600071,989596669,989622402,25733,3810,300
989629936,989626537,989649397,22860,3811,300
989656805,989653621,989677891,24270,3812,300
989685334,989682150,989706716,24566,3813,300
989714157,989710972,989734884,23912,3814,300
989742420,989739019,989762849,23830,3815,300
989770385,989766984,989793031,26047,3816,300
989800567,989797167,989820977,23810,3817,300
989828513,989825112,989846369,21257,3818,300
989853737,989850551,989874484,23933,3819,300
989882020,989878619,989902429,23810,3820,300
989909826,989906641,989930235,23594,3821,300
989937633,989934448,989960618,26170,3822,300
989968155,989964754,989988881,24127,3823,300
989996417,989993017,990016805,23788,3824,300
990024223,990021039,990045583,24544,3825,300
990053029,990049842,990074411,24569,3826,300
990081847,990078662,990102235,23573,3827,300
990109773,990106371,990129866,23495,3828,300
990137403,990134002,990157813,23811,3829,300
990165233,990162047,990187246,25199,3830,300
990194615,990191430,990214391,22961,3831,300
990221785,990218601,990239979,21378,3832,300
990247370,990244185,990265880,21695,3833,300
990273419,990270016,990293512,23496,3834,300
990300928,990297743,990324545,26802,3835,300
990331927,990328743,990353602,24859,3836,300
990361141,990357738,990381867,24129,3837,300
990389263,990386078,990409989,23911,3838,300
990417526,990414125,990436985,22860,3839,300
990444354,990441169,990463815,22646,3840,300
990471351,990467950,990491760,23810,3841,300
990499297,990495896,990520679,24783,3842,300
990528216,990524815,990547991,23176,3843,300
990555531,990552127,990574674,22547,3844,300
990582118,990578934,990601259,22325,3845,300
990608632,990605447,990628407,22960,3846,300
990635943,990632542,990657618,25076,3847,300
990665153,990661753,990686535,24782,3848,300
990694072,990690671,990713512,22841,3849,300
990721050,990717648,990740805,23157,3850,300
990748341,990744940,990770988,26048,3851,300
990778386,990775203,990799449,24246,3852,300
990806986,990803585,990827732,24147,3853,300
990835143,990831958,990853337,21379,3854,300
990860768,990857584,990883732,26148,3855,300
990891270,990887868,990915204,27336,3856,300
990922741,990919340,990942834,23494,3857,300
990950372,990946970,990972701,25731,3858,300
990980239,990976837,991000037,23200,3859,300
991007434,991004249,991026578,22329,3860,300
991034115,991030713,991053239,22526,3861,300
991060655,991057471,991080746,23275,3862,300
991088285,991084882,991109011,24129,3863,300
991116443,991113258,991134300,21042,3864,300
991141837,991138436,991162247,23811,3865,300
991169784,991166382,991190847,24465,3866,300
991198385,991194983,991219111,24128,3867,300
991226488,991223303,991247193,23890,3868,300
991254730,991251328,991276110,24782,3869,300
991283529,991280344,991304276,23932,3870,300
991311811,991308411,991333191,24780,3871,300
991340728,991337327,991359554,22227,3872,300
991366970,991363786,991387084,23298,3873,300
991394620,991391219,991415028,23809,3874,300
991422564,991419164,991442024,22860,3875,300
991449560,991446159,991469315,23156,3876,300
991476851,991473450,991498527,25077,3877,300
991506064,991502662,991525504,22842,3878,300
991532872,991529687,991560076,30389,3879,300
991567614,991564212,991592307,28095,3880,300
991599677,991596492,991619454,22962,3881,300
991626990,991623589,991648348,24759,3882,300
991655884,991652483,991676293,23810,3883,300
991683678,991680493,991705354,24861,3884,300
991712786,991709602,991732900,23298,3885,300
991740436,991737035,991760868,23833,3886,300
991768405,991765003,991790101,25098,3887,300
991797639,991794236,991816761,22525,3888,300
991824142,991820958,991844552,23594,3889,300
991852089,991848688,991872793,24105,3890,300
991880329,991876928,991902658,25730,3891,300
991910047,991906863,991931723,24860,3892,300
991939260,991935858,991959375,23517,3893,300
991966911,991963511,991989557,26046,3894,300
991997094,991993693,992016870,23177,3895,300
992024406,992021005,992044500,23495,3896,300
992052035,992048635,992072128,23493,3897,300
992079663,992076263,992100706,24443,3898,300
992108148,992104964,992128558,23594,3899,300
992136094,992132693,992158107,25414,3900,300
992165551,992162366,992183723,21357,3901,300
992191110,992187925,992212786,24861,3902,300
992220169,992216985,992239291,22306,3903,300
992246828,992243427,992268187,24760,3904,300
992275581,992272396,992297279,24883,3905,300
992304815,992301414,992324274,22860,3906,300
992331683,992328499,992351122,22623,3907,300
992358562,992355377,992379307,23930,3908,300
992386683,992383499,992404539,21040,3909,300
992412076,992408674,992433773,25099,3910,300
992441309,992437908,992462036,24128,3911,300
992469572,992466171,992489686,23515,3912,300
992497222,992493821,992516049,22228,3913,300
992523499,992520314,992543907,23593,3914,300
992551444,992548043,992571537,23494,3915,300
992578972,992575787,992600669,24882,3916,300
992608038,992604852,992626527,21675,3917,300
992634064,992630662,992656077,25415,3918,300
992663615,992660213,992685313,25100,3919,300
992692682,992689497,992712776,23279,3920,300
992720313,992716912,992740743,23831,3921,300
992748110,992744926,992768857,23931,3922,300
992776248,992773063,992798915,25852,3923,300
992806280,992803096,992825741,22645,3924,300
992833279,992829877,992853055,23178,3925,300
992860488,992857303,992883473,26170,3926,300
992891009,992887609,992909519,21910,3927,300
992917055,992913654,992939048,25394,3928,300
992946583,992943183,992967331,24148,3929,300
992974869,992971467,992993380,21913,3930,300
993000916,992997515,993018792,21277,3931,300
993026328,993022928,993046401,23473,3932,300
993053775,993050589,993072895,22306,3933,300
993080431,993077030,993101495,24465,3934,300
993109031,993105630,993128175,22545,3935,300
993135559,993132374,993156918,24544,3936,300
993164454,993161054,993185498,24444,3937,300
993193035,993189633,993213446,23813,3938,300
993220888,993217703,993240347,22644,3939,300
993247733,993244548,993268142,23594,3940,300
993275556,993272372,993292799,20427,3941,300
993300173,993296989,993320563,23574,3942,300
993327957,993324772,993346468,21696,3943,300
993354007,993350604,993374733,24129,3944,300
993382269,993378868,993401708,22840,3945,300
993409246,993405843,993430626,24783,3946,300
993438005,993434820,993457147,22327,3947,300
993464589,993461404,993482762,21358,3948,300
993490298,993486898,993510076,23178,3949,300
993517527,993514342,993538589,24247,3950,300
993546125,993542724,993566872,24148,3951,300
993574408,993571007,993592897,21890,3952,300
993600434,993597033,993622109,25076,3953,300
993629646,993626245,993649401,23156,3954,300
993656843,993653660,993676915,23255,3955,300
993684329,993681146,993704104,22958,3956,300
993711639,993708239,993733337,25098,3957,300
993740873,993737472,993760331,22859,3958,300
993767867,993764466,993789879,25413,3959,300
993797416,993794015,993814956,20941,3960,300
993822493,993819091,993842269,23178,3961,300
993849661,993846476,993870070,23594,3962,300
993877485,993874300,993898210,23910,3963,300
993905747,993902345,993923939,21594,3964,300
993931474,993928074,993952539,24465,3965,300
993960075,993956674,993980485,23811,3966,300
993988023,993984621,994009404,24783,3967,300
994016769,994013585,994037811,24226,3968,300
994045348,994041947,994065421,23474,3969,300
994072959,994069557,994093685,24128,3970,300
994101054,994097870,994122117,24247,3971,300
994129560,994126376,994151572,25196,3972,300
994159109,994155708,994178885,23177,3973,300
994186424,994183021,994210039,27018,3974,300
994217576,994214175,994238957,24782,3975,300
994246378,994243194,994267102,23908,3976,300
994274485,994271300,994296794,25494,3977,300
994304332,994300930,994326663,25733,3978,300
994334201,994330799,994357186,26387,3979,300
994364725,994361322,994387054,25732,3980,300
994394591,994391190,994414685,23495,3981,300
994422223,994418821,994442949,24128,3982,300
994450487,994447085,994470581,23496,3983,300
994478118,994474717,994496292,21575,3984,300
994503828,994500427,994524238,23811,3985,300
994531776,994528374,994551215,22841,3986,300
994558751,994555350,994579520,24170,3987,300
994587058,994583656,994606518,22862,3988,300
994614055,994610653,994634823,24170,3989,300
994642361,994638959,994664394,25435,3990,300
994671930,994668529,994692994,24465,3991,300
994700377,994697192,994721082,23890,3992,300
994728619,994725218,994749663,24445,3993,300
994757031,994753847,994778389,24542,3994,300
994785927,994782525,994805386,22861,3995,300
994812800,994809614,994833504,23890,3996,300
994840909,994837723,994861953,24230,3997,300
994869490,994866089,994888613,22524,3998,300
994896150,994892749,994916560,23811,3999,300
994923959,994920774,994943397,22623,4000,300
994950933,994947532,994971660,24128,4001,300
994979196,994975795,994998023,22228,4002,300
995005560,995002159,995025336,23177,4003,300
995032872,995029472,995054884,25412,4004,300
995062421,995059020,995083485,24465,4005,300
995091022,995087621,995112085,24464,4006,300
995119623,995116221,995139104,22883,4007,300
995146513,995143328,995166606,23278,4008,300
995174143,995170742,995195819,25077,4009,300
995203192,995200007,995224256,24249,4010,300
995231792,995228391,995252835,24444,4011,300
995260372,995256971,995282069,25098,4012,300
995289605,995286204,995309381,23177,4013,300
995316918,995313517,995337327,23810,4014,300
995344864,995341463,995365275,23812,4015,300
995372811,995369410,995392904,23494,4016,300
995400440,995397039,995421526,24487,4017,300
995429061,995425661,995447888,22227,4018,300
995455425,995452024,995473916,21892,4019,300
995481451,995478051,995502176,24125,4020,300
995509713,995506312,995527906,21594,4021,300
995535442,995532041,995558067,26026,4022,300
995565455,995562270,995586180,23910,4023,300
995593717,995590316,995615077,24761,4024,300
995622472,995619288,995645433,26145,4025,300
995652808,995649622,995673850,24228,4026,300
995681233,995678049,995701325,23276,4027,300
995708860,995705460,995727055,21595,4028,300
995734593,995731191,995755954,24763,4029,300
995763493,995760090,995784515,24425,4030,300
995792053,995788651,995814067,25416,4031,300
995821604,995818203,995842984,24781,4032,300
995850354,995847170,995869834,22664,4033,300
995877371,995873970,995899702,25732,4034,300
995907239,995903838,995927331,23493,4035,300
995934868,995931466,995955278,23812,4036,300
995962815,995959414,995983563,24149,4037,300
995990936,995987751,996008792,21041,4038,300
996016181,996012997,996036908,23911,4039,300
996044445,996041043,996067430,26387,4040,300
996074801,996071616,996093608,21992,4041,300
996101011,996097825,996121758,23933,4042,300
996129295,996125893,996147152,21259,4043,300
996154690,996151288,996174466,23178,4044,300
996181872,996178687,996205174,26487,4045,300
996212711,996209310,996233753,24443,4046,300
996241291,996237888,996261065,23177,4047,300
996268431,996265248,996291394,26146,4048,300
996298782,996295597,996317272,21675,4049,300
996324643,996321458,996347924,26466,4050,300
996355292,996352108,996376018,23910,4051,300
996383466,996380281,996403262,22981,4052,300
996410798,996407397,996432156,24759,4053,300
996439691,996436291,996461051,24760,4054,300
996468588,996465186,996489969,24783,4055,300
996497505,996494104,996517599,23495,4056,300
996525016,996521832,996547663,25831,4057,300
996555200,996551799,996576876,25077,4058,300
996584413,996581012,996608031,27019,4059,300
996615472,996612288,996636853,24565,4060,300
996644390,996640988,996665769,24781,4061,300
996673304,996669904,996691160,21256,4062,300
996698695,996695295,996716550,21255,4063,300
996724086,996720686,996745150,24464,4064,300
996752686,996749285,996772462,23177,4065,300
996779906,996776722,996802235,25513,4066,300
996809618,996806434,996829078,22644,4067,300
996836615,996833213,996856074,22861,4068,300
996863610,996860209,996884334,24125,4069,300
996891871,996888470,996911648,23178,4070,300
996919184,996915783,996939911,24128,4071,300
996947447,996944046,996969461,25415,4072,300
996976998,996973596,996998378,24782,4073,300
997005915,997002513,997026325,23812,4074,300
997033863,997030460,997055856,25396,4075,300
997063394,997059992,997082539,22547,4076,300
997090076,997086675,997109536,22861,4077,300
997117073,997113672,997138432,24760,4078,300
997145969,997142568,997165090,22522,4079,300
997172626,997169225,997192108,22883,4080,300
997199479,997196295,997219888,23593,4081,300
997227426,997224023,997247519,23496,4082,300
997254886,997251702,997277551,25849,4083,300
997285088,997281687,997307102,25415,4084,300
997314639,997311238,997336336,25098,4085,300
997343873,997340471,997364302,23831,4086,300
997371840,997368438,997394487,26049,4087,300
997402023,997398623,997422116,23493,4088,300
997429652,997426251,997448458,22207,4089,300
997455996,997452594,997477356,24762,4090,300
997484894,997481492,997506252,24760,4091,300
997513788,997510387,997534852,24465,4092,300
997542388,997538987,997562820,23833,4093,300
997570357,997566956,997590449,23493,4094,300
997597986,997594585,997619051,24466,4095,300
997626587,997623187,997646364,23177,4096,300
997653740,997650555,997674783,24228,4097,300
997682156,997678972,997702882,23910,4098,300
997710419,997707018,997730491,23473,4099,300
997737927,997734743,997760279,25536,4100,300
997767815,997764414,997789511,25097,4101,300
997797048,997793647,997818745,25098,4102,300
997826281,997822880,997849582,26702,4103,300
997857118,997853718,997878815,25097,4104,300
997886260,997883076,997904749,21673,4105,300
997912286,997908884,997933371,24487,4106,300
997940907,997937506,997959713,22207,4107,300
997967250,997963849,997989263,25414,4108,300
997996800,997993399,998020417,27018,4109,300
998027867,998024682,998046377,21695,4110,300
998053913,998050512,998077532,27020,4111,300
998085068,998081668,998103263,21595,4112,300
998110799,998107398,998130259,22861,4113,300
998137796,998134394,998159176,24782,4114,300
998166713,998163312,998187754,24442,4115,300
998195292,998191890,998214099,22209,4116,300
998221637,998218235,998242048,23813,4117,300
998249586,998246184,998269997,23813,4118,300
998277535,998274133,998298598,24465,4119,300
998306047,998302863,998328377,25514,4120,300
998335913,998332513,998356324,23811,4121,300
998363861,998360460,998383954,23494,4122,300
998391491,998388090,998409685,21595,4123,300
998417220,998413820,998438262,24442,4124,300
998445668,998442484,998466731,24247,4125,300
998474103,998470919,998495461,24542,4126,300
998502835,998499651,998522293,22642,4127,300
998529829,998526428,998551821,25393,4128,300
998559254,998556070,998579030,22960,4129,300
998586567,998583166,998606976,23810,4130,300
998614511,998611111,998636546,25435,4131,300
998644083,998640682,998663206,22524,4132,300
998670742,998667341,998691785,24444,4133,300
998699205,998696020,998718666,22646,4134,300
998726115,998722930,998748444,25514,4135,300
998755982,998752580,998777995,25415,4136,300
998785416,998782232,998806775,24543,4137,300
998814312,998810911,998836640,25729,4138,300
998844177,998840776,998865557,24781,4139,300
998872951,998869767,998894987,25220,4140,300
998902389,998899205,998925351,26146,4141,300
998932889,998929487,998955536,26049,4142,300
998963073,998959672,998984137,24465,4143,300
998991673,998988272,999012420,24148,4144,300
999019957,999016556,999039396,22840,4145,300
999046933,999043532,999066414,22882,4146,300
999073788,999070604,999094514,23910,4147,300
999102050,999098649,999121532,22883,4148,300
999128901,999125717,999149966,24249,4149,300
999157335,999154150,999177766,23616,4150,300
999185163,999181980,999206880,24900,4151,300
999214418,999211016,999233562,22546,4152,300
999240986,999237801,999262998,25197,4153,300
999270535,999267134,999290332,23198,4154,300
999297869,999294467,999317329,22862,4155,300
999324723,999321539,999346419,24880,4156,300
999353785,999350600,999375481,24881,4157,300
999382849,999379665,999404546,24881,4158,300
999412083,999408682,999432807,24125,4159,300
999440343,999436943,999460435,23492,4160,300
999467971,999464570,999487092,22522,4161,300
999494628,999491227,999513770,22543,4162,300
999521166,999517982,999539360,21378,4163,300
999546895,999543495,999566648,23153,4164,300
999574185,999570783,999595566,24783,4165,300
999602954,999599770,999623384,23614,4166,300
999630771,999627585,999654071,26486,4167,300
999661610,999658207,999682651,24444,4168,300
999690187,999686786,999708359,21573,4169,300
999715778,999712594,999736505,23911,4170,300
999744040,999740640,999762529,21889,4171,300
999770065,999766664,999788238,21574,4172,300
999795775,999792373,999816522,24149,4173,300
999823936,999820752,999844999,24247,4174,300
999852383,999849199,999871822,22623,4175,300
999879231,999876046,999900296,24250,4176,300
999907833,999904431,999927630,23199,4177,300
999935167,999931765,999957814,26049,4178,300
999965352,999961950,999984811,22861,4179,300
999992347,999988946,1000013390,24444,4180,300
1000021014,1000017830,1000041763,23933,4181,300
1000049428,1000046243,1000069524,23281,4182,300
1000077220,1000074036,1000099235,25199,4183,300
1000106932,1000103747,1000125760,22013,4184,300
1000133561,1000130159,1000156526,26367,4185,300
1000164153,1000160970,1000185218,24248,4186,300
1000192870,1000189685,1000212986,23301,4187,300
1000220785,1000217385,1000238663,21278,4188,300
1000246464,1000243063,1000270083,27020,4189,300
1000277759,1000274574,1000298170,23596,4190,300
1000305810,1000302627,1000326560,23933,4191,300
1000334362,1000330960,1000353191,22231,4192,300
1000360991,1000357590,1000382690,25100,4193,300
1000390491,1000387090,1000409002,21912,4194,300
1000416667,1000413483,1000437080,23597,4195,300
1000444759,1000441575,1000465171,23596,4196,300
1000472866,1000469681,1000491695,22014,4197,300
1000499495,1000496094,1000519591,23497,4198,300
1000527305,1000524120,1000545797,21677,4199,300
1000553597,1000550196,1000575296,25100,4200,300
1000583097,1000579696,1000602875,23179,4201,300
1000610544,1000607360,1000629374,22014,4202,300
1000637005,1000633820,1000658724,24904,4203,300
1000666432,1000663247,1000687814,24567,4204,300
1000695524,1000692340,1000715937,23597,4205,300
1000723612,1000720428,1000741490,21062,4206,300
1000749290,1000745890,1000768752,22862,4207,300
1000776553,1000773152,1000797935,24783,4208,300
1000805736,1000802335,1000823910,21575,4209,300
1000831712,1000828310,1000852757,24447,4210,300
1000860557,1000857157,1000881602,24445,4211,300
1000889311,1000886127,1000912931,26804,4212,300
1000920731,1000917331,1000940510,23179,4213,300
1000948223,1000945039,1000970554,25515,4214,300
1000978245,1000975062,1000996758,21696,4215,300
1001004470,1001001286,1001027119,25833,4216,300
1001034919,1001031519,1001055311,23792,4217,300
1001063112,1001059711,1001084157,24446,4218,300
1001091959,1001088557,1001110785,22228,4219,300
1001118586,1001115185,1001139946,24761,4220,300
1001147615,1001144429,1001167732,23303,4221,300
1001175533,1001172132,1001196895,24763,4222,300
1001204697,1001201295,1001226375,25080,4223,300
1001234176,1001230775,1001253932,23157,4224,300
1001261605,1001258421,1001282016,23595,4225,300
1001289731,1001286546,1001310775,24229,4226,300
1001318485,1001315301,1001339868,24567,4227,300
1001347669,1001344268,1001367428,23160,4228,300
1001375230,1001371828,1001395326,23498,4229,300
1001403126,1001399726,1001421640,21914,4230,300
1001429282,1001426098,1001449081,22983,4231,300
1001456883,1001453481,1001479554,26073,4232,300
1001487356,1001483954,1001507135,23181,4233,300
1001514764,1001511580,1001535513,23933,4234,300
1001543314,1001539913,1001565646,25733,4235,300
1001573447,1001570046,1001593541,23495,4236,300
1001601342,1001597941,1001622071,24130,4237,300
1001629701,1001626516,1001649501,22985,4238,300
1001657137,1001653953,1001675967,22014,4239,300
1001683655,1001680471,1001703434,22963,4240,300
1001711235,1001707833,1001732597,24764,4241,300
1001740399,1001736997,1001759205,22208,4242,300
1001767005,1001763605,1001789655,26050,4243,300
1001797348,1001794163,1001816516,22353,4244,300
1001824317,1001820916,1001844749,23833,4245,300
1001852421,1001849237,1001871567,22330,4246,300
1001879367,1001875967,1001900730,24763,4247,300
1001908531,1001905130,1001930546,25416,4248,300
1001938241,1001935056,1001956753,21697,4249,300
1001964554,1001961152,1001983996,22844,4250,300
1001991712,1001988527,1002011828,23301,4251,300
1002019630,1002016228,1002040061,23833,4252,300
1002047862,1002044461,1002070195,25734,4253,300
1002077996,1002074595,1002098430,23835,4254,300
1002106133,1002102949,1002126228,23279,4255,300
1002134029,1002130628,1002155075,24447,4256,300
1002162712,1002159528,1002183756,24228,4257,300
1002191558,1002188156,1002213574,25418,4258,300
1002221375,1002217974,1002242420,24446,4259,300
1002250134,1002246949,1002271180,24231,4260,300
1002278854,1002275670,1002299266,23596,4261,300
1002306982,1002303796,1002327394,23598,4262,300
1002335055,1002331870,1002355467,23597,4263,300
1002363168,1002359983,1002383917,23934,4264,300
1002391718,1002388317,1002412762,24445,4265,300
1002420473,1002417289,1002441519,24230,4266,300
1002449158,1002445972,1002470856,24884,4267,300
1002478493,1002475309,1002499244,23935,4268,300
1002507046,1002503644,1002529062,25418,4269,300
1002536862,1002533462,1002557590,24128,4270,300
1002565391,1002561990,1002586141,24151,4271,300
1002593823,1002590639,1002612652,22013,4272,300
1002620359,1002617174,1002640475,23301,4273,300
1002648276,1002644875,1002667739,22864,4274,300
1002675540,1002672139,1002698189,26050,4275,300
1002705991,1002702590,1002727036,24446,4276,300
1002734838,1002731436,1002753963,22527,4277,300
1002761658,1002758473,1002782386,23913,4278,300
1002790188,1002786786,1002809967,23181,4279,300
1002817639,1002814453,1002838051,23598,4280,300
1002845853,1002842451,1002865315,22864,4281,300
1002873115,1002869715,1002894475,24760,4282,300
1002902276,1002898875,1002923343,24468,4283,300
1002930980,1002927795,1002950738,22943,4284,300
1002958443,1002955259,1002979171,23912,4285,300
1002986858,1002983672,1003009823,26151,4286,300
1003017625,1003014223,1003038332,24109,4287,300
1003046045,1003042861,1003068059,25198,4288,300
1003075859,1003072458,1003094668,22210,4289,300
1003102368,1003099185,1003122780,23595,4290,300
1003130488,1003127304,1003150584,23280,4291,300
1003158386,1003154984,1003180083,25099,4292,300
1003187739,1003184555,1003209122,24567,4293,300
1003216923,1003213522,1003238938,25416,4294,300
1003246649,1003243465,1003267693,24228,4295,300
1003275494,1003272092,1003297805,25713,4296,300
1003305460,1003302275,1003327159,24884,4297,300
1003334873,1003331689,1003357206,25517,4298,300
1003365008,1003361606,1003385758,24152,4299,300
1003393559,1003390158,1003415575,25417,4300,300
1003423377,1003419975,1003444104,24129,4301,300
1003451744,1003448559,1003471522,22963,4302,300
1003479324,1003475922,1003498129,22207,4303,300
1003505789,1003502603,1003525252,22649,4304,300
1003533052,1003529652,1003552830,23178,4305,300
1003560531,1003557347,1003579972,22625,4306,300
1003587615,1003584432,1003607096,22664,4307,300
1003614801,1003611617,1003634578,22961,4308,300
1003642377,1003638977,1003660889,21912,4309,300
1003668690,1003665288,1003689418,24130,4310,300
1003697218,1003693817,1003718917,25100,4311,300
1003726568,1003723384,1003745712,22328,4312,300
1003753358,1003750174,1003774719,24545,4313,300
1003782374,1003779189,1003803101,23912,4314,300
1003810805,1003807621,1003830247,22626,4315,300
1003837894,1003834709,1003857673,22964,4316,300
1003865474,1003862073,1003886836,24763,4317,300
1003894638,1003891236,1003917285,26049,4318,300
1003925087,1003921685,1003946153,24468,4319,300
1003953955,1003950553,1003972764,22211,4320,300
1003980394,1003977210,1003998590,21380,4321,300
1004006219,1004003035,1004028234,25199,4322,300
1004036035,1004032634,1004058684,26050,4323,300
1004066487,1004063084,1004086264,23180,4324,300
1004094065,1004090663,1004114815,24152,4325,300
1004122617,1004119215,1004142395,23180,4326,300
1004150087,1004146904,1004171133,24229,4327,300
1004178841,1004175656,1004201511,25855,4328,300
1004209222,1004206037,1004230267,24230,4329,300
1004237895,1004234712,1004258982,24270,4330,300
1004266782,1004263381,1004287828,24447,4331,300
1004295483,1004292298,1004317498,25200,4332,300
1004325143,1004321958,1004344605,22647,4333,300
1004352406,1004349004,1004374423,25419,4334,300
1004382226,1004378823,1004402301,23478,4335,300
1004409982,1004406798,1004430394,23596,4336,300
1004438100,1004434917,1004459800,24883,4337,300
1004467469,1004464284,1004487269,22985,4338,300
1004495071,1004491669,1004512950,21281,4339,300
1004520752,1004517350,1004541797,24447,4340,300
1004549449,1004546265,1004568573,22308,4341,300
1004576373,1004572973,1004598072,25099,4342,300
1004605782,1004602598,1004627461,24863,4343,300
1004635262,1004631860,1004656962,25102,4344,300
1004664594,1004661409,1004684689,23280,4345,300
1004692378,1004689194,1004712812,23618,4346,300
1004720613,1004717211,1004739123,21912,4347,300
1004746833,1004743650,1004767877,24227,4348,300
1004775590,1004772405,1004796003,23598,4349,300
1004803806,1004800403,1004821664,21261,4350,300
1004829466,1004826063,1004851481,25418,4351,300
1004859176,1004855991,1004880538,24547,4352,300
1004888239,1004885053,1004910887,25834,4353,300
1004918579,1004915395,1004939625,24230,4354,300
1004947425,1004944025,1004968175,24150,4355,300
1004975810,1004972624,1004996559,23935,4356,300
1005004360,1005000959,1005025741,24782,4357,300
1005033540,1005030140,1005054289,24149,4358,300
1005061940,1005058755,1005082689,23934,4359,300
1005090375,1005087191,1005113340,26149,4360,300
1005121141,1005117740,1005141236,23496,4361,300
1005149037,1005145636,1005171053,25417,4362,300
1005178854,1005175453,1005199266,23813,4363,300
1005207067,1005203665,1005225874,22209,4364,300
1005233675,1005230274,1005254720,24446,4365,300
1005262398,1005259213,1005281860,22647,4366,300
1005289662,1005286260,1005308490,22230,4367,300
1005316292,1005312890,1005338308,25418,4368,300
1005346013,1005342828,1005366402,23574,4369,300
1005374051,1005370867,1005395097,24230,4370,300
1005402760,1005399575,1005423171,23596,4371,300
1005430885,1005427701,1005450981,23280,4372,300
1005458656,1005455472,1005480375,24903,4373,300
1005488175,1005484775,1005511479,26704,4374,300
1005519143,1005515958,1005537635,21677,4375,300
1005545437,1005542035,1005566164,24129,4376,300
1005573866,1005570682,1005593961,23279,4377,300
1005601761,1005598360,1005620589,22229,4378,300
1005628302,1005625118,1005647743,22625,4379,300
1005655409,1005652225,1005674871,22646,4380,300
1005682513,1005679329,1005703875,24546,4381,300
1005711676,1005708275,1005731792,23517,4382,300
1005739459,1005736275,1005759871,23596,4383,300
1005767546,1005764362,1005787979,23617,4384,300
1005795781,1005792379,1005816509,24130,4385,300
1005824183,1005820998,1005845226,24228,4386,300
1005853028,1005849626,1005874094,24468,4387,300
1005881805,1005878620,1005902196,23576,4388,300
1005909998,1005906596,1005932014,25418,4389,300
1005939717,1005936533,1005958206,21673,4390,300
1005966007,1005962606,1005987706,25100,4391,300
1005995506,1005992106,1006014968,22862,4392,300
1006022621,1006019437,1006042715,23278,4393,300
1006050516,1006047115,1006069978,22863,4394,300
1006077652,1006074468,1006097137,22669,4395,300
1006104828,1006101643,1006126844,25201,4396,300
1006134645,1006131244,1006154128,22884,4397,300
1006161787,1006158602,1006184436,25834,4398,300
1006192136,1006188952,1006213813,24861,4399,300
1006221615,1006218213,1006242344,24131,4400,300
1006250145,1006246744,1006272161,25417,4401,300
1006279853,1006276669,1006300898,24229,4402,300
1006308700,1006305298,1006330082,24784,4403,300
1006337883,1006334482,1006359583,25101,4404,300
1006367384,1006363983,1006387796,23813,4405,300
1006395597,1006392196,1006415693,23497,4406,300
1006423390,1006420206,1006445068,24862,4407,300
1006452868,1006449468,1006470747,21279,4408,300
1006478548,1006475147,1006500226,25079,4409,300
1006508027,1006504626,1006529073,24447,4410,300
1006536773,1006533588,1006557521,23933,4411,300
1006565322,1006561921,1006587676,25755,4412,300
1006595331,1006592147,1006614773,22626,4413,300
1006622404,1006619219,1006644737,25518,4414,300
1006652385,1006649202,1006673093,23891,4415,300
1006680894,1006677492,1006704176,26684,4416,300
1006711978,1006708576,1006731462,22886,4417,300
1006739262,1006735861,1006760306,24445,4418,300
1006768106,1006764706,1006786301,21595,4419,300
1006794006,1006790820,1006813467,22647,4420,300
1006821173,1006817988,1006841902,23914,4421,300
1006849705,1006846302,1006870116,23814,4422,300
1006877829,1006874645,1006897311,22666,4423,300
1006904977,1006901793,1006926972,25179,4424,300
1006934678,1006931494,1006955427,23933,4425,300
1006963094,1006959910,1006983505,23595,4426,300
1006991161,1006987976,1007011890,23914,4427,300
1007019691,1007016290,1007042318,26028,4428,300
1007050120,1007046718,1007069561,22843,4429,300
1007077254,1007074070,1007097032,22962,4430,300
1007104711,1007101527,1007126727,25200,4431,300
1007134528,1007131127,1007155235,24108,4432,300
1007162936,1007159751,1007183684,23933,4433,300
1007191391,1007188206,1007213408,25202,4434,300
1007221121,1007217936,1007239317,21381,4435,300
1007246974,1007243790,1007267070,23280,4436,300
1007274754,1007271569,1007294195,22626,4437,300
1007301848,1007298665,1007322261,23596,4438,300
1007329895,1007326710,1007350624,23914,4439,300
1007358424,1007355024,1007379807,24783,4440,300
1007387608,1007384207,1007407704,23497,4441,300
1007415505,1007412104,1007436867,24763,4442,300
1007444669,1007441267,1007467951,26684,4443,300
1007475666,1007472482,1007495128,22646,4444,300
1007502758,1007499574,1007524773,25199,4445,300
1007532477,1007529294,1007552236,22942,4446,300
1007560037,1007556636,1007581082,24446,4447,300
1007588769,1007585584,1007610132,24548,4448,300
1007617783,1007614599,1007636274,21675,4449,300
1007644076,1007640674,1007664802,24128,4450,300
1007672604,1007669202,1007693017,23815,4451,300
1007700648,1007697463,1007721713,24250,4452,300
1007729513,1007726112,1007752477,26365,4453,300
1007760108,1007756924,1007779907,22983,4454,300
1007787705,1007784306,1007807147,22841,4455,300
1007814804,1007811618,1007835870,24252,4456,300
1007843517,1007840333,1007864898,24565,4457,300
1007872541,1007869355,1007893923,24568,4458,300
1007901623,1007898438,1007923026,24588,4459,300
1007930727,1007927543,1007951814,24271,4460,300
1007959614,1007956213,1007980343,24130,4461,300
1007988143,1007984743,1008007900,23157,4462,300
1008015700,1008012299,1008035457,23158,4463,300
1008043258,1008039857,1008064302,24445,4464,300
1008072103,1008068701,1008091881,23180,4465,300
1008099681,1008096280,1008117855,21575,4466,300
1008125656,1008122254,1008147355,25101,4467,300
1008154987,1008151803,1008177296,25493,4468,300
1008184968,1008181783,1008205358,23575,4469,300
1008213071,1008209886,1008233821,23935,4470,300
1008241484,1008238300,1008262212,23912,4471,300
1008269911,1008266727,1008290955,24228,4472,300
1008298756,1008295355,1008319821,24466,4473,300
1008327623,1008324221,1008347719,23498,4474,300
1008355521,1008352119,1008376566,24447,4475,300
1008384238,1008381054,1008405915,24861,4476,300
1008413717,1008410315,1008433179,22864,4477,300
1008440981,1008437579,1008463650,26071,4478,300
1008471283,1008468098,1008491694,23596,4479,300
1008499496,1008496094,1008520540,24446,4480,300
1008528340,1008524940,1008548751,23811,4481,300
1008556552,1008553151,1008579222,26071,4482,300
1008587023,1008583622,1008607098,23476,4483,300
1008614733,1008611548,1008633878,22330,4484,300
1008641583,1008638399,1008662332,23933,4485,300
1008670033,1008666848,1008690444,23596,4486,300
1008698157,1008694973,1008717936,22963,4487,300
1008725581,1008722395,1008745042,22647,4488,300
1008752842,1008749441,1008775512,26071,4489,300
1008783226,1008780041,1008803301,23260,4490,300
1008811002,1008807816,1008831098,23282,4491,300
1008838810,1008835625,1008862112,26487,4492,300
1008869795,1008866611,1008889573,22962,4493,300
1008897374,1008893972,1008920021,26049,4494,300
1008927823,1008924421,1008947918,23497,4495,300
1008955718,1008952317,1008979020,26703,4496,300
1008986820,1008983420,1009006895,23475,4497,300
1009014696,1009011295,1009034180,22885,4498,300
1009041834,1009038650,1009063849,25199,4499,300
1009071560,1009068375,1009091677,23302,4500,300
1009099371,1009096187,1009119486,23299,4501,300
1009127147,1009123963,1009147559,23596,4502,300
1009155233,1009152049,1009175646,23597,4503,300
1009183445,1009180045,1009204827,24782,4504,300
1009212536,1009209352,1009233244,23892,4505,300
1009240920,1009237735,1009260700,22965,4506,300
1009268399,1009265214,1009291047,25833,4507,300
1009298749,1009295565,1009318844,23279,4508,300
1009326474,1009323289,1009348806,25517,4509,300
1009356500,1009353316,1009376596,23280,4510,300
1009384307,1009381123,1009406320,25197,4511,300
1009413975,1009410791,1009434385,23594,4512,300
1009442017,1009438833,1009462744,23911,4513,300
1009470544,1009467143,1009490957,23814,4514,300
1009498759,1009495357,1009519508,24151,4515,300
1009527309,1009523908,1009550275,26367,4516,300
1009558075,1009554675,1009578782,24107,4517,300
1009586583,1009583182,1009609569,26387,4518,300
1009617209,1009614024,1009638570,24546,4519,300
1009646370,1009642969,1009667435,24466,4520,300
1009675235,1009671834,1009693746,21912,4521,300
1009701387,1009698203,1009722433,24230,4522,300
1009730094,1009726910,1009748605,21695,4523,300
1009756406,1009753004,1009776479,23475,4524,300
1009784279,1009780878,1009804691,23813,4525,300
1009812374,1009809190,1009831834,22644,4526,300
1009839634,1009836233,1009861311,25078,4527,300
1009869002,1009865817,1009890048,24231,4528,300
1009897847,1009894447,1009920515,26068,4529,300
1009928201,1009925017,1009948950,23933,4530,300
1009956750,1009953349,1009974944,21595,4531,300
1009982588,1009979403,1010003001,23598,4532,300
1010010648,1010007464,1010032326,24862,4533,300
1010040039,1010036854,1010063026,26172,4534,300
1010070828,1010067427,1010091894,24467,4535,300
1010099551,1010096366,1010121271,24905,4536,300
1010129072,1010125670,1010152692,27022,4537,300
1010160403,1010157218,1010182081,24863,4538,300
1010189881,1010186480,1010210927,24447,4539,300
1010218595,1010215412,1010238353,22941,4540,300
1010246154,1010242753,1010267516,24763,4541,300
1010275316,1010271915,1010296361,24446,4542,300
1010304005,1010300820,1010326675,25855,4543,300
1010334372,1010331188,1010354468,23280,4544,300
1010362102,1010358918,1010381880,22962,4545,300
1010389525,1010386342,1010410275,23933,4546,300
1010418076,1010414674,1010439796,25122,4547,300
1010447597,1010444196,1010468009,23813,4548,300
1010475809,1010472408,1010497171,24763,4549,300
1010504805,1010501620,1010525533,23913,4550,300
1010533334,1010529933,1010550581,20648,4551,300
1010558382,1010554981,1010578181,23200,4552,300
1010585815,1010582631,1010607809,25178,4553,300
1010615514,1010612329,1010636558,24229,4554,300
1010644361,1010640958,1010666060,25102,4555,300
1010673772,1010670586,1010694817,24231,4556,300
1010702509,1010699325,1010720368,21043,4557,300
1010728061,1010724875,1010748175,23300,4558,300
1010755838,1010752654,1010777221,24567,4559,300
1010784866,1010781682,1010804645,22963,4560,300
1010812447,1010809045,1010834779,25734,4561,300
1010842420,1010839235,1010861227,21992,4562,300
1010869029,1010865627,1010888809,23182,4563,300
1010896473,1010893288,1010919459,26171,4564,300
1010927261,1010923859,1010949276,25417,4565,300
1010956907,1010953724,1010977297,23573,4566,300
1010985099,1010981697,1011005849,24152,4567,300
1011013649,1011010249,1011032794,22545,4568,300
1011040481,1011037297,1011061208,23911,4569,300
1011068872,1011065688,1011089285,23597,4570,300
1011097086,1011093685,1011115915,22230,4571,300
1011123716,1011120315,1011146387,26072,4572,300
1011154188,1011150787,1011174601,23814,4573,300
1011182402,1011179001,1011203785,24784,4574,300
1011211586,1011208185,1011231998,23813,4575,300
1011239799,1011236397,1011259577,23180,4576,300
1011267376,1011263976,1011287153,23177,4577,300
1011294955,1011291553,1011314078,22525,4578,300
1011321783,1011318599,1011343482,24883,4579,300
1011351282,1011347881,1011371377,23496,4580,300
1011379178,1011375776,1011399591,23815,4581,300
1011407245,1011404061,1011427635,23574,4582,300
1011435330,1011432145,1011453527,21382,4583,300
1011461161,1011457977,1011485098,27121,4584,300
1011492899,1011489498,1011513311,23813,4585,300
1011521111,1011517711,1011543127,25416,4586,300
1011550929,1011547527,1011569105,21578,4587,300
1011576760,1011573575,1011597192,23617,4588,300
1011604994,1011601592,1011626036,24444,4589,300
1011633837,1011630436,1011655853,25417,4590,300
1011663557,1011660372,1011683337,22965,4591,300
1011691138,1011687737,1011713491,25754,4592,300
1011721293,1011717891,1011742358,24467,4593,300
1011750063,1011746878,1011769205,22327,4594,300
1011776920,1011773735,1011796383,22648,4595,300
1011804052,1011800867,1011824779,23912,4596,300
1011832477,1011829294,1011851919,22625,4597,300
1011859614,1011856429,1011879393,22964,4598,300
1011887040,1011883855,1011906185,22330,4599,300
1011913897,1011910713,1011934310,23597,4600,300
1011942024,1011938839,1011962435,23596,4601,300
1011970139,1011966954,1011989918,22964,4602,300
1011997718,1011994317,1012020705,26388,4603,300
1012028505,1012025105,1012048938,23833,4604,300
1012056637,1012053452,1012077049,23597,4605,300
1012084851,1012081449,1012105262,23813,4606,300
1012113064,1012109662,1012134109,24447,4607,300
1012141910,1012138509,1012162344,23835,4608,300
1012169995,1012166811,1012192011,25200,4609,300
1012199645,1012196460,1012220711,24251,4610,300
1012228425,1012225241,1012249154,23913,4611,300
1012256956,1012253554,1012279603,26049,4612,300
1012287316,1012284132,1012310302,26170,4613,300
1012317930,1012314746,1012338026,23280,4614,300
1012345734,1012342550,1012366145,23595,4615,300
1012373815,1012370630,1012394563,23933,4616,300
1012402364,1012398963,1012420855,21892,4617,300
1012428658,1012425255,1012450020,24765,4618,300
1012457707,1012454522,1012477484,22962,4619,300
1012485286,1012481884,1012506670,24786,4620,300
1012514363,1012511179,1012536038,24859,4621,300
1012543840,1012540438,1012564885,24447,4622,300
1012572686,1012569285,1012593098,23813,4623,300
1012600804,1012597620,1012620900,23280,4624,300
1012628534,1012625349,1012650528,25179,4625,300
1012658234,1012655048,1012677716,22668,4626,300
1012685395,1012682211,1012706778,24567,4627,300
1012714471,1012711286,1012733297,22011,4628,300
1012740951,1012737767,1012762018,24251,4629,300
1012769653,1012766468,1012789431,22963,4630,300
1012797235,1012793831,1012818596,24765,4631,300
1012826397,1012822996,1012844908,21912,4632,300
1012852548,1012849363,1012874881,25518,4633,300
1012882557,1012879373,1012901365,21992,4634,300
1012909028,1012905843,1012927519,21676,4635,300
1012935321,1012931919,1012956704,24785,4636,300
1012964505,1012961104,1012985889,24785,4637,300
1012993569,1012990384,1013014950,24566,4638,300
1013022605,1013019420,1013043017,23597,4639,300
1013050692,1013047508,1013070152,22644,4640,300
1013077835,1013074650,1013099197,24547,4641,300
1013106860,1013103676,1013126322,22646,4642,300
1013133977,1013130792,1013151857,21065,4643,300
1013159659,1013156257,1013182961,26704,4644,300
1013190761,1013187361,1013210562,23201,4645,300
1013218363,1013214962,1013236538,21576,4646,300
1013244340,1013240938,1013265701,24763,4647,300
1013273502,1013270101,1013294250,24149,4648,300
1013302051,1013298650,1013322759,24109,4649,300
1013330560,1013327159,1013350993,23834,4650,300
1013358678,1013355492,1013379406,23914,4651,300
1013387103,1013383919,1013409119,25200,4652,300
1013416921,1013413519,1013437670,24151,4653,300
1013445318,1013442133,1013466383,24250,4654,300
1013474185,1013470783,1013494618,23835,4655,300
1013502297,1013499113,1013523680,24567,4656,300
1013531369,1013528185,1013551442,23257,4657,300
1013559244,1013555842,1013580626,24784,4658,300
1013588426,1013585026,1013609808,24782,4659,300
1013617446,1013614262,1013639463,25201,4660,300
1013647130,1013643945,1013668513,24568,4661,300
1013676152,1013672968,1013695930,22962,4662,300
1013703572,1013700386,1013723351,22965,4663,300
1013731026,1013727843,1013749539,21696,4664,300
1013757221,1013754035,1013778604,24569,4665,300
1013786311,1013783125,1013807694,24569,4666,300
1013815494,1013812093,1013836580,24487,4667,300
1013844383,1013840980,1013863211,22231,4668,300
1013870914,1013867731,1013889089,21358,4669,300
1013896891,1013893488,1013918253,24765,4670,300
1013926054,1013922653,1013946802,24149,4671,300
1013954484,1013951299,1013978421,27122,4672,300
1013986115,1013982931,1014006845,23914,4673,300
1014014519,1014011334,1014036198,24864,4674,300
1014043999,1014040598,1014066648,26050,4675,300
1014074448,1014071048,1014095176,24128,4676,300
1014102978,1014099576,1014122757,23181,4677,300
1014130463,1014127279,1014149629,22350,4678,300
1014157430,1014154029,1014180079,26050,4679,300
1014187709,1014184525,1014208121,23596,4680,300
1014215769,1014212584,1014236180,23596,4681,300
1014243981,1014240580,1014263422,22842,4682,300
1014271224,1014267822,1014292290,24468,4683,300
1014300092,1014296690,1014320187,23497,4684,300
1014327889,1014324704,1014348300,23596,4685,300
1014356101,1014352700,1014376514,23814,4686,300
1014384315,1014380914,1014404726,23812,4687,300
1014412527,1014409126,1014432940,23814,4688,300
1014440654,1014437470,1014461086,23616,4689,300
1014468887,1014465486,1014491219,25733,4690,300
1014498895,1014495711,1014518650,22939,4691,300
1014526451,1014523050,1014546568,23518,4692,300
1014554369,1014550968,1014575097,24129,4693,300
1014582897,1014579497,1014604596,25099,4694,300
1014612259,1014609075,1014632352,23277,4695,300
1014640005,1014636819,1014661388,24569,4696,300
1014669090,1014665905,1014687582,21677,4697,300
1014695246,1014692060,1014716292,24232,4698,300
1014723925,1014720740,1014746278,25538,4699,300
1014753947,1014750763,1014774379,23616,4700,300
1014782181,1014778779,1014800673,21894,4701,300
1014808308,1014805123,1014827791,22668,4702,300
1014835484,1014832300,1014855240,22940,4703,300
1014863042,1014859640,1014883454,23814,4704,300
1014891168,1014887984,1014910609,22625,4705,300
1014918259,1014915075,1014938692,23617,4706,300
1014946355,1014943172,1014965162,21990,4707,300
1014972963,1014969562,1014993375,23813,4708,300
1015001175,1014997774,1015022220,24446,4709,300
1015030021,1015026620,1015048533,21913,4710,300
1015056336,1015052933,1015078986,26053,4711,300
1015086640,1015083457,1015107050,23593,4712,300
1015114851,1015111450,1015138155,26705,4713,300
1015145868,1015142684,1015168518,25834,4714,300
1015176319,1015172918,1015199306,26388,4715,300
1015207107,1015203706,1015229440,25734,4716,300
1015237100,1015233915,1015258165,24250,4717,300
1015265794,1015262609,1015289413,26804,4718,300
1015297215,1015293814,1015317015,23201,4719,300
1015324817,1015321415,1015346200,24785,4720,300
1015354002,1015350600,1015373126,22526,4721,300
1015380805,1015377621,1015401533,23912,4722,300
1015409335,1015405933,1015429431,23498,4723,300
1015437232,1015433831,1015457644,23813,4724,300
1015465355,1015462171,1015486105,23934,4725,300
1015493905,1015490505,1015514655,24150,4726,300
1015522306,1015519122,1015541432,22310,4727,300
1015549085,1015545900,1015569179,23279,4728,300
1015576887,1015573703,1015597002,23299,4729,300
1015604674,1015601489,1015626035,24546,4730,300
1015633674,1015630489,1015655035,24546,4731,300
1015662837,1015659435,1015683270,23835,4732,300
1015690915,1015687731,1015713248,25517,4733,300
1015721049,1015717648,1015739222,21574,4734,300
1015747023,1015743622,1015767138,23516,4735,300
1015774939,1015771538,1015796321,24783,4736,300
1015804036,1015800852,1015825420,24568,4737,300
1015833221,1015829820,1015853652,23832,4738,300
1015861367,1015858182,1015883045,24863,4739,300
1015890847,1015887445,1015910943,23498,4740,300
1015918603,1015915419,1015939014,23595,4741,300
1015946723,1015943539,1015965551,22012,4742,300
1015973256,1015970071,1015993373,23302,4743,300
1016001068,1015997885,1016019580,21695,4744,300
1016027379,1016023979,1016049395,25416,4745,300
1016057058,1016053873,1016076521,22648,4746,300
1016084212,1016081027,1016105593,24566,4747,300
1016113394,1016109993,1016133827,23834,4748,300
1016141628,1016138227,1016163328,25101,4749,300
1016170985,1016167801,1016192979,25178,4750,300
1016200622,1016197438,1016221686,24248,4751,300
1016229315,1016226131,1016249727,23596,4752,300
1016257361,1016254177,1016279060,24883,4753,300
1016286861,1016283460,1016307294,23834,4754,300
1016315095,1016311694,1016334557,22863,4755,300
1016342357,1016338957,1016363107,24150,4756,300
1016370743,1016367559,1016390184,22625,4757,300
1016397984,1016394583,1016418079,23496,4758,300
1016425881,1016422479,1016445047,22568,4759,300
1016452739,1016449554,1016471253,21699,4760,300
1016479053,1016475652,1016499780,24128,4761,300
1016507409,1016504225,1016528453,24228,4762,300
1016536254,1016532853,1016554766,21913,4763,300
1016562567,1016559166,1016583316,24150,4764,300
1016591116,1016587716,1016612499,24783,4765,300
1016620300,1016616899,1016641999,25100,4766,300
1016649800,1016646399,1016670211,23812,4767,300
1016677905,1016674720,1016698677,23957,4768,300
1016706478,1016703077,1016728177,25100,4769,300
1016735808,1016732624,1016757507,24883,4770,300
1016765308,1016761907,1016785699,23792,4771,300
1016793376,1016790191,1016812501,22310,4772,300
1016820302,1016816901,1016842634,25733,4773,300
1016850436,1016847034,1016870869,23835,4774,300
1016878670,1016875269,1016898765,23496,4775,300
1016906567,1016903165,1016927634,24469,4776,300
1016935435,1016932034,1016955531,23497,4777,300
1016963332,1016959931,1016982160,22229,4778,300
1016989815,1016986630,1017011218,24588,4779,300
1017019019,1017015618,1017042302,26684,4780,300
1017050103,1017046702,1017070535,23833,4781,300
1017078173,1017074989,1017098585,23596,4782,300
1017106385,1017102985,1017127135,24150,4783,300
1017134838,1017131653,1017154933,23280,4784,300
1017162633,1017159449,1017184353,24904,4785,300
1017192061,1017188876,1017212790,23914,4786,300
1017220592,1017217190,1017241953,24763,4787,300
1017249645,1017246461,1017271344,24883,4788,300
1017279146,1017275744,1017300845,25101,4789,300
1017308477,1017305292,1017329838,24546,4790,300
1017337483,1017334299,1017358569,24270,4791,300
1017366954,1017363078,1017386079,23001,4792,300
1017393718,1017390534,1017413812,23278,4793,300
1017421487,1017418302,1017440633,22331,4794,300
1017448331,1017445148,1017468742,23594,4795,300
1017476542,1017473142,1017496954,23812,4796,300
1017504590,1017501405,1017525973,24568,4797,300
1017533645,1017530461,1017557265,26804,4798,300
1017565067,1017561665,1017582947,21282,4799,300
1017590656,1017587473,1017612018,24545,4800,300
1017619818,1017616418,1017639301,22883,4801,300
1017646934,1017643751,1017666690,22939,4802,300
1017674490,1017671090,1017695217,24127,4803,300
1017703018,1017699617,1017724064,24447,4804,300
1017731768,1017728584,1017751208,22624,4805,300
1017758916,1017755732,1017780298,24566,4806,300
1017787935,1017784750,1017808685,23935,4807,300
1017816485,1017813084,1017836262,23178,4808,300
1017844064,1017840662,1017866080,25418,4809,300
1017873735,1017870551,1017893493,22942,4810,300
1017901294,1017897893,1017922359,24466,4811,300
1017930003,1017926819,1017950098,23279,4812,300
1017957898,1017954497,1017977023,22526,4813,300
1017984823,1017981422,1018004918,23496,4814,300
1018012718,1018009318,1018033804,24486,4815,300
1018041474,1018038289,1018063489,25200,4816,300
1018071290,1018067889,1018089147,21258,4817,300
1018096837,1018093651,1018117228,23577,4818,300
1018125028,1018121627,1018145462,23835,4819,300
1018153096,1018149912,1018173190,23278,4820,300
1018180991,1018177590,1018201404,23814,4821,300
1018209043,1018205858,1018228189,22331,4822,300
1018235898,1018232714,1018257913,25199,4823,300
1018265564,1018262380,1018286292,23912,4824,300
1018294093,1018290692,1018313891,23199,4825,300
1018321693,1018318291,1018340840,22549,4826,300
1018348468,1018345284,1018370801,25517,4827,300
1018378499,1018375316,1018399227,23911,4828,300
1018407029,1018403627,1018427421,23794,4829,300
1018435221,1018431821,1018455948,24127,4830,300
1018463750,1018460348,1018484459,24111,4831,300
1018492260,1018488858,1018512673,23815,4832,300
1018520302,1018517119,1018539743,22624,4833,300
1018547544,1018544143,1018568589,24446,4834,300
1018576291,1018573106,1018594783,21677,4835,300
1018602451,1018599266,1018623810,24544,4836,300
1018631610,1018628210,1018653289,25079,4837,300
1018660944,1018657760,1018681354,23594,4838,300
1018688989,1018685805,1018709718,23913,4839,300
1018717519,1018714118,1018736980,22862,4840,300
1018744622,1018741438,1018765056,23618,4841,300
1018772858,1018769456,1018794241,24785,4842,300
1018801894,1018798710,1018822644,23934,4843,300
1018830297,1018827113,1018848154,21041,4844,300
1018855792,1018852608,1018876521,23913,4845,300
1018884154,1018880970,1018905220,24250,4846,300
1018913020,1018909619,1018931848,22229,4847,300
1018939648,1018936247,1018961347,25100,4848,300
1018969056,1018965872,1018989784,23912,4849,300
1018997438,1018994254,1019015929,21675,4850,300
1019023730,1019020329,1019042539,22210,4851,300
1019050340,1019046939,1019069823,22884,4852,300
1019077625,1019074223,1019099323,25100,4853,300
1019106966,1019103782,1019129931,26149,4854,300
1019137643,1019134459,1019157126,22667,4855,300
1019164927,1019161526,1019186605,25079,4856,300
1019194300,1019191115,1019215345,24230,4857,300
1019223144,1019219744,1019243893,24149,4858,300
1019251597,1019248413,1019272957,24544,4859,300
1019280758,1019277357,1019302774,25417,4860,300
1019310575,1019307174,1019329382,22208,4861,300
1019337087,1019333902,1019357793,23891,4862,300
1019365593,1019362193,1019384718,22525,4863,300
1019392410,1019389225,1019414426,25201,4864,300
1019422227,1019418826,1019442997,24171,4865,300
1019450799,1019447397,1019472498,25101,4866,300
1019480156,1019476972,1019499933,22961,4867,300
1019507734,1019504333,1019530067,25734,4868,300
1019537867,1019534467,1019558912,24445,4869,300
1019566625,1019563441,1019586404,22963,4870,300
1019594205,1019590804,1019614280,23476,4871,300
1019622082,1019618680,1019642155,23475,4872,300
1019649958,1019646555,1019670054,23499,4873,300
1019677704,1019674520,1019697482,22962,4874,300
1019705174,1019701990,1019725290,23300,4875,300
1019732951,1019729765,1019753679,23914,4876,300
1019761479,1019758079,1019781258,23179,4877,300
1019789059,1019785658,1019810757,25099,4878,300
1019818462,1019815278,1019839191,23913,4879,300
1019846993,1019843591,1019868355,24764,4880,300
1019876046,1019872861,1019895826,22965,4881,300
1019903522,1019900338,1019922963,22625,4882,300
1019930620,1019927436,1019951032,23596,4883,300
1019958674,1019955490,1019978452,22962,4884,300
1019986252,1019982851,1020006348,23497,4885,300
1020014150,1020010748,1020036800,26052,4886,300
1020044474,1020041289,1020067123,25834,4887,300
1020074925,1020071523,1020094702,23179,4888,300
1020102353,1020099168,1020124369,25201,4889,300
1020132169,1020128769,1020153552,24783,4890,300
1020161186,1020158003,1020183856,25853,4891,300
1020191515,1020188331,1020211609,23278,4892,300
1020219308,1020216122,1020240691,24569,4893,300
1020248492,1020245091,1020269895,24804,4894,300
1020277546,1020274360,1020298296,23936,4895,300
1020306096,1020302696,1020327478,24782,4896,300
1020335140,1020331956,1020355889,23933,4897,300
1020363690,1020360289,1020383806,23517,4898,300
1020391608,1020388206,1020413938,25732,4899,300
1020421653,1020418469,1020442065,23596,4900,300
1020449768,1020446583,1020469547,22964,4901,300
1020477348,1020473947,1020496811,22864,4902,300
1020504520,1020501336,1020523664,22328,4903,300
1020531465,1020528064,1020551540,23476,4904,300
1020559342,1020555940,1020581992,26052,4905,300
1020589679,1020586495,1020609751,23256,4906,300
1020617552,1020614151,1020638302,24151,4907,300
1020645973,1020642788,1020666407,23619,4908,300
1020674208,1020670807,1020692087,21280,4909,300
1020699752,1020696568,1020722740,26172,4910,300
1020730541,1020727140,1020749688,22548,4911,300
1020757330,1020754146,1020775842,21696,4912,300
1020783550,1020780365,1020804596,24231,4913,300
1020812312,1020809127,1020834328,25201,4914,300
1020842037,1020838853,1020860550,21697,4915,300
1020868352,1020864950,1020889080,24130,4916,300
1020896881,1020893480,1020916639,23159,4917,300
1020924442,1020921039,1020945508,24469,4918,300
1020953309,1020949908,1020974354,24446,4919,300
1020982022,1020978839,1021002434,23595,4920,300
1021010235,1021006834,1021032676,25842,4921,300
1021040309,1021037124,1021061060,23936,4922,300
1021068760,1021065576,1021087906,22330,4923,300
1021095599,1021092414,1021115377,22963,4924,300
1021123177,1021119777,1021143589,23812,4925,300
1021151286,1021148102,1021173300,25198,4926,300
1021181003,1021177819,1021199811,21992,4927,300
1021207508,1021204324,1021226632,22308,4928,300
1021234433,1021231032,1021253263,22231,4929,300
1021261065,1021257663,1021281792,24129,4930,300
1021289505,1021286321,1021310254,23933,4931,300
1021317915,1021314729,1021340246,25517,4932,300
1021348047,1021344646,1021367825,23179,4933,300
1021375533,1021372348,1021398203,25855,4934,300
1021405853,1021402668,1021425612,22944,4935,300
1021433412,1021430012,1021455429,25417,4936,300
1021463230,1021459829,1021482375,22546,4937,300
1021490053,1021486868,1021509853,22985,4938,300
1021517564,1021514380,1021538946,24566,4939,300
1021546530,1021543346,1021570524,27178,4940,300
1021578325,1021574925,1021599687,24762,4941,300
1021607489,1021604087,1021625663,21576,4942,300
1021633324,1021630140,1021653102,22962,4943,300
1021660902,1021657502,1021680995,23493,4944,300
1021688626,1021685441,1021708722,23281,4945,300
1021716353,1021713169,1021737736,24567,4946,300
1021745417,1021742234,1021764542,22308,4947,300
1021772216,1021769032,1021790728,21696,4948,300
1021798529,1021795128,1021817675,22547,4949,300
1021825370,1021822186,1021847681,25495,4950,300
1021855481,1021852081,1021876843,24762,4951,300
1021884539,1021881355,1021904001,22646,4952,300
1021911803,1021908401,1021932214,23813,4953,300
1021940014,1021936614,1021959792,23178,4954,300
1021967593,1021964192,1021988955,24763,4955,300
1021996756,1021993355,1022019722,26367,4956,300
1022027399,1022024214,1022047178,22964,4957,300
1022054846,1022051661,1022076208,24547,4958,300
1022084011,1022080608,1022103769,23161,4959,300
1022111472,1022108288,1022132517,24229,4960,300
1022140218,1022137033,1022159047,22014,4961,300
1022166711,1022163526,1022186490,22964,4962,300
1022194291,1022190890,1022216962,26072,4963,300
1022224625,1022221439,1022245037,23598,4964,300
1022252715,1022249531,1022275700,26169,4965,300
1022283405,1022280220,1022302868,22648,4966,300
1022310670,1022307268,1022333002,25734,4967,300
1022340683,1022337499,1022359489,21990,4968,300
1022367291,1022363889,1022389940,26051,4969,300
1022397742,1022394340,1022419780,25440,4970,300
1022427581,1022424180,1022449597,25417,4971,300
1022457251,1022454066,1022476102,22036,4972,300
1022483758,1022480574,1022505120,24546,4973,300
1022512921,1022509520,1022531412,21892,4974,300
1022539213,1022535812,1022558676,22864,4975,300
1022566477,1022563076,1022587520,24444,4976,300
1022595321,1022591919,1022616050,24131,4977,300
1022623759,1022620574,1022643201,22627,4978,300
1022651002,1022647601,1022673018,25417,4979,300
1022680731,1022677547,1022703062,25515,4980,300
1022710734,1022707551,1022731778,24227,4981,300
1022739459,1022736276,1022758585,22309,4982,300
1022766276,1022763092,1022786984,23892,4983,300
1022794696,1022791511,1022815446,23935,4984,300
1022823162,1022819976,1022842920,22944,4985,300
1022850720,1022847320,1022870816,23496,4986,300
1022878452,1022875267,1022900468,25201,4987,300
1022908181,1022904996,1022927959,22963,4988,300
1022935761,1022932359,1022957755,25396,4989,300
1022965556,1022962155,1022985335,23180,4990,300
1022993136,1022989735,1023013885,24150,4991,300
1023021686,1023018285,1023042731,24446,4992,300
1023050362,1023047178,1023073012,25834,4993,300
1023080812,1023077412,1023102827,25415,4994,300
1023110458,1023107274,1023128970,21696,4995,300
1023136770,1023133369,1023159123,25754,4996,300
1023166925,1023163524,1023187020,23496,4997,300
1023194821,1023191420,1023215234,23814,4998,300
1023223036,1023219634,1023245368,25734,4999,300
1023253168,1023249768,1023271975,22207,5000,300
